aachaaryanandanaa	ಆಚಾರ್ಯನಂದನಾ
aachaarynandanaa	ಆಚಾರ್ಯನಂದನಾ
aachaarysut	ಆಚಾರ್ಯಸುತ
aadhi roti	ಆದಿ ರೋಟಿ
aadityavardhan	ಆದಿತ್ಯವರ್ಧನ್
aaj ka gundaraj	ಆಜ್ ಕಾ ಗುಂಡರಾಜ್
aakaankshaa	ಆಕರ್ಷಣಾ
aaminah	ಆಮಿನಾ
aan	ಆನ್
aashish	ಆಶಿಷ್
aatikah	ಆತಿಕಾ
aatirah	ಆತಿರಾ
ab kya hoga	ಅಬ್ ಕ್ಯಾ ಹೋಗಾ
abdul adl	ಅಬ್ದುಲ್ ಅದಲ್
abdul muhaayameen	ಅಬ್ದುಲ್ಲ ಮುಹಾಯಮೀನ್
abdullah	ಅಬ್ದುಲ್ಲಾ
abhijwaala	ಅಭಿಜ್ವಾಲ
abhijwaalaa	ಅಭಿಜ್ವಾಲಾ
abhik	ಅಭೀಕ್
abhilasahaa	ಅಭಿಲಾಷಾ
abhivir	ಅಭಿವೀರ್
accalia	ಎಕಾಲಿಯಾ
achaleshwar	ಅಚಲೇಶ್ವರ್
achcha bura	ಅಚ್ಛಾ ಬುರಾ
achhnera junction	ಅಚ್ನೆರಾ ಜಂಕ್ಷನ್
achyutray	ಅಚ್ಯುತರಾಯ
adaa	ಅದಾ
aderyn	ಏಡೆರಿನ್
adhikar	ಅಧಿಕಾರ್
adity	ಆದಿತ್ಯ
adityaa	ಆದಿತ್ಯಾ
adriatic	ಆಡ್ರಿಯಾಟಿಕ್
aftek infosys	ಅಫ್ಟೆಕ್ ಇನ್ಫೋಸಿಸ್
agaathaa	ಅಗಾಥಾ
agori khas	ಅಗೋರಿಖಾಸ್
agostino	ಅಗೋಸ್ಟಿನೋ
ahmed ar-rifai	ಅಹಮದ್ ಅರ್-ರಿಫಾಯ್
ahmedabad	ಅಹ್ಮದಾಬಾದ್
ahsan	ಅಹ್ಸಾನ್
ahzab	ಅಹ್ಜಾಬ್
aimee	ಏಮೀ
ajooba	ಅಜೂಬಾ
akshita	ಅಕ್ಷಿತ
al	ಅಲ್
al sahariar	ಅಲ್ ಸಹಾರಿಯರ್
alain	ಅಲೆನ್
alamnagar	ಅಲಂನಗರ್
alboran	ಅಲ್ಬೊರಾನ್
albukerk	ಅಲ್ಬುಕರ್ಕ್
aldona	ಅಲ್ಡೋನಾ
alfa laval	ಆಲ್ಫಾ ಲಾವಲ್
alibaba	ಅಲೀಬಾಬಾ
allen ginsberg	ಅಲೆನ್ ಗಿನ್ಸ್‌ಬರ್ಗ್
alpine skiing world cup	ಅಲ್ಪೈನ್ ಸ್ಕೀಯಿಂಗ್ ವರ್ಲ್ಡ್ ಕಪ್
amala	ಅಮಲಾ
amalataas	ಅಮಲತಾಸ್
amalendu	ಅಮಲೇಂದು
amalesh	ಅಮಲೇಶ್
amalia	ಅಮಾಲಿಯಾ
amanjeet	ಅಮನ್‌ಜೀತ್
amarpura	ಅಮರಾಪುರ
ambedkarnagar	ಅಂಬೇಡ್ಕರ್ ನಗರ್
ameer	ಅಮೀರ್
amelia	ಅಮೇಲಿಯಾ
american intl group	ಅಮೆರಿಕನ್ ಇಂಟ್ ಗ್ರೂಪ್
amlakhurd	ಅಮ್ಲಾಖುರ್ದ್
amritvel	ಅಮೃತ್‌ವೆಲ್
amu darya	ಅಮು ದರ್ಯಾ
amulya	ಅಮೂಲ್ಯ
anaamay	ಅನಾಮಯ್
anahita	ಅನಾಹಿತ
anandinee	ಆನಂದಿನೀ
anantapur	ಅನಂತಪುರ್
ananyaa	ಅನನ್ಯಾ
andrew hudson	ಆಂಡ್ರ್ಯೂ ಹಡ್ಸನ್
andrew strauss	ಆಂಡ್ರ್ಯೂ ಸ್ಟ್ರಾವಸ್
angaarika	ಅಗಾರಿಕ
angada	ಅಂಗದ
angulimal	ಅಂಗುಲಿಮಾಲ್
anjalee	ಅಂಜಲೀ
annona	ಅನ್ನೋನಾ
anou boussouil	ಅನೌ ಬೌಸೋಯಿಲ್
anshuman	ಅಂಶುಮಾನ್
anuhya	ಅನೂಹ್ಯ
anupam	ಅನುಪಮ್
anupamaa	ಅನುಪಮಾ
anuradhaa	ಅನುರಾಧಾ
aparajit	ಅಪರಾಜಿತ್
aparajita	ಅಪರಾಜಿತಾ
aparnesh	ಅಪರ್ಣೇಶ್
apna bana lo	ಅಪ್ನಾ ಬನಾ ಲೋ
apurv	ಅಪೂರ್ವ
aquila	ಆಕ್ವಿಲಾ
arab	ಅರಬ್
arakku	ಅರಾಕು
arasur	ಅರಸೂರ್
arcelor	ಆರ್ಸಿಲರ್
arch	ಆರ್ಚ್
arcos	ಆರ್ಕೋಸ್
ardelis	ಆರ್ಡೆಲಿಸ್
aristophanes	ಅರಿಸ್ಟೋಫನೇಸ್
arora	ಅರೋರಾ
artemas	ಆರ್ಟಿಮಸ್
arub	ಅರುಬ್
asahi india	ಆಸಹೀ ಇಂಡಿಯಾ
asangaon	ಅಸನ್‌ಗಾಂವ್
asavari	ಅಸಾವರಿ
ashadh ka ek din	ಆಶಾಧ್ ಕಾ ಏಕ್ ದಿನ್
ashapurna devi	ಆಶಾಪೂರ್ಣ ದೇವಿ
ashley de silva	ಅಶ್ಲೇ ಡಿಸಿಲ್ವ
ashok leyland	ಅಶೋಕ್ ಲೀಲ್ಯಾಂಡ್
asija	ಅಸಿಜಾ
aslesha	ಆಶ್ಲೇಷಾ
aspasia	ಆಸ್ಪೇಶಿಯಾ
aston	ಆಸ್ಟನ್
astro	ಆಸ್ಟ್ರೋ
aswan dams	ಆಸ್ವಾನ್ ಡ್ಯಾಮ್
atahar	ಅತಹರ್
atithee	ಅತಿಥಿ
atrauli road	ಅತ್ರೌಲಿ ರೋಡ್
auberta	ಆಬೆರ್ಟಾ
auburn	ಅಂಬುರ್ನ್
aurat pair ki joti nahin	ಔರತ್ ಪೈರ್ ಕಿ ಜೂತೀ ನಹೀ
aurobindo memorial school	ಅರಬಿಂದೋ ಮೆಮೋರಿಯಲ್ ಸ್ಕೂಲ್
ayatollah khomeini	ಅಯಾತುಲ್ಲಾ ಖೊಮೇನಿ
ayodhya	ಅಯೋಧ್ಯಾ
baali	ಬಾಲಿ
baba rexheb	ಬಾಬಾ ರೆಕ್ಸೆಬ್
badal aur bijli	ಬಾದಲ್ ಔರ್ ಬಿಜಲಿ
badaruddeen	ಬದ್ರುದ್ದೀನ್
bade ghar ki bahu	ಬಡೇ ಘರ್ ಕಿ ಬಹು
bade ghar ki beti	ಬಡೇ ಘರ್ ಕಿ ಬೇಟಿ
badnaam	ಬದನಾಮ್
badriprasad	ಬದ್ರಿಪ್ರಸಾದ್
badrudin	ಬದ್ರುದ್ದಿನ್
bahadur kisan	ಬಹಾದೂರ್ ಕಿಸಾನ್
baharon phool barsao	ಬಹಾರೋಂ ಫೂಲ್ ಬರಸಾವೋ
bajaj	ಬಜಾಜ್
bajwa	ಬಾಜ್ವಾ
balagopal	ಬಾಲಗೋಪಾಲ್
balagovind	ಬಾಲಗೋವಿಂದ್
balakrishna	ಬಾಲಕೃಷ್ಣ
balasor	ಬಾಲಸೋರ್
balawali	ಬಲಾವಾಲಿ
balrampur	ಬಲರಾಂಪುರ್
balwinder sandhu	ಬಲ್ವಿಂದರ್ ಸಂಧು
bamboo	ಬಾಂಬೂ
banbasa	ಬನಬಾಸಾ
bandagi	ಬಂದಗೀ
bandhan	ಬಂಧನ್
bandook dahej ke seeney par	ಬಂದೂಕ್ ದಹೇಜ್ ಕಿ ಸೀನೆ ಪರ್
bank of india	ಬ್ಯಾಂಕ್ ಆಫ್ ಇಂಡಿಯಾ
bank robbery	ಬ್ಯಾಂಕ್ ರಾಬರಿ
banka	ಬಂಕಾ
bankebiharee	ಬಾಂಕೆಬಿಹಾರೀ
bankimchandra chatarjee	ಬಂಕಿಮಚಂದ್ ಚಟರ್ಜಿ
bansari	ಬನ್ಸಾರಿ
bansuri	ಬಾನ್ಸುರಿ
baraat	ಬಾರಾತ್
barauni junction	ಬಾರೌನಿ ಜಂಕ್ಷನ್
barberton friends	ಬಾರ್ಬೆರ್ಟಾನ್ ಫ್ರೆಂಡ್ಸ್
barrah	ಬರಾ
barry manilow	ಬ್ಯಾರಿ ಮೆನಿಲೋ
barwa sagar	ಬರವಾ ಸಾಗರ್
battice fort	ಬ್ಯಾಟಿಸ್ ಫೋರ್ಟ್
bawal	ಬವಾಲ್
bayer	ಬಾಯರ್
bayern	ಬೆಯರ್ನ್
bedetti	ಬೀದೆತ್ತಿ
beeraam	ಬೀರಾಮ್
behram khan	ಬೆಹರಮ್ ಖಾನ್
bekhbar	ಬೆಖಬರ್
belvandi	ಬೆಲ್ವಂಡಿ
beqasoor	ಬೆಖಸೂರ್
bewafa	ಬೇವಫಾ
bewakkoof	ಬೇವಕೂಫ್
bhago bhoot aaya	ಭಾಗೋ ಭೂತ್ ಆಯಾ
bhangu	ಭಂಗೂ
bharatishipyard	ಭಾರತಿಶಿಪ್‌ಯಾರ್ಡ್
bheniwal	ಭೆಣಿವಾಲಾ
bhimashankar	ಭೀಮಾಶಂಕರ್
bhimsa	ಭಿಮ್ಸಾ
bhindra	ಭಿಂಡರಾ
bhiwani	ಭಿವಾನಿ
bhoola bhatka	ಭೂಲ್ ಭಟಕಾ
bhrigu	ಭೃಗು
bhuvaneswari hindu	ಭುವನೇಶ್ವರಿ ಹಿಂದು
bichpuri	ಬಿಛಪುರಿ
bidhan nagar	ಬಿಧಾನ್ ನಗರ್
bilaspur junction	ಬಿಲಾಸ್‌ಪುರ್ ಜಂಕ್ಷನ್
bill athey	ಬಿಲ್ ಅಥೆ
bimala	ಬಿಮಲಾ
binaur	ಬಿನಾರ್
birla group	ಬಿರ್ಲಾ ಗ್ರೂಪ್
bisalwas kalan	ಬಿಸಲ್ವಾಸ್ ಕಲಾನ್
bishenpur	ಬಿಷೇನ್ಪುರ್
bishnathganj	ಬಿಶನಾಥ್‌ಗಂಜ್
bland	ಬ್ಲಾಂಡ್
blue ridge	ಬ್ಲೂ ರಿಡ್ಜ್
bob hope	ಬಾಬ್ ಹೋಪ್
bokha	ಬೋಖಾ
boliviano	ಬೊಲಿವಿಯಾನೊ
bongaigaon	ಬೊಂಗೈಗಾಂವ್
bontebok	ಬೋಂಟೆಬೋಕ್
bosch chassis	ಬೋಶ್ ಚಾಸಿಸ್
bowie	ಬೋವಿ
brajamohan	ಬ್ರಜಮೋಹನ್
brant	ಬ್ರಾಂಟ್
brean down fort	ಬೀನ್ ಡೌನ್ ಫೋರ್ಟ್
brian close	ಬ್ರಿಯಾನ್ ಕ್ಲೋಸ್
brinda	ಬ್ರಿಂದಾ
british comedy awards	ಬ್ರಿಟಿಷ್ ಕಾಮೆಡಿ ಅವಾರ್ಡ್ಸ್
broadwater	ಬ್ರಾಡ್‌ವಾಟರ್
bruce willis	ಬ್ರೂಸ್ ವಿಲಿಸ್
bu ali shah qalandar	ಬು ಅಲಿ ಶಾ ಖಲಂದರ್
budni	ಬದನಿ
buniyaad	ಬುನಿಯಾದ್
buraj	ಬುರಜ್
burhar	ಬುರಹಾರ್
bushra	ಬುಶ್ರಾ
cabot	ಕ್ಯಾಬಟ್
caesar	ಸೀಸರ್
camila	ಕ್ಯಾಮಿಲಾ
canon del sumidero	ಕೆನನ್ ಡೆಲ್ ಸುಮಿಡೆರೊ
capodistria museum	ಕ್ಯಾಪೊಡಿಸ್ಟ್ರಿಯಾ ಮ್ಯೂಸಿಯಂ
captain sheroo	ಕ್ಯಾಪ್ಟನ್ ಶೆರೂ
capucine	ಕೇಪುಸಿನ್
cara	ಕಾರಾ
cardiome pharma corporation	ಕಾರ್ಡಿಯೋಮ್ ಫಾರ್ಮಾ ಕಾರ್ಪೊರೇಶನ್
carl cachopa	ಕಾರ್ಲ್ ಕಚೋಪಾ
carlton	ಕಾರ್ಲ್ಟನ್
carnegie medal	ಕಾರ್ನೆಜ್ ಮೆಡಲ್
casper	ಕ್ಯಾಸ್ಪರ್
cassia	ಕೇಸಿಯಾ
castrol	ಕ್ಯಾಸ್ಟ್ರಾಲ್
caswell	ಕಾಸ್ವೆಲ್
catherine turner	ಕ್ಯಾಥರೀನ್ ಟರ್ನರ್
cathy lee gifford	ಕ್ಯಾಥಿ ಲೀ ಜಿಫಾರ್ಡ್
catriona	ಕೇಟ್ರಿಯೋನಾ
cecile	ಸಿಸಿಲ್
central america maya	ಸೆಂಟ್ರಲ್ ಅಮೆರಿಕ ಮಾಯಾ
central european media enterprises	ಸೆಂಟ್ರಲ್ ಯುರೋಪಿಯನ್ ಮೀಡಿಯಾ ಎಂಟರ್ ಪ್ರೈಸ್
ceram	ಸೆರಾಮ್
cesar award	ಸೆಸಾರ್ ಅವಾರ್ಡ್
chabua	ಛಾಬುವಾ
chahta	ಚಾಹತಾ
chaitanya	ಚೈತನ್ಯ
chalti ka naam gaadi	ಚಲ್ತೀ ಕಾ ನಾಮ್ ಗಾಢೀ
chandak	ಚಂಡಾಕ್
chandha	ಚಾಂಧಾ
chandika	ಚಂದ್ರಿಕಾ
chandrak	ಚಂದ್ರಕ್
chandrakala	ಚಂದ್ರಕಲಾ
chandramukhi	ಚಂದ್ರಮುಖಿ
charita	ಚರಿತಾ
charles dickens	ಚಾರ್ಲ್ಸ್ ಡಿಕನ್ಸ್
charlie lock	ಚಾರ್ಲೀ ಲಾಕ್
charlton heston	ಚಾರ್ಲಟನ್ ಹೆಸ್ಟಾನ್
chaughule	ಚೌಘುಲೆ
chelsi	ಚೆಲ್ಸೀ
chemin de fer fort	ಚೆಮಿನ್ ಡಿ ಫೆರ್ ಫೋರ್ಟ್
chhalia	ಛಲಿಯಾ
chianki	ಛಿಯಾಂಕಿ
china telecommunications	ಚೀನಾ ಟೆಲಿಕಮ್ಯೂನಿಕೇಶನ್ಸ್
china's great wall museum	ಚೈನಾಸ್ ಗ್ರೇಟ್ ವಾಲ್ ಮ್ಯೂಸಿಯಂ
chinchvad	ಚಿಂಚವಾಡ್
chinmay	ಚಿನ್ಮಯ್
chinnamalai	ಚಿನ್ನಮಲೈ
chip	ಚಿಪ್
chipurupalle	ಚಿಪುರುಪಲ್ಲಿ
chirayinkil	ಚಿರಾಯಿನ್‌ಕಿಲ್
chitnis	ಚಿಟ್ನಿಸ್
chitrakot	ಚಿತ್ರಕೋಟ್
chitrarath	ಚಿತ್ರರಥ್
chodiala	ಚೋಡಿಯಾಲಾ
chuck norris	ಚುಕ್ ನೋರಿಸ್
chunneelaal	ಚುನ್ನೀಲಾಲ್
chyna	ಚಾಯನಾ
cicely	ಸಿಸಿಲಿ
clermont	ಕ್ಲೆಮಂಟ್
colette	ಕೊಲೆಟ್
colin cowdrey	ಕಾಲಿನ್ ಕೌಡ್ರೆ
colombo	ಕೊಲಂಬೊ
comparsa	ಕಂಪಾರ್ಸಾ
computer sciences	ಕಂಪ್ಯೂಟರ್ ಸೈನ್ಸಸ್
concor	ಕಾನ್ಕೋರ್
connor	ಕಾನರ್
conroy	ಕಾನ್ರಾಯ್
container	ಕಂಟೈನರ್
continental	ಕಾಂಟಿನೆಂಟಲ್
continental tango	ಕಾಂಟಿನೆಂಟಲ್ ಟಾಂಗೊ
coonoor	ಕೂಣೂರ್
craig evans	ಕ್ರೆಗ್ ಇವನ್ಸ್
cryptologic	ಕ್ರಿಪ್ಟೋಲಾಜಿಕ್
cura	ಕ್ಯುರಾ
curtly ambrose	ಕರ್ಟ್ಲಿ ಅಂಬ್ರೋಸ್
daera	ದಾಯರಾ
daku bijlee	ಡಾಕೂ ಬಿಜಲಿ
dale	ದಾಲೇ
danish	ಡ್ಯಾನಿಶ್
darabuka	ಡಾರಾಬುಕ
daraganj	ದಾರಾಗಂಜ್
darbhanga junction	ದರಭಾಂಗಾ ಜಂಕ್ಷನ್
darcie	ದಾರ್ಸಿ
darshana	ದರ್ಶಣಾ
darwin awards	ಡಾರ್ವಿನ್ ಅವಾರ್ಡ್ಸ್
dashavtar	ದಶಾವತಾರ್
dassault systems	ದಸ್ಸಾಲ್ಟ್ ಸಿಸ್ಟಮ್ಸ್,
dasuya	ದಸುಯಾ
dausa	ದೌಸಾ
dausni	ದೌಸ್ನಿ
dave richardson	ಡೇವ್ ರಿಚರ್ಡ್ಸನ್
deedar-e-yaar	ದೀದಾರ್-ಎ-ಯಾರ್
deepak fert	ದೀಪಕ್ ಫರ್ಟಿಲೈಸರ್ಸ್
delhi junction	ದೆಲ್ಲಿ ಜಂಕ್ಷನ್
denis	ಡೆನಿಸ್
derek crookes	ಡೆರೆಕ್ ಕ್ರೂಕ್ಸ್
devabrata	ದೆವಬ್ರತಾ
devavarya	ದೇವವರ್ಯ
devayush	ದೇವಯುಶ್
dhadial	ಢಡಿಯಾಲ್
dhaka	ಢಾಕಾ
dham	ಧಾಮ್
dhamkee	ಧಮಕಿ
dhanashri	ಧನಶ್ರೀ
dhanoa	ಧನೋಯಾ
dhanraj	ಧನರಾಜ್
dharamsheel	ಧರಂಶೀಲ್
dharani	ಧರಣಿ
dharti kahe pukar ke	ಧರತೀ ಕಹೆ ಪುಕಾರ್ ಕೆ
dhekiajili road	ಧೆಕಿಯಾಜಿ ರೋಡ್
dhodra mohar	ಧೋದ್ರಾ ಮೊಹರ್
dilber	ದಿಲ್ಬರ್
dilruba tangewali	ದಿಲರುಬಾ ಟಾಂಗೆವಾಲೀ
dilwara temple	ದಿಲ್ವಾರ್ ಟೆಂಪಲ್
dino	ಡಿನೊ
dinos	ಡಿನೋಸ್
dirgh	ದೀರ್ಘ
dirt biking	ಡರ್ಟ್ ಬೈಕಿಂಗ್
do raaste	ದೋ ರಾಸ್ತೆ
dobro	ಡೋಬ್ರೊ
dolti naiya	ಡೋಲತೀ ನೈಯಾ
domingarh	ದೊಮಿನಗಢ್
dominick	ಡೊಮಿನಿಕ್
donovan	ಡೊನವನ್
doodh ka karz	ದೂಧ್ ಕಾ ಕರ್ಜಾ
dornakal junction	ದೊರನಾಕಲ್ ಜಂಕ್ಷನ್
draco	ಡ್ರ್ಯಾಕೊ
drummond	ಡ್ರಮ್ಮಂಡ್
duggad	ದುಗ್ಗಡ್
dumariya	ದುಮಾರಿಯಾ
duncan fletcher	ಡಂಕನ್ ಫ್ಲೆಚರ್
duperre	ದುಪೇರಿ
duraundha	ದುರೌಂಧಾ
dwight	ಡ್ವೈಟ್
e'jaaz	ಎಜಾಜ್
ehsan	ಎಹಸಾನ್
eithne	ಈಥ್ನಿ
ek bechara	ಏಕ್ ಬೆಚಾರಾ
ek misaal	ಏಕ್ ಮಿಸಾಲ್
ek thi ladki	ಏಕ್ ಥಿ ಲಡಕಿ
ekachitt	ಏಕಚಿತ್
el-saraya	ಅಲ್-ಸರಯಾ
elaan	ಏಲಾನ್
elizabeth tailor	ಎಲಿಜಬೆತ್ ಟೇಲರ್
elke	ಎಲ್ಕೆ
elkhart	ಎಲ್ಕ್ಹಾರ್ಟ್
ellenabad	ಎಲೆನಾಬಾದ್
emily	ಎಮಿಲಿ
emirates tower one	ಎಮಿರೇಟ್ಸ್ ಟವರ್ ಒನ್
erebus	ಎರೆಬಸ್
eris	ಏರಿಸ್
erna	ಎರ್ನಾ
ernakulam junction	ಎರ್ನಾಕುಲಮ್ ಜಂಕ್ಷನ್
erno	ಎರ್ನೋ
errin	ಎರಿನ್
erv	ಎರ್ವ್
etah	ಇತಾಹಾ
etmadpur	ಇಟಮಾಪುರ್
eurohypo	ಯೂರೋಹೈಪೋ
european film awards	ಯುರೋಪಿಯನ್ ಫಿಲ್ಮ್ ಅವಾರ್ಡ್ಸ್
eveready ind	ಎವರೆಡೀ ಇಂಡ್
everest ind	ಎವರೆಸ್ಟ್ ಇಂಡ್
everly	ಎವರ್ಲಿ
exeter	ಎಕ್ಸೀಟರ್
express scripts	ಎಕ್ಸ್ ಪ್ರೆಸ್ ಸ್ಕ್ರಿಪ್ಟ್ಸ್
eyab	ಎಯಾಬ್
fabiana	ಫೇಬಿಯಾನಾ
fajyaz	ಫಾಜ್‌ಯಾಜ್
fancy	ಫ್ಯಾನ್ಸಿ
fanie de villiers	ಫ್ಯಾನೀ ಡಿ ವಿಲಿಯರ್ಸ್
farhan adil	ಫರಾನ್ ಅದಿಲ್
farica	ಫ್ಯಾರಿಕಾ
farid	ಫರಿದ್
farlington redoubt	ಫಾರ್ಲಿಂಗ್ಟನ್ ರಿಡೌಟ್
farooq	ಫಾರೂಕ್
farragut	ಫರಾಗತ್
fateh singhpura	ಫತೆಹ್ ಸಿಂಗಪುರ
fattah	ಫತ್ತಾ
fauve	ಫಾವ್
fay	ಫೇ
fayyadh	ಫೈಯಾದ್
felix	ಫೆಲಿಕ್ಸ್
fia	ಫಿಯಾ
filia	ಫಿಲಿಯಾ
filler	ಫಿಲ್ಲರ್
finnea	ಫಿನಿಯಾ
firdaus	ಫಿರದೌಸ್
first canadian place	ಫಸ್ಟ್ ಕೆನಿಡಿಯನ್ ಪ್ಲೇಸ್
firstservice corporation	ಫಸ್ಟ್ ಸರ್ವಿಸ್ ಕಾರ್ಪೊರೇಶನ್
fleur	ಫ್ಲ್ಯೂರ್
florence	ಫ್ಲಾರೆನ್ಸ್
fluorine	ಫ್ಲೋರಿನ್
flying cloud	ಫ್ಲೈಯಿಂಗ್ ಕ್ಲೌಡ್
fort benghisa	ಫೋರ್ಟ್ ಬೆಂಗಿಶಾ
fort cumberland	ಫೋರ್ಟ್ ಕುಂಬರ್‌ಲ್ಯಾಂಡ್
fort donelson	ಫೋರ್ಟ್ ಡೊನೆಲ್ಸನ್
fort edmonton	ಫೋರ್ಟ್ ಎಡ್ಮಂಟನ್
fort foster	ಫೋರ್ಟ್ ಫಾಸ್ಟರ್
fort mcclary	ಫೋರ್ಟ್ ಮ್ಯಾಕ್‌ಕ್ಲಾರಿ
fort mcnab	ಫೋರ್ಟ್ ಮ್ಯಾಕ್‌ನಬ್
fort santo domingo	ಫೋರ್ಟ್ ಸ್ಯಾಂಟೊ ಡೊಮಿಂಗೊ
fort siloso	ಫೋರ್ಟ್ ಸಿಲೋಸೊ
fossilized forest of lesvos museum of natural history	ಫಾಸಿಲಿಜದ್ ಫಾರೆಸ್ಟ್ ಆಫ್ ಲೆವೋಸ್ ಮ್ಯೂಸಿಯಂ ಆಫ್ ನ್ಯಾಚುರಲ್ ಹಿಸ್ಟರಿ
fox	ಫಾಕ್ಸ್
franklin roosevelt	ಫ್ರಾಂಕ್ಲಿನ್ ರೂಸೆವೆಲ್ಟ್
furqan	ಫುರ್ಖಾನ್
gahiree	ಗಹಿರಿ
galvin	ಗಾಲ್ವಿನ್
gangaganj	ಗಂಗಾಗಂಜ್
gangtok	ಗ್ಯಾಂಗ್ಟಕ್
gangu	ಗಂಗು
gap	ಗ್ಯಾಪ್
garam khoon	ಗರಮ್ ಖೂನ್
gardner memorial united methodist	ಗಾರ್ಡನರ್ ಮೆಮೋರಿಯಲ್ ಯುನೈಟೆಡ್ ಮೆಥೋಡಿಸ್ಟ್
garma garam	ಗರಮ್ ಗರಮ್
garwah	ಗರ್ವಾ
genera	ಜೆನೀರಾ
general george castro	ಜನರಲ್ ಜಾರ್ಜ್ ಕ್ಯಾಸ್ಟ್ರೋ
gentium	ಜೆಂಟಿಯಂ
ghaare	ಘಾರೆ
ghana	ಘಾನಾ
gharoda	ಘರೋಡಾ
ghatsila	ಘಟಸಿಲಾ
ghita	ಗೀತಾ
ghufran	ಗುಫರಾನ್
ghumaysa	ಗುಮಾಯಸ
ghumman	ಘುಮ್ಮನ್
ghunayn	ಗುತಾಯನ್
giddarbaha	ಗಿದ್ದರಬಹಾ
gillespie	ಗಿಲೆಸ್ಪೀ
ginger	ಜಿಂಜರ್
girdhar gopal ki mira	ಗಿರಧರ್ ಗೋಪಾಲ್ ಕಿ ಮೀರಾ
giuseppe miraglia	ಗ್ಯುಸೆಪ್ ಮಿರಾಗ್ಲಿಯಾ
glen chapple	ಗ್ಲೆನ್ ಚಾಪಲ್
glennis	ಗ್ಲೆನ್ನೀಸ್
glenyon	ಗ್ಲೆನ್‌ಯೋನ್
glide	ಗ್ಲೈಡ್
gogna	ಗೋಗನಾ
gogte	ಗೋಗಟೆ
golanthra	ಗೋಲಂಥರಾ
goodwin	ಗುಡ್‌ವಿನ್
gorakhpur junction	ಘೋರಖ್‌ಪುರ್ ಜಂಕ್ಷನ್
gorana	ಗೋರಾನಾ
goraul	ಗೋರಾಲ್
gorm	ಗೋರ್ಮ್
grah pravesh	ಗೃಹ ಪ್ರವೇಶ್
greg matthews	ಗ್ರೆಗ್ ಮ್ಯಾಥ್ಯೂಸ್
gregory	ಗ್ರೆಗೋರಿ
gunah aur kanoon	ಗುನಾಹ್ ಔರ್ ಕಾನೂನ್
gupt shastra	ಗುಪ್ತ್ ಶಾಸ್ತ್ರ
gurjas	ಗುರಜಸ್
gurnam	ಗುರುನಾಮ್
gurudwara sachha souda	ಗುರುದ್ವಾರ ಸಚ್ಚಾ ಸೌದಾ
guy whittall	ಗಯ್ ವಿಟ್ಟಾಲ್
guzar	ಗುಜರ
hajeeb	ಹಜೀಬ್
hamara haj	ಹಮಾರಾ ಹಜ್
hamari duniya	ಹಮಾರಿ ದುನಿಯಾ
hamish marshall	ಹಮೀಶ್ ಮಾರ್ಷಲ್
hanmee presbyterian	ಹಾನ್ಮೀ ಪ್ರೆಸ್ಬಿಟೇರಿಯನ್
hareesh	ಹರೀಶ್
haris	ಹ್ಯಾರಿಸ್
harry potter	ಹ್ಯಾರಿ ಪಾಟರ್
haweliana	ಹವೇಲಿಯಾನಾ
heera aur patthar	ಹೀರಾ ಔರ್ ಪತ್ಥರ್
henkel	ಹೆಂಕೆಲ್
hillary swank	ಹಿಲೆರಿ ಸ್ವಾಂಕ್
himmat	ಹಿಮ್ಮತ್
hollebone	ಹೋಲ್‌ಬೋನ್
hong kong new world building	ಹಾಂಗ್‌ಕಾಂಗ್ ನ್ಯೂ ವರ್ಲ್ಡ್ ಬಿಲ್ಡಿಂಗ್
hrishikesh kanitkar	ಹೃಷಿಕೇಶ್ ಕಾನಿಟ್ಕರ್
hujaymah	ಹುಜೇಮಾ
hum se na jeeta koi	ಹಮ್ ಸೆ ನಾ ಜೀತಾ ಕೋಯಿ
hum tum aur who	ಹಮ್ ತುಮ್ ಔರ್ ವೋ
humphrey	ಹಂಫ್ರೆ
hurayth	ಹುರೇತ್
iena	ಲೆನಾ
iflex solution	ಐಫ್ಲೆಕ್ಸ್ ಸಲ್ಯೂಷನ್ಸ್
illinois	ಇಲಿನಾಯ್ಸ್
imtihal	ಇಮ್ತಿಹಾಲ್
indian hotels	ಇಂಡಿಯನ್ ಹೋಟೆಲ್ಸ್
indra sabha	ಇಂದ್ರ ಸಭಾ
indrakanta	ಇಂದ್ರಕಾಂತ
insan	ಇನ್ಸಾನ್
insurgente	ಇನ್‌ಸುರ್‌ಜೆಂಟಿ
intel	ಇಂಟೆಲ್
intercontinental cup	ಇಂಟರ್‌ಕಾಂಟಿನೆಂಟಲ್ ಕಪ್
iodine	ಅಯೋಡಿನ್
ipca labs	ಇಪ್ಕಾ ಲ್ಯಾಬ್ಸ್
irrigation	ಇರಿಗೇಶನ್
irrisistible	ಇರ್ರೆಸಿಸ್ಟಬಲ್
ishan	ಈಶನ್
ishq ishq ishq	ಇಶ್ಕ್ ಇಶ್ಕ್ ಇಶ್ಕ್
ispat	ಇಸ್ಪಾಟ್
iwo jima	ಇವೋ ಜಿಮಾ
jaago	ಜಾಗೋ
jack richards	ಜಾಕ್ ರಿಚರ್ಡ್ಸ್
jackvillen kennedy	ಜ್ಯಾಕ್‌ವಿಲಿನ್ ಕೆನೆಡಿ
jaclyn elders	ಜ್ಯಾಕ್ಲಿನ್ ಎಲ್ಡರ್ಸ್
jacobite rising in scotland	ಜಾಕೊಬೈಟ್ ರೈಸಿಂಗ್ ಸ್ಕಾಟ್‌ಲ್ಯಾಂಡ್
jafar	ಜಾಫರ್
jahajj	ಝಜ್ಜ್
jahan	ಜಹಾನ್
jahangir	ಜಹಂಗೀರ್
jahura	ಜಹೂರಾ
jaikwadi	ಜಾಯಕ್‌ವಾಡಿ
jaipur fort	ಜೈಪುರ್ ಫೋರ್ಟ್
james ormond	ಜೇಮ್ಸ್ ಒರ್ಮಾಂಡ್
janak	ಜನಕ್
jassal	ಜಸ್ಸಲ್
jati	ಜತಿ
javelin	ಜಾವೆಲಿನ್
jesimae	ಜೆಸ್ಸಿಮಿ
jewish museum	ಜ್ಯುಯಿಶ್ ಮ್ಯೂಸಿಯಂ
jhambaari	ಝಮ್ಬಾರಿ
jharna	ಝರನಾ
jiali plaza	ಜಿಯಾಲಿ ಪ್ಲಾಜಾ
jinta	ಜಿಂಟಾ
johan straus batch	ಜೋಹಾನ್ ಸ್ಟ್ರೌಸ್ ಬ್ಯಾಚ್
john aubuchon freedom	ಜಾನ್ ಆಬುಚೋನ್ ಫ್ರೀಡಮ್
jonathan millmow	ಜೊನಾಥನ್ ಮಿಲ್ಮೋ
jouhikko	ಜೌಹಿಕೊ
judaism	ಜುಡೈಸ್ಮ್
julianne	ಜುಲಿಯಾನಿ
julien wiener	ಜುಲಿಯನ್ ವೀನರ್
junayd shirazi	ಜುನಾಯ್ದ್ ಶಿರಾಝಿ
jung bahadur	ಜಂಗ್ ಬಹಾದುರ್
kahnuwal	ಕಹನೂವಾಲಾ
kakadu	ಕಕಾಡು
kala chor	ಕಾಲಾ ಚೋರ್
kamil	ಕಮಿಲ್
kamla ki maut	ಕಮಲಾ ಕಿ ಮೌತ್
kamran akmal	ಕಮ್ರಾನ್ ಅಕ್ಮಲ್
kanoon meri mutthi mein	ಕಾನೂನ್ ಮೇರಿ ಮುಟ್ಠಿ ಮೆ
kanpur	ಕಾನ್ಪುರ್
karah	ಕರಾ
kardawiyah	ಕರ್ದವಿಯಾ
karin	ಕೇರಿನ್
karsan ghavri	ಕರ್ಸನ್ ಗಾರ್ವಿ
karunakar	ಕರುಣಾಕರ್
katha	ಕಥಾ
kaun apana kaun paraya	ಕೌನ್ ಅಪನಾ ಕೌನ್ ಪರಾಯಾ
kausar	ಕೌಸರ್
kavishwar	ಕವೀಶ್ವರ್
kawishar	ಕವೀಶರ್
kaylana	ಕೆಲಾನಾ
keefer	ಕೀಫರ್
kemp	ಕೆಂಪ್
kerryn	ಕೆರಿನ್
keshi	ಕೇಶಿ
khadikar	ಖಾಡಿಕರ್
khalsa	ಖಾಲಸಾ
khazanah	ಖಜಾನಾ
khel	ಖೇಲ್
khudgarz	ಖುದಗರ್ಜ್
khulaybah	ಖುಲೇಬಾ
khunays	ಖುನೇಸ್
kineta	ಕಿನೆಟಾ
kishan	ಕಿಶನ್
klarika	ಕ್ಲಾರಿಕಾ
kobe steel	ಕೋಬ್ ಸ್ಟೀಲ್
konkani	ಕೊಂಕಣಿ
krashnaa	ಕೃಷ್ಣಾ
kratz	ಕ್ರೇಟ್ಸ್
kshama	ಕ್ಷಮಾ
kular	ಕುಲಾರ್
kullursandai reservoir	ಕುಲ್ಲೂರ್‌ಸಂದೈ ರಿಜರ್ವಾಯರ್
kumar	ಕುಮಾರ್
kutch	ಕುಛ್
laabhante	ಲಾಭಾಂತೆ
laalaa	ಲಾಲಾ
lake norman baptist	ಲೇಕ್ ನಾರ್ಮನ್ ಬ್ಯಾಪ್ಟಿಸ್ಟ್
lakeeren	ಲಕೀರೇ
lakheshvar	ಲಖೇಶ್ವರ್
lakhon mein ek	ಲಾಖೋಂ ಮೆ ಏಕ್
landon	ಲಂಡನ್
lee germon	ಲೀ ಜರ್ಮನ್
lefty	ಲೆಫ್ಟಿ
leroy	ಲೆರಾಯ್
levana	ಲೆವೆನಾ
lignite	ಲಿಗ್‌ನೈಟ್
linus	ಲಿನಸ್
livett	ಲಿವೆಟ್
lockeridge	ಲಾಕ್‌ರಿಡ್ಜ್
lokamaan_y	ಲೋಕಮಾನ್ಯ
lorenzo	ಲೊರೆಂಝೋ
lucie	ಲೂಸಿ
lucille	ಲುಕಿಲ್ಲೆ
lukoil	ಲುಕಾಯಿಲ್
lutaaoo	ಲುಟಾವೂ
luzon	ಲುಜನ್
maa bahen aur biwi	ಮಾ ಬಹನ್ ಔರ್ ಬೀವಿ
madhuri	ಮಾಧುರಿ
mahi	ಮಹಿ
maine pyar kiya	ಮೈ ಪ್ಯಾರ್ ಕಿಯಾ
maiyaa	ಮೈಯಾ
majhail	ಮಝೌಲ್
major league lacrosse offensive player of the year award	ಮೇಜರ್ ಲೀಗ್ ಲಾಕ್ರೊಸ್ ಅಫೆನ್ಸಿವ್ ಪ್ಲೇಯರ್ ಆಫ್ ದ ಈಯರ್ ಅವಾರ್ಡ್
makhdoom	ಮಕದೂಮ್
makia	ಮಾಕಿಯಾ
makkhu	ಮಖೂ
malaysia	ಮಲೇಷಿಯಾ
maldaar	ಮಾಲದಾರ್
malka mari	ಮಲ್ಕಾ ಮಾರಿ
mandakranta	ಮಂದ್ರಕ್ರಾಂತ
mandeep	ಮನ್‌ದೀಪ್
mandir masjid	ಮಂದಿರ್ ಮಸ್ಜಿದ್
mangal dada	ಮಂಗಲ್ ದಾದಾ
mangat	ಮಂಗಟ್
manideepa	ಮಣಿದೀಪ
maniram	ಮಣಿರಾಮ್
manjula	ಮಂಜುಳಾ
mannan	ಮನ್ನಾನ್
mansoor rana	ಮನ್ಸೂರ್ ರಾಣಾ
marcia	ಮಾರ್ಸಿಯಾ
marconi prize	ಮಾರ್ಕೊನಿ ಪ್ರೈಜ್
margaret	ಮಾರ್ಗರೇಟ್
marge	ಮಾರ್ಗ್
marlo	ಮಾರ್ಲೊ
martyn moxon	ಮಾರ್ಟಿನ್ ಮಾಕ್ಸನ್
mashooqa	ಮಾಶೂಕಾ
mashrafe mortaza	ಮಶ್ರೇಪ್ ಮೊರ್ಟಾಜಾ
massenhoven	ಮಾಸೆನ್‌ಹೋವನ್
mawiyah	ಮಾವಿಯಾ
mawsil	ಮಾವಸಿಲ್
mayoorashikhaa	ಮಯೂರ್‌ಶಿಖಾ
maysa	ಮೇಸಾ
mayurakshi	ಮಯೂರಾಕ್ಷಿ
mazloom	ಮಜಲೂಮ್
mccracken	ಮ್ಯಾಕ್‌ಕ್ರಾಕೆನ್
mccurry	ಮ್ಯಾಕ್‌ಕರ್ರಿ
mckile	ಮೆಕಿಲಿ
medal for heroism in silver	ಮೆಡಲ್ ಫಾರ್ ಹೀರೋಯಿಸಮ್ ಇನ್ ಸಿಲ್ವರ್
mellette	ಮೆಲೆಟ್
mercator lines	ಮರ್ಕೇಟರ್ ಲೈನ್ಸ್
mere garib nawaz	ಮೇರೆ ಗರೀಬ್ ನವಾಜ್
mere jeevan saathi	ಮೇರೆ ಜೀವನ್ ಸಾಥಿ
meri dosti tera pyar	ಮೇರಿ ದೋಸ್ತಿ ತೇರಾ ಪ್ಯಾರ್
messinia	ಮೆಸಿನಿಯಾ
mia	ಮಿಯಾ
michael	ಮೈಕೇಲ್
michael hussey	ಮೈಕೇಲ್ ಹಸ್ಸೆ
mimi	ಮಿಮಿ
mindo	ಮಿಂದೋ
miraj	ಮಿರಜ್
mirch masala	ಮಿರ್ಚ್ ಮಸಾಲಾ
misaal	ಮಿಸಾಲ್
miss bombay	ಮಿಸ್ ಬಾಂಬೆ
miss mary	ಮಿಸ್ ಮೇರಿ
mohammad	ಮೊಹಮ್ಮದ್ ಇಕ್ಬಾಲ್
mohite	ಮೊಹಿತೆ
montagu	ಮಾಂಟೆಗೊ
moorat	ಮೂರತ್
morepen laboratories	ಮೊರೆಪೆನ್ ಲ್ಯಾಬೊರೇಟರೀಸ್
motherson sumi	ಮದರ್‌ಸನ್ ಸುಮಿ
mradutaa	ಮೃದುತಾ
mrigayu	ಮೃಗಯು
mrinal	ಮೃಣಾಲ್
mrityu	ಮೃತ್ಯು
mrityunjai	ಮೃತ್ಯುಂಜಯಿ
mu'awwiz	ಮುಆವ್ವಿಜ್
mu'azzam	ಮುಅಜ್ಜಮ್
muhafiz	ಮುಹಾಫಿಜ್
muhammad ahmad	ಮುಹಮ್ಮದ್ ಅಹಮದ್
mujaffarpur	ಮುಜಾಫರಪುರ್
muqabala	ಮುಕಾಬಲಾ
muralidhar	ಮುರಳಿಧರ
muriel	ಮೌರಿಲ್
musafir	ಮುಸಾಫಿರ್
mutsu	ಮುಟ್ಸು
muttiah muralitharan	ಮುತ್ತಯ್ಯ ಮುರಳೀಧರನ್
myron	ಮಾಯರನ್
na hone wali baat	ನಾ ಹೋನೆ ವಾಲೀ ಬಾತ್
naag devta	ನಾಗ್ ದೇವತಾ
naamjoshi	ನಾಮ್‌ಜೋಶೀ
nabilah	ನಬೀಲಾಲ್
nagin aur sapera	ನಾಗಿನ್ ಔರ್ ಸಪೆರಾ
nai imarat	ನಯೀ ಇಮಾರತ್
najih	ನಜೀ
nalvadi	ನಲ್ವಾಡಿ
namak	ನಮಕ್
nan	ನನ್
nand ke lala	ನಂದ್ ಕೆ ಲಾಲಾ
naomi awards	ನಯೋಮಿ ಅವಾರ್ಡ್ಸ್
naseerah	ನಸೀರಾ
nasha	ನಶಾ
nasim	ನಸೀಮ
nasir ahmed	ನಾಸಿರ್ ಅಹ್ಮದ್
natalia	ನಟಾಲಿಯಾ
national musem of korea	ನ್ಯಾಶನಲ್ ಮ್ಯೂಸಿಯಂ ಆಫ್ ಕೊರಿಯಾ
nausherwan e adil	ನೌಶೆರವಾನ್ ಎ ಅದಿಲ್
navakrashn	ನವಕೃಷ್ಣ
navendra	ನವೀಂದ್ರ
navratri	ನವರಾತ್ರಿ
naya daur	ನಯಾ ದೌರ್
naya nasha	ನಯಾ ನಶಾ
naya zamana	ನಯಾ ಜಮಾನಾ
nayan mongia	ನಯನ್ ಮೋಗಿಂಯಾ
neelkamal	ನೀಲಕಮಲ್
nehle pe dehla	ನೆಹಲೆ ಪೆ ದೆಹಲಾ
netaajee	ನೇತಾಜೀ
new springs christian	ನ್ಯೂ ಸ್ಪ್ರಿಂಗ್ಸ್ ಕ್ರಿಶ್ಚಿಯನ್
newstime	ನ್ಯೂಸ್‌ಟೈಮ್
nick	ನಿಕ್
nicky	ನಿಕಿ
nieuwersluis	ನ್ಯುವರ್‌ಸ್ಲೂಸ್
nilagriv	ನೀಲಗ್ರೀವ್
nirali duniya	ನಿರಾಲೀ ದುನಿಯಾ
nisa	ನಿಸಾ
niteesh	ನಿತೀಶ್
nitin	ನಿತಿನ್
nizamuddin auliya	ನಿಜಾಮುದ್ದೀನ್ ಔಲಿಯಾ
novartis india	ನೋವಾರ್ಟಿಸ್ ಇಂಡಿಯಾ
numair	ನುಮೈರ್
oarathuppalayam	ಒರಾಥುಪ್ಪಾಯಮ್
oconto	ಅಕೋಂಟೋ
oeleghem	ಓಲಿಗೆಮ್
oliver north	ಓಲಿವರ್ ನಾರ್ಥ್
onkar	ಓಂಕಾರ್
oonch neech	ಊಂಚ್ ನೀಚ್
optimal group	ಆಪ್ಟಿಮಲ್ ಗ್ರೂಪ್
order of national redevelopment merit	ಆರ್ಡರ್ ಆಫ್ ನ್ಯಾಶನಲ್ ರಿಡೆವೆಲಪ್‌ಮೆಂಟ್ ಮೆರಿಟ್
order of ontario	ಆರ್ಡರ್ ಆಫ್ ಓಂಟಾರಿಯೋ
order of the cross of the eagle	ಆರ್ಡರ್ ಆಫ್ ದ ಕ್ರಾಸ್ ಆಫ್ ದ ಈಗಲ್
order of the dutch lion	ಆರ್ಡರ್ ಆಫ್ ದ ಡಚ್ ಲಯನ್
order of the red banner	ಆರ್ಡರ್ ಆಫ್ ದ ರೆಡ್ ಬ್ಯಾನರ್
paapi pet ka sawal hai	ಪಾಪಿ ಪೇಟ್ ಕಾ ಸವಾಲ್ ಹೈ
paavgi	ಪಾವ್‌ಗೀ
pacific rim	ಪೆಸಿಫಿಕ್ ರಿಮ್
pada	ಬಾಡಾ
pahli	ಪಹಲೀ
pahuja	ಪಾಹೂಜಾ
paisa	ಪೈಸಾ
pal	ಪಾಲ್
palnitkar	ಪಲ್ನಿಟ್‌ಕರ್
panamint	ಪೆನಾಮಿಂಟ್
panchkula	ಪಂಚಕುಲಾ
paper products	ಪೇಪರ್ ಪ್ರಾಡೆಕ್ಟ್ಸ್
paramesh	ಪರಮೇಶ
paramita	ಪರಮಿತ
pardes	ಪರದೇಸ್
pardesi mehman	ಪರದೇಸೀ ಮೆಹಮಾನ್
parmameshwar	ಪರಮೇಶ್ವರ
paul simon	ಪೌಲ್ ಸೈಮನ್
paul strang	ಪೌಲ್ ಸ್ಟ್ರಾಂಗ್
pawaskar	ಪಾವಸ್ಕರ್
peace	ಪೀಸ್
peetaabh	ಪೀತಾಭ್
pelly	ಪೆಲ್ಲಿ
peter strasser	ಪೀಟರ್ ಸ್ಟ್ರಾಸರ್
petiwale	ಪೇಟಿವಾಲೆ
phanishwar	ಫಣೀಶ್ವರ್
philantha	ಫಿಲಾಂತಾ
philomena	ಫಿಲೋಮಿನಾ
pointer	ಪಾಯಿಂಟರ್
pope paul	ಪೋಪ್ ಪೌಲ್
porttipahta reservoir	ಪೋರ್ತಿಪಹ್ತಾ ರಿಜರ್ವಾಯರ್
post box	ಪೋಸ್ಟ್ ಬಾಕ್ಸ್
prabath	ಪ್ರಬಾತ್
prahas	ಪ್ರಹಾಸ್
prapti	ಪ್ರಾಪ್ತಿ
pratapgarh	ಪ್ರತಾಪಗರ್
president hayes	ಪ್ರೆಸಿಡೆಂಟ್ ಹಯೀಸ್
preussen	ಪ್ರಿಯುಸೆನ್
prince george christian	ಪ್ರಿನ್ಸ್ ಜಾರ್ಜ್ ಕ್ರಿಶ್ಚಿಯನ್
prix femina	ಪ್ರಿಕ್ಸ್ ಫೆಮಿನಾ
provence	ಪ್ರೋವೆನ್ಸ್
pugree	ಪಗಡೀ
pujari	ಪುಜಾರಿ
pujit	ಪೂಜಿತ್
punia	ಪುನಿಯಾ
punita	ಪುನೀತ
punjab express (new)	ಪಂಜಾಬ್ ಎಕ್ಸ್‌ಪ್ರೆಸ್ (ನ್ಯೂ)
purna	ಪೂರ್ಣ
purnendu	ಪೂರ್ಣೇಂದು
pushpinder	ಪುಷ್ಪಿಂದರ್
pyar ka sagar	ಪ್ಯಾರ್ ಕಾ ಸಾಗರ್
pyar ki baaten	ಪ್ಯಾರ್ ಕಿ ಬಾತೇ
pyara dushman	ಪ್ಯಾರಾ ದುಶ್ಮನ್
pyasi sham	ಪ್ಯಾಸಿ ಶಾಮ್
qadim	ಕಾದಿಮ್
qamar	ಕಮರ್
queen’s university belfast	ಕ್ವೀನ್ಸ್ ಯುನಿವರ್ಸಿಟಿ ಬೆಲ್ಫಾಸ್ಟ್
quetzal	ಕ್ವೆಜಾಲ್
raajavraksh	ರಾಜವೃಕ್ಷ
raani	ರಾನೀ
radhakrishn	ರಾಧಾಕೃಷ್ಣ
raeesah	ರಯೀಸಾಹ್
rahnuma	ರಹನುಮಾ
rajata	ರಜತಾ
rajkumari	ರಾಜಕುಮಾರಿ
ram laxman	ರಾಮ್ ಲಕ್ಷ್ಮಣ್
ramiro	ರಮಿರೊ
rampratap	ರಾಮಪ್ರತಾಪ್
randy	ರೇಂಡಿ
rangeela	ರಂಗೀಲಾ
rangeela raja	ರಂಗೀಲಾ ರಾಜಾ
ranthambhore fort	ರಣತಂಬೋರ್ ಫೋರ್ಟ್
ratnapriya	ರತ್ನಪ್ರಿಯ
rea	ರಿಯಾ
reba mcentire	ರೀಬಾ ಮೆಕೆಂಟೈರ್
renu	ರೇಣು
research in motion limited	ರಿಸರ್ಚ್ ಇನ್ ಮೋಷನ್ ಲಿಮಿಟೆಡ್
reshmi sari	ರೇಶಮೀ ಸಾಡಿ
rewadikar	ರೆವಾಡಿಕರ್
rexam	ರೆಕ್ಸಾಮ್
rhone	ರೋನ್
richard gabriel	ರಿಚರ್ಡ್ ಗೇಬ್ರಿಯಲ್
rikshawala	ರಿಕ್ಷಾವಾಲಾ
rimjhim geeton ki	ರಿಮ್ ಜಿಮ್ ಗೀತೋಂ ಕಿ
risa	ರೀಜಾ
rishabh	ರಿಷಭ್
robert	ರಾಬರ್ಟ್
robert atkins	ರಾಬರ್ಟ್ ಅಟ್ಕಿನ್ಸ್
rocco	ರೊಕೊ
rochan	ರೋಚನ್
romney	ರಾಮ್ನಿ
ronda	ರೋಂಡಾ
roop kahani	ರೂಪ್ ಕಹಾನಿ
rossa	ರೊಸಾ
rozalia	ರೋಝಾಲಿಯಾ
rugby	ರಗ್ಬಿ
ruksana	ರುಕ್ಸಾನಾ
russo-turkish war	ರಸ್ಸೊ-ಟರ್ಕಿಶ್ ವಾರ್
saburah	ಸಬುರಾ
sachet	ಸಚೆತ್
safeer	ಸಫೀರ್
saful islam	ಸಫುಲ್ ಇಸ್ಲಾಂ
saggu	ಸಗ್ಗು
sahaj	ಸಹಜ್
sailaab	ಸೈಲಾಬ್
saluja	ಸಲೂಜಾ
samhita	ಸಂಹಿತಾ
samudrasen	ಸಮುದ್ರಸೇನ್
san remo music festival	ಸ್ಯಾನ್ ರೆಮೊ ಮ್ಯೂಸಿಕ್ ಫೆಸ್ಟಿವಲ್
sandhar	ಸಂಧರ್
sanghod	ಸಂಘೋಡ್
sanjula	ಸಂಜುಲಾ
sanne	ಸೇನಿ
santour	ಸಂಟಾರ್
sarada	ಸಾರದಾ
sarangi	ಸಾರಂಗಿ
saratoga	ಸರಾಟೋಗಾ
sarkari mehman	ಸರಕಾರಿ ಮೆಹಮಾನ್
saudanttikar	ಸೌದತ್ತೀಕರ್
saumarez	ಸಾಮರೆಜ್
sayf	ಸೈಫ್
saza e maut	ಸಾಜಾ ಎ ಮೌತ್
schock prize in mathematics	ಸ್ಕೋಕ್ ಪ್ರೈಜ್ ಇನ್ ಮ್ಯಾಥಮೆಟಿಕ್ಸ್
score	ಸ್ಕೋರ್
scottish football museum	ಸ್ಕಾಟಿಶ್ ಫುಟ್‌ಬಾಲ್ ಮ್ಯೂಸಿಯಂ
sene	ಸೆನಿ
sesa goa	ಸೀಸಾ ಗೋವಾ
sevaram	ಸೇವಾರಾಮ್
sew shivnarine	ಶಿವ್ ಶಿವನಾರಾಯಣ್
seymour	ಸೀಮೋರ್
shaankar	ಶಾಂಕರ್
shahdol	ಶಾದೂಲ್
shaheed	ಶಹೀದ್
shahriar hossain	ಶಹರಿಯಾರ್ ಹುಸೇನ್
shaitan	ಶೈತಾನ್
shake hands	ಶೇಕ್ ಹ್ಯಾಂಡ್ಸ್
shan-e-hind	ಶಾನ್-ಎ-ಹಿಂದ್
shanbaree	ಶಂಬರೀ
shanon	ಶೆನನ್
shark	ಶಾರ್ಕ್
shaun	ಶೌನ್
sheehan	ಶೀಹನ್
shendaye	ಶೆಂಡಯೆ
shibani	ಶಿಬಾನಿ
shotley battery	ಶೋಟ್ಲೆ ಬ್ಯಾಟರಿ
shreyashi	ಶ್ರೇಯಶಿ
shrinivas	ಶ್ರೀನಿವಾಸ್
shumaysah	ಶುಮಾಷಾ
shyamal	ಶ್ಯಾಮಲ
sidki	ಸಿದಕಿ
sigmund freud	ಸಿಗ್ಮಂಡ್ ಫ್ರಾಯ್ಡ್
sine	ಸೈನ್
sirius	ಸಿರಿಯಸ್
sirohi	ಸಿರೋಹಿ
siya	ಸಿಯಾ
skillsoft	ಸ್ಕಿಲ್‌ಸಾಫ್ಟ್
skipper	ಸ್ಕಿಪರ್
slough fort	ಸ್ಲೌಗ್ ಫೋರ್ಟ್
smita	ಸ್ಮಿತ
sohni mahiwal	ಸೋಹನೀ ಮಹಿವಾಲ್
somnath jyotirlinga	ಸೋಮನಾಥ ಜ್ಯೋತಿರ್ಲಿಂಗ
soryu	ಸೋರ್ಯೂ
spence	ಸ್ಪೆನ್ಸ್
speranza	ಸ್ಪೆರಾಂಜ
srapanch	ಸರಪಂಚ್
srisailam	ಶ್ರೀಶೈಲಂ
steffi	ಸ್ಟೆಫಿ
steve elworthy	ಸ್ಟೀವ್ ಎಲ್ವರ್ದಿ
stuti	ಸ್ತುತಿ
suhaas	ಸುಹಾಸ್
suhaylah	ಸುಹೇಲಾ
sumter	ಸಮ್ಟರ್
suprabha	ಸುಪ್ರಭಾ
supreme ind	ಸುಪ್ರೀಂ ಇಂಡ್
suresh	ಸುರೇಶ್
suresh raina	ಸುರೇಶ್ ರಾಯನ್
suzy-q	ಸೂಜೀ-ಕ್ಯೂ
swaminath	ಸ್ವಾಮಿನಾಥ್
swaroop	ಸ್ವರೂಪ್
tala	ಟಾಲಾ
taner ansari	ತನೇರ್ ಅನ್ಸಾರಿ
tanuja	ತನುಜಾ
tapas	ತಪಸ್
tarannum	ತರನ್ನುಮ್
tarantella	ಟಾರೆಂಟೆಲ್ಲಾ
tarunaa	ತರುಣಾ
tata elxsi	ಟಾಟಾ ಎಲೆಕ್ಸಿ
tavse	ತಾವ್ಸೆ
teesri	ತೀಸರೀ
teledata	ಟೆಲಿಡೇಟಾ
teleri	ಟೆಲೇರಿ
thakare	ಥಾಕರೆ
the assam tribune	ದ ಅಸ್ಸಾಮ್ ಟ್ರಿಬ್ಯೂನ್
the doon school, dehradun	ದ ದೂನ್ ಸ್ಕೂಲ್, ಡೆಹ್ರಾಡೂನ್
the oriya samaja	ದ ಒರಿಯಾ ಸಮಾಜ
tibbi	ತಿಬ್ಬಿ
tierney	ಟಿಯರ್ನಿ
tim allan	ಟಿಮ್ ಅಲನ್
timila	ತಿಮಿಲಾ
toiyabe	ಟೊಯಬೆ
tooba	ತೂಬ
trevor jesty	ಟ್ರೆವರ್ ಜೆಸ್ಟಿ
trevor madondo	ಟ್ರೆವರ್ ಮರ್ಡೊಂಡೊ
triborough	ಟ್ರಿಬೋರೋ
triguna	ತ್ರಿಗುಣ
tumhare bina	ತುಮ್ಹಾರೆ ಬಿನಾ
turkana	ತುರ್ಕಾನಾ
turkey trot	ಟರ್ಕಿ ಟ್ರಾಟ್
two-step	ಟೂ-ಸ್ಟೆಪ್
twyla	ಟ್ವೈಲಾ
tyrrhenian	ತೈಹಿನಿಯನ್
umrao jaan	ಉಮರಾವೋ ಜಾನ್
university of bristol	ಯುನಿವರ್ಸಿಟಿ ಆಫ್ ಬ್ರಿಸ್ಟಲ್
university of colorado	ಯುನಿವರ್ಸಿಟಿ ಆಫ್ ಕೊಲರೆಡೊ
university of nottingham	ಯುನಿವರ್ಸಿಟಿ ಆಫ್ ನಾಟಿಂಗ್‌ಹ್ಯಾಮ್
university of technology	ಯುನಿವರ್ಸಿಟಿ ಆಫ್ ಟೆಕ್ನಾಲಜಿ
unnati	ಉನ್ನತಿ
ununbium	ಯುನುನ್ಬಿಯಂ
urmimala	ಊರ್ಮಿಳಾ
urooj	ಉರೂಜ್
urwah	ಊರ್ವಾ
vagdevi	ವಾಗ್‌ದೇವಿ
vairaj	ವೈರಾಜ್
valentina	ವ್ಯಾಲಂಟಿನಾ
valsad	ವಲ್ಸಾಡ್
valtina	ವೆಲ್ಟಿನಾ
vanadium	ವನಡಿಯಂ
vanhi	ವನ್ಹಿ
varick	ವೈರಿಕ್
vijaya bank	ವಿಜಯಾ ಬ್ಯಾಂಕ್
vikram vetal	ವಿಕ್ರಮ್ ಬೇತಾಲ್
viveka	ವಿವೇಕಾ
walkley	ವಾಕ್ಲೆ
walter scott	ವಾಲ್ಟರ್ ಸ್ಕಾಟ್
waltz	ವಾಲ್ಟ್‌ಸ್
war of the grand alliance	ವಾರ್ ಆಫ್ ದಿ ಗ್ರಾಂಡ್ ಅಲಯನ್ಸ್
wilson	ವಿಲ್ಸನ್
woodrow	ವುಡ್‌ರೋ
world association of newspapers's golden pen of freedom award	ವರ್ಲ್ಡ್ ಅಸೋಸಿಯೇಶನ್ ಆಫ್ ನ್ಯೂಸ್ ಪೇಪರ್ಸ್ ಗೋಲ್ಡನ್ ಪೆನ್ ಆಫ್ ಫ್ರೀಡಂ
wren	ರೆನ್
wuankara	ವಾಂಕರಾ
wyndham	ವಿಂಧಮ್
yaachit	ಯಾಚಿತ್
yaar kasam	ಯಾರ್ ಕಸಮ್
yashasvee	ಯಶಸ್ವೀ
yauvani	ಯೋವನಿ
yuktika	ಯುಕ್ತಿಕಾ
zakhmi zameen	ಜಖ್ಮೀ ಜಮೀನ್
zameen aasman	ಜಮೀನ್ ಆಸಮಾನ್
zanthe	ಜಾಂಥೆ
zareh	ಜಾರೇ
zimmedaar	ಜಿಮ್ಮೆದಾರ್
zurich financial services	ಜ್ಯೂರಿಕ್ ಫೈನಾನ್ಷಿಯಲ್ ಸರ್ವಿಸಸ್
