aalto	אלטו
aamir	עאמיר
aarhus	ארהוס
aaronsohn	ארונסון
aatef	עאטף
ababa	אבאבא
ababil	אבאביל
abadan	עבדאן
abane	עבאן
abba	אבא
abbas	עבאס
abbass	עבאס
abbassi	עבאסי
abboud	עבוד
abdallah	עבדאללה
abdoh	עבדו
abdou	עבדו
abdoulaye	עבדולאי
abduh	עבדוה
abdulaziz	עבדולעזיז
abdullah	עבדאללה
abebe	אביבי
abedi	עבידי
abel	אבל
abeokuta	אביוקוטא
abercrombie	אברקרומבי
abhur	אבחור
abie	אבי
abigail	אביגייל
abkhazia	אבחאזיא
abraham	אברהם
abrahams	אבראהאמז
abraj	אבראג'
absalom	אבסאלום
abud	עבعד
acasuso	אקאסוסו
accademia	אקאדימיה
accra	אקרא
ackerman	אקרמאן
aconcagua	אקונקאגוא
acosta	אקוסטא
acrobat	אקרובאט
acuna	אקונא
acutifolia	אקיוטיפוליא
adair	אדייר
adam	אדם
adan	אדן
adana	עדאנא
ade	עאד
adel	עאדל
adelaide	אדיליاד
adelstein	אדלסטין
aden	עדן
adhan	אדאן
adi	עדי
adib	אדיב
adidas	אדידס
adir	אדיר
adivasi	אדיבאסי
adler	אדלר
adnan	עדנאן
adolf	אדולף
adolph	אדולף
adonis	אדוניס
adorno	אדורנו
adrian	אדריאן
adriana	אדריאנא
adriano	אדריאנו
adriatic	אדריאטיק
advocaat	אדבוקאט
adwan	עדואן
adygea	אדיגיא
aeroflot	אירופלוט
aes	איס
afar	עפאר
affleck	אפליק
afghani	אפגאני
afghanistan	אפגנסיטאן
afia	עאפיה
africa	אפריקא
afrikaner	אפריקאנר
agab	עגב
again	אגיין
agam	עגם
agassi	אגאסי
agatha	אגאתא
aghahowa	אגאהווא
aghily	עגילי
agnon	עגנון
agranat	אגרנט
agrippa	אגריפא
aguero	אגוירו
aguilar	אגוילאר
aguilera	אגוילירא
aharon	אהרון
ahern	אהירן
ahmad	אחמד
ahmed	אחמד
aikido	איקידו
aimar	אימאר
aires	אריס
aissati	עיסאטי
ajab	עג'ב
ajax	איג'אקס
ajram	ע'גרם
ak	אק
akaki	אקאקי
akayev	אקאייב
akhalkalaki	אכאלקאלאקי
akhmeteli	אכמיטילי
akihito	אקיהיטו
akkad	עקאד
akl	עקל
akrour	עקרור
alaam	עאלם
alahram	אלאהראם
alaidy	אלעאידי
alain	אליין
alali	אלעלי
alalwani	אלעלואני
alami	עלמי
alan	אלן
alansari	אלאנסארי
alanwar	אלאנואר
alaska	אלאסקא
alaskan	אלסקאן
alassad	אלאסד
albaath	אלבעת
albahri	אלבחרי
albania	אלבניה
albanian	אלבייניאן
albanna	אלבנא
albari	אלבארי
albayrak	אלבאירק
albayyati	אלבאיאטי
albert	אלברט
alberta	אלברטא
alberto	אלברטו
albi	אלבי
albin	אלבין
album	אלבום
alcntara	אלקנטארא
aldair	אלדייר
aldo	אלדו
aldrin	אלדרין
alec	אליק
alegre	אליגרי
aleksander	אלקסנדר
aleksandr	אלקסנדר
aleksei	אלקסיי
aleman	אלימאן
alex	אלקס
alexandra	אלקסנדרא
alexandre	אלקסנדר
alexandrina	אלקסאנדרינא
alexei	אליקסיי
alfa	אלפא
alfida	אלפידא
alfons	אלפונס
alfonso	אלפונסו
alfredo	אלפרידו
alghifari	אלגיפארי
alhamadi	אלחמאדי
ali	עלי
alia	עליא
aliaksandr	אליאקסאנדר
alice	אליס
alicia	אליסיא
alighieri	אליגיירי
alikhani	עליחאני
alina	אלינא
alioui	עליוי
aliqulov	עליקולוב
alisfahani	אלאיספהאני
alistair	אליסטיר
aliyev	עלייב
aljabal	אלג'בל
aljaber	אלג'אבר
aljaldaki	אלג'לדאקי
alla	עלא
allah	אללה
allal	עלאל
allam	עלאם
allan	אלאן
allen	אלן
allenby	אלנבי
allianz	אליאנז
alloudi	עלודי
allouni	עלוני
allyson	אליסון
almahdi	אלמהדי
almaimani	אלמאימני
almajid	אלמג'יד
almanfaluti	אלמנפלוטי
almaszadeh	אלמאסזאדה
almaty	אלמאטי
almeida	אלמידא
almenbar	אלמנבר
almeyda	אלמידא
almodovar	אלמודובאר
almog	אלמוג
almunia	אלמוניא
almurshid	אלמורשיד
alnemri	אלנמרי
aloni	אלוני
alonzo	אלונזו
aloysius	אלאוישס
alshahid	אלשהיד
alsiqilli	אלסיקילי
alta	אלטא
altai	אלטאי
altman	אלטמאן
alton	אלטון
alvarado	אלבאראדו
alvaro	אלבארו
alzheimer	אלזהאימר
amal	אמל
amalia	אמאליא
amanda	אמאנדא
amapa	אמאפא
amar	עמאר
amartya	אמארטיא
amatzia	אמציה
ambrose	אמברוס
amedeo	אמידיו
amer	עאמר
american	אמריקן
ami	עאמי
amichai	עמיחי
amin	אמין
amioun	אמיון
amir	עאמיר
amira	אמירה
amit	אמית
amitav	אמיטב
amman	עמאן
ammar	עמאר
ammonium	אמוניום
amnon	אמנון
amor	עמור
amos	עמוס
amr	עמר
amram	עמרם
amritsar	אמריטסאר
amsterdam	אמסטרדאם
amundsen	אמונדסן
amuneke	אמוניק
amuro	אמורו
an	אן
ana	אנא
anabta	ענאבטא
anaheim	אנאהאים
anand	אנאנד
anastasia	אנאסטייז'ה
anastasius	אנאסטאסיוס
anatol	אנאטול
anatoly	אנאטולי
ander	אנדר
anders	אנדרז
andersen	אנדרסן
anderssen	אנדרסן
andoni	אנדוני
andorra	אנדורא
andranik	אנדראניק
andre	אנדריי
andrea	אנדריא
andreas	אנדריאס
andres	אנדריס
andresen	אנדרסן
andrew	אנדרו
andrey	אנדריי
andria	אנדריא
andriy	אנדרי
andronicus	אנדרוניקוס
ang	אנג
angela	אנגילא
angeles	אנג'ליס
anglia	אנגליא
ani	אני
animaniacs	אנימאניאקס
anita	אניטא
anka	אנקא
ankara	אנקרה
anna	אנא
annabi	ענאבי
annan	ענאן
anne	ען
annie	אני
anno	אנו
annunziata	אנונסיאטא
anomer	אנומר
anselm	אנסילם
anselmo	אנסילמו
antalya	אנטאליא
antananarivo	אנטאנאנאריבו
antar	ענטר
antarctica	אנטארקטיקא
anthony	אנתוני
anton	אנטון
antonescu	אנטוניסקו
antonia	אנטוניא
antonin	אנטונין
antonius	אנטוניוס
anubis	אנוביס
aono	אונו
aosta	אוסטא
aoun	עאון
aphrodite	אפרודאיטי
apocalyptica	אפוקאליפטיקא
apollinaris	אפולינאריס
apollo	אפולו
apolo	אפולו
apophis	אפופיס
apostol	אפוסטול
apso	אפסו
apulia	אפוליא
aqaba	עקבה
aquitaine	אקויטיין
ara	ערא
arabian	ארייביאן
aractingi	ערקטינגי
arad	אראד
arae	אראי
arafat	ערפאת
aramid	אראמיד
arana	אראנא
aranha	אראנא
arar	עראר
arazi	ארזי
arba	ארבע
arbel	ארביל
arbid	ערביד
arbil	ארביל
arca	ארקא
ardahan	ארדאהאן
ardashir	ארדשיר
ardiles	ארדיליס
aref	עארף
arghun	ארגון
ariadne	אריאדני
arief	עריף
ariel	אריאל
arik	אריק
aristide	אריסטיד
aristides	אריסטידיס
aristizabal	אריסטיזאבאל
aritomo	אריטומו
arizona	אריזונא
arjun	ארג'ון
arkansas	ארקנסו
arkhangelsk	ארכאנגילסק
arlen	ארלין
armando	ארמאנדו
armenia	ארמיניא
armia	ארמיא
armin	ארמין
arnaud	ארנו
arnaut	ארנוט
arne	ארני
arnon	ארנון
aron	ארון
arraba	אראבא
ars	ארס
arsen	ארסן
arshavin	ארשאבין
arslan	ארסלאן
artem	ארטים
artemis	ארטימיס
arthur	ארתור
arturo	ארטורו
artzi	ארצי
arun	ארון
arutz	ערוץ
asad	אסד
asaf	עסאף
asahara	אסאהארא
asakir	עסאקיר
asamoah	אסאמוא
asatiani	אסאטיאני
ascii	אסקי
ascoli	אסקולי
ash	אש
ashcroft	אשקרופט
ashdod	אשדוד
ashdown	אשדאון
asher	אשר
ashkenazi	אשכנזי
ashley	אשלי
ashour	עאשור
ashraf	אשרף
ashrawi	עשראוי
asi	עאסי
asia	איז'א
asier	אסייר
asik	אסיק
asimo	אסימו
aslan	אסלאן
asmahan	אסמהאן
asmara	אסמרא
asror	אסרור
assad	אסד
assaf	עסאף
assem	עאסם
assi	עאסי
assia	אסיא
assisi	אסיסי
assoumani	עסומאני
asti	אסטי
aston	אסטון
astrid	אסטריד
astro	אסטרו
asturias	אסטוריאס
asuncion	אסונסיון
ata	עטא
atar	עטאר
atarot	עטרות
ataturk	אטאטורק
atef	עאטף
athletic	אתלטיק
athos	אתוס
atkinson	אטקינסון
atlantic	אטלאנטיק
atlas	אטלס
atletico	אטלטיקו
atomic	אטומיק
attenborough	אטנבורו
attia	עטיה
attias	אטיאס
attica	אטיקא
atwood	אטווד
aubrey	אוברי
audin	אודן
audo	אודו
audrey	אודרי
augsburg	אוגסברג
augusta	אוגוסטא
auguste	אוגסט
augustin	אוגסטין
augusto	אוגוסטו
auhah	עוהה
aumann	אומאן
aung	אונג
aurel	אורל
aurelius	אוריליוס
austin	אוסטין
australia	אוסטראליא
austria	אוסטריא
avalon	אבאלון
avigdor	אביגדור
avishai	אבישי
avivim	אביבים
avner	אבנר
avni	אבני
avogadro	אבוגאדרו
avraham	אברהם
avram	אברם
avril	אבריל
avro	אברו
avshalom	אבשלום
avtovaz	אבטובאז
awad	עוואד
axum	אקסום
ayache	עיאש
ayala	איילה
ayalon	אילון
ayan	עיאן
ayil	עאיל
ayman	איימאן
ayoob	איוב
ayouch	עיוש
ayoun	עיון
ayrshire	אירשאיר
ayrton	אירטון
ayyash	עיאש
azad	אזאד
azali	אזאלי
azar	אזאר
azarenka	אזארינקא
azd	אזד
azilal	אזילאל
aziz	עזיז
azizi	עזיזי
azizou	עזיזו
azmi	עזמי
azouz	עזוז
azzam	עזאם
ba	בא
baal	בעל
baalbek	בעלבק
baba	באבא
babacan	באבאקאן
babacar	באבאקר
babangida	באבנגידא
babi	באבי
babylon	באבילון
bacardi	באקארדי
bacary	בקארי
bacau	באקאו
bachchan	באצ'אן
bachelet	באשילה
bachir	בשיר
bachmann	באכמאן
bacon	בייקון
badalona	באדאלונא
badar	בדר
bader	באדר
badilla	באדילא
badir	באדר
badoglio	באדוליו
badou	באדו
badr	בדר
badran	בדראן
badu	בדו
baecke	בקי
baekeland	ביקלאנד
baer	באיר
baeyer	באיר
baeza	באיזא
bagayoko	באגאיוקו
bagdadi	בגדאדי
baghdad	בגדאד
baghdadi	בגדאדי
bagheri	באגרי
bah	באה
bahadori	בהאדורי
bahamas	באהאמאס
bahar	בחר
baher	באהר
bahi	באהי
bahia	באהיא
bahir	בהיר
bahja	בהג'א
bahnini	בחניני
bahr	בחר
bahrain	בחריין
bahram	בהראם
bahrani	בחראני
bahro	באהרו
bai	באי
baibars	באיבארס
baidachny	באידאצ'ני
baikal	באיקאל
bajer	באיר
bajram	באירם
bak	באק
bakala	באקאלא
bakar	בקר
bakari	באקארי
bakdash	בקדאש
baker	בייקר
bakhit	בכיט
bakhoum	באכום
bakhtiar	בכטיאר
bakkati	בקאטי
bakr	בקר
bakri	בקרי
bakshi	באקשי
baku	באקו
balaban	באלאבאן
balash	בלאש
balaton	באלאטון
balbo	באלבו
balboa	באלבוא
balde	באלדי
baldry	באלדרי
baldur	באלדור
bale	בייל
balel	באלל
balhous	בלחוס
bali	באלי
baligh	באליג
balint	באלינט
baljic	באליטש
balkan	בלקאן
balkans	באלקאנז
ballesta	באייסטא
ballistic	באליסטיק
ballmer	באלמר
ballut	בלוט
balmer	באלמר
balmont	באלמונט
baloncieri	באלונשיירי
balotelli	באלוטילי
baloyi	באלויי
baltaah	בלטעה
baltasar	באלטאסאר
balti	באלטי
baltimore	באלטימור
bamako	באמאקו
bambang	באמבאנג
bambi	באמבי
bamir	באמיר
bamlett	באמלט
bammer	באמר
bamrung	באמרונג
bamyan	באמיאן
banach	באנאך
banana	בננה
bancarel	באנקאריל
bandar	באנדאר
bandaranaike	באנדאראנאיקה
bandeira	באנדירא
banderas	באנדיראס
bandler	באנדלר
bando	באנדו
bangalore	באנגאלור
bangka	באנגקא
bangkok	באנקוק
bangladesh	בנגלאדש
bangoura	באנגורא
banjo	באנג'ו
banks	באנקס
banksy	באנקסי
bannatyne	באנאטין
bantustan	באנטוסטאן
bar	באר
barack	ברק
baraja	באראכא
barak	ברק
baram	באראם
baramidze	באראמידזה
barazite	באראזאיט
barbados	בארבאדוס
barbara	בארברא
barbarossa	בארבארוסא
barbera	בארבירא
barbosa	בארבוסא
barbour	בארבור
barbra	בארברא
barcelata	בארסילאטא
barcham	ברצ'ם
barclay	בארקליי
bardem	בארדם
bardon	בארדון
bardsley	בארדסלי
barenboim	בארינבוים
baresi	באריזי
barghouti	ברגותי
barhom	ברהום
baric	באריטש
barison	באריסון
barka	ברקה
barker	בארקר
barkley	בארקלי
barlach	בארלאך
barmada	ברמדא
barmos	בארמוס
barnaul	בארנול
barnea	בארניא
barnet	בארניט
barnetta	בארניטא
baronio	בארוניו
baroti	בארוטי
baroud	בארוד
barr	בר
barragan	בראגאן
barrancos	באראנקוס
barranquilla	באראנקוילא
barro	בארו
barron	בארון
barroso	בארוסו
barry	בארי
barrymore	בארימור
bart	בארט
barthes	בארט
barthez	בארטיז
bartlett	בארטלט
bartoli	בארטולי
bartolomeo	בארטולומיו
bartolucci	בארטולוצ'י
barton	בארטון
bartosz	בארטוש
bartter	בארטר
baruch	ברוך
barukh	ברוך
barusso	בארוסו
barzagli	בארזאלי
basel	באסל
basescu	באסיסקו
bashar	בשאר
bashi	באשי
bashir	בשיר
basho	באשו
basil	באסל
basile	באסיל
basinas	באסינאס
basinger	באסינגר
basler	באסלר
basma	בסמה
basri	בסרי
bassala	באסאלא
bassel	באסל
bassem	באסם
bassi	באסי
bassila	באסילא
bassim	באסים
basten	באסטן
bastian	באסטיאן
basto	באסטו
batatu	בטאטו
bataysk	באטאיסק
bates	בייטס
bathory	באטורי
batista	באטיסטא
batistuta	באטיסטוטא
batlles	באטלס
batman	באטמאן
batroun	בטרון
bats	באטס
batt	באט
batta	באטא
batteux	באטו
battir	בטיר
battista	באטיסטא
battisti	באטיסטי
battiston	באטיסטון
batu	באטו
bau	בו
baudelaire	בודליר
baudrillard	באודרילארד
bauer	באוור
bauhaus	באוהאוס
baume	בום
bay	ביי
bayda	ביידא
bayer	באיר
bayezid	באיזיד
baykal	באיקאל
bayoumi	באיומי
bayrou	באירו
baysse	באיס
bazooka	באזוקא
bazzani	באזאני
bea	בי
beadle	בידל
beardsley	בירדזלי
bearzot	בירזוט
beatrice	ביאטריס
beatrix	ביאטריקס
bebeto	ביביטו
becher	בישר
beckenbauer	בקנבאור
becker	בקר
beckham	בקהאם
beda	בידא
bedi	בדי
bedjaoui	בג'אוי
bedrich	בדריש
beenhakker	בינהאקר
beer	ביר
begag	בגאג
begin	בגין
behan	ביהאן
behcet	בהקט
behrami	בהראמי
behtash	בהטאש
behzadi	בהזאדי
beidas	ביידאס
beilin	בילין
beinisch	ביניש
beirut	בירות
beiteinu	ביתנו
bejbl	בייבל
bek	בק
bela	בילא
belaid	בילייד
belal	בלאל
belarus	בלארוס
belaya	בילאיא
belgrade	בלגראד
belgrano	בילגראנו
belhadj	בלחאג'
belin	בילין
belitung	בליטונג
belize	בליז
belkacem	בלקאסם
bell	בל
bella	בילא
bellamy	בילאמי
belleri	בלירי
bellini	ביליני
bellion	בליון
bello	בלו
bellone	בילוני
belloumi	בלומי
bellugi	בלוגי
belmondo	בלמונדו
belmont	בלמונט
belo	בלו
belozoglu	בילוזוגלו
belqas	בלקאס
belqola	בלקולה
belyzel	ביליזל
bem	בם
ben	בן
benaderet	בנאדרת
benaglio	בינאגליו
benayahu	בנאיאהו
bendtner	בנדטנר
bene	בני
benedetto	בינידטו
benedict	בנדיקט
benedictine	בינידיקטין
benelux	בנילוקס
benenson	ביניסון
benes	בנס
benetti	בניטי
benghazi	בנגאזי
benhassi	בנחסי
benicio	ביניסיו
benigni	בניני
benin	בנין
benitez	ביניטיז
benito	ביניטו
benjamin	בנג'אמין
benjani	בנג'אני
benko	בינקו
benn	בן
benneteau	בניטו
bennett	בנט
benni	בני
bennington	בנינגטון
bennis	בניס
benno	בינו
benny	בני
benoit	בינוא
benson	בנסון
bent	בנט
bentley	בנטלי
benyamin	בנימין
benz	בנז
benzarti	בנזארטי
bercellino	ברצ'לינו
berdych	בירדיטש
berezutski	ברזוצקי
berg	בירג
berger	ברגר
bergeroo	בירגירו
berggreen	ברגרין
berggren	בירגרין
bergman	ברגמאן
bergmann	ברגמאן
bergomi	בירגומי
bergougnoux	בירגוניו
bergson	ברגסון
bering	בירינג
berkeley	בירקלי
berkman	בירקמאן
berkshire	בירקשיר
berl	בירל
berlin	ברלין
berliner	ברלינר
berlioz	בירליוז
berlusconi	ברלסקוני
berman	ברמאן
bermuda	ברמודא
bernadette	ברנאדיט
bernadotte	ברנאדוט
bernal	ברנאל
bernanke	בירנאנקי
bernard	ברנאר
bernardino	ברנארדינו
bernardo	ברנארדו
bernays	ברנייז
berne	ברן
berner	בירנר
bernhard	ברנהארד
berni	בירני
bernie	ברני
berrer	בירר
berri	ברי
berry	בירי
bert	ברט
bertelsen	בירטילסן
berthod	בירתוד
berthold	בירתולד
berti	ברטי
bertie	בירטי
bertin	ברטין
bertine	ברטין
bertini	ברטיני
berto	בירטו
bertoli	בירטולי
bertolt	ברטולט
bertos	בירטוס
bertrand	ברטראנד
besant	ביזנט
beschastnykh	ביצ'אסטניך
besheer	בשיר
beslan	בסלאן
bessemer	בסימר
besson	בסון
best	בסט
betancourt	ביטאנקורט
beth	בת
bethesda	ביתיסדא
betta	ביטא
bette	ביט
bettega	ביטיגא
bettini	ביטיני
bettino	בטינו
bettiol	ביטיול
beynie	בייני
beyonce	ביונסי
bezalel	בזלאל
bezos	ביזוס
bg	בג
bhamdoun	בחמדון
bharrat	באראט
bhatia	באטיא
bhutto	בוטו
biaggio	ביאג'יו
bianca	ביאנקא
biber	ביבר
bibi	ביבי
bidatsu	בידאטסו
bidouane	בדואן
biella	ביילא
bielsa	בילסא
big	ביג
bigeard	ביגירד
bigogno	ביגוניו
bigon	ביגון
bihar	ביחאר
bijeljina	ביילינא
bijotat	ביג'וטאט
bikey	באיקי
bikila	ביקילא
bikin	ביקין
bila	בילא
bilady	בילאדי
bilal	בילאל
bilharz	בילהארץ
bilic	ביליטש
bilirubin	בילירובין
bill	ביל
billel	בילל
billie	בילי
billong	בילונג
billstrom	בילסטרום
billy	בילי
bimkom	במקום
bin	בין
binet	בינה
bingu	בינגו
binoche	בינוש
binyamin	בנימין
birak	ביראק
birgit	בירגיט
birnbaum	בירנבאום
biros	בירוש
birsk	בירסק
birtles	בירטלז
bisha	בישה
bismarck	ביסמארק
bismillah	ביסמילה
bissau	ביסאו
bisset	ביסה
bit	ביט
bitar	ביטאר
bitat	ביטאט
bixente	ביסינטי
bizimungu	ביזימונגו
bjarne	ביארן
bjarni	ביארני
bjorkman	ביורקמאן
bjorn	ביורן
bksy	בקסי
blaby	בלייבי
blackstone	בלאקסטון
blagoja	בלאגויה
blaine	בליין
blair	בלייר
blaise	בלייז
blake	בלייק
blanchett	בלאנצ'ט
blanco	בלאנקו
blanka	בלאנקא
blas	בלאס
blasi	בלאזי
blass	בלאס
blatter	בלאטר
blazej	בלאזיי
blazek	בלאזיק
bledel	בלדל
bliss	בליס
blitzer	בליצר
bloch	בלוך
blok	בלוק
blokhin	בלוכין
blondeau	בלונדו
bloom	בלום
bluetooth	בלוטות'
bluitgen	בלוטגן
blum	בלום
blumenthal	בלומנתאל
blunt	בלאנט
bnei	בני
bo	בו
boakye	בואקיה
boateng	בוטינג
boaz	בועז
bob	בוב
bobadilla	בובאדילא
boban	בובאן
bobby	בובי
bobo	בובו
bocelli	בוצ'לי
boco	בוקו
bodart	בודארט
bodo	בודו
bodom	בודום
bodrum	בודרום
boeing	בואינג
bogart	בוגארט
bogdan	בוגדאן
bogota	בוגוטא
bohdan	בודאן
bohlen	בולן
bohlin	בוהלין
bohm	בום
boiany	בויאני
bois	בווא
boissier	בויסייר
boka	בוקא
bola	בולא
boland	בולאנד
bolelli	בולילי
boleyn	בולין
bolkiah	בולקיה
boll	בול
bollettieri	בוליטיירי
boloni	בולוני
bolt	בולט
boltzmann	בולצמאן
bolzano	בולזאנו
bomis	בומיס
bommer	בומר
bonaire	בונייר
bonano	בונאנו
bondarenko	בונדארינקו
bonera	בונירא
bonetto	בוניטו
bongani	בונגאני
bongartz	בונגארץ
bongo	בונגו
boniek	בוניק
bonn	בון
bonnard	בונארד
bonner	בונר
bonnet	בוניט
bonnie	בוני
bonnissel	בוניסל
bono	בונו
bonsai	בונסאי
boole	בול
boonen	בונן
booy	בוי
bora	בורא
boral	בוראל
borana	בוראנא
borchardt	בורשארדט
borden	בורדן
bordet	בורדה
bordin	בורדין
bordon	בורדון
boreanaz	בורינאז
borel	בורל
borges	בורכיס
borgetti	בורגיטי
borgnine	בורגנין
borgo	בורגו
boris	בוריס
bork	בורק
borland	בורלאנד
borlaug	בורלוג
bormann	בורמאן
born	בורן
borneo	בורניו
bornstein	בורנסטאין
borobudur	בורובודור
borrelli	בורילי
borriello	בוריילו
boru	בורו
boruc	בורוטש
borussia	בורוסיא
bosacki	בוסאצקי
bosch	בוש
boselli	בוסיללי
bosko	בוסקו
bosman	בוסמאן
bosnich	בוסניטש
bossis	בוסיס
boston	בוסטן
botero	בוטירו
botta	בוטא
botton	בוטון
boubacar	בובקר
bouboulina	בובולינא
bouchaib	בושעיב
bouchardeau	בושארדיו
boudica	בודיקא
bouhired	בוחירד
boujelbene	בוג'לבאן
boulahrouz	בולאחרוז
boulares	בולעראס
boulle	בול
boulus	בולוס
bouma	בומא
boumediene	בומדין
boumnijel	בומניג'ל
bouna	בונא
bouraoui	בוראוי
bourbaki	בורבאקי
bourdieu	בורדיו
boutahar	בוטהאר
boutlilisse	בוטליליס
boutros	בוטרוס
bouzarah	בוזארה
boyd	בויד
boye	בוי
boyens	בוינס
boyle	בויל
bozanic	בוזאניטש
bozoljac	בוזולג'אק
bracci	בראקי
bracciali	בראשיאלי
brad	בראד
bradbury	בראדברי
bradesco	בראדיסקו
bradley	בראדלי
brady	בריידי
braga	בראגא
bragg	בראג
brahe	בראהי
brahem	בראהם
brahma	בראהמא
brahman	בראהמאן
braila	בראילא
braille	בריاל
braizat	בראיזאט
bram	בראם
bramante	בראמאנטי
brammertz	בראמירץ
brandenburg	בראנדנברג
brando	בראנדו
brandon	בראנדון
brandt	בראנט
brandts	בראנץ
branduardi	בראנדוארדי
branko	בראנקו
branson	בראנסון
brant	בראנט
braque	בראק
brasilia	בראזיליא
bratt	בראט
bratz	בראטז
braugher	ברויר
braun	בראון
braxton	בראקסטון
brazauskas	בראזאוסקאס
brechet	בריטשיט
brecht	ברישט
brede	ברידי
bree	ברי
breen	ברין
breeze	בריז
bregerie	בריגירי
brehme	ברימה
breitner	בראיטנר
bremner	ברימנר
brendan	ברנדאן
brendell	ברינדל
brennan	ברינאן
brenner	ברנר
breslin	ברסלין
bresse	בריס
breton	בריטון
brett	בריט
breuer	ברויר
brian	בריאן
bridge	ברידג'
bridges	ברידג'ז
bridget	בריג'ט
briggs	בריגז
brigham	בריגם
bright	בראיט
brigitte	בריגיט
brik	בריק
brin	ברין
bringas	ברינגאס
brisson	בריסון
bristol	בריסטול
britain	בריטאן
britney	בריטני
brittany	בריטאני
brixton	בריקסטון
brno	ברנו
broadbent	ברודבנט
brocchi	ברוקי
brocic	ברושיטש
brock	ברוק
brockie	ברוקי
brod	ברוד
broderick	ברודריק
brodie	ברודי
brodsky	ברודסקי
brody	ברודי
broissart	ברויסארט
bromley	ברומלי
bromothymol	ברומותימול
bronstein	ברונסטין
bronte	ברונטי
brook	ברוק
brooklyn	ברוקלין
brooks	ברוקס
brosnan	ברוסנאן
broz	ברוז
bru	ברו
bruce	ברוס
brukhin	ברוכין
brul	ברול
brundle	בראנדל
bruneau	ברוניאו
brunei	ברוניי
brunel	ברוניל
brunelleschi	ברונליסקי
bruner	ברונר
brunetti	ברוניטי
brunner	ברונר
bruno	ברונו
bryan	בראין
bryansk	בריאנסק
bryant	בראינט
bryden	בראידן
brynjar	בריניאר
brzic	ברזיטש
bseiso	בסייסו
bsharri	בשארי
bu	בו
buarque	בוארק
buber	בובר
bubernik	בוברניק
bubka	בובקא
buble	בובלה
bubnik	בובניק
bucaille	בוקאי
bucharest	בוכארסט
buchner	בוכנר
bucker	באקר
buckley	באקלי
buckmaster	באקמאסטר
budan	בודאן
buddha	בודהא
budyanskiy	בודיאניסקי
buell	ביואל
bueno	בוינו
buenos	בוינוס
bugalo	בוגאלו
buganda	בוגאנדא
bugatti	בוגאטי
bugnet	בוגניט
bugzilla	בגזילא
buhari	בוהארי
buhturi	בוחטורי
buigues	בויגיס
buinsk	בוינסק
buisson	בויסון
bukhara	בוכארא
bukharin	בוכארין
bulent	בולנט
buljan	בוליאן
bull	בול
bulleh	בולה
bultmann	בולטמאן
bulykin	בוליקן
bunche	באנש
buncol	בונקול
bundy	בנדי
bunin	בונין
bunraku	בונראקו
bunting	באנטינג
bunton	באנטון
burckhardt	בורקהארט
burd	בורד
burdenski	בורדינסקי
burdisso	בורדיסו
buretsu	בוריטסו
burgess	בורגיס
burgmeier	ברגמאיר
burgnich	בורגניטש
buriani	בוריאני
burke	בורק
burkert	בורקרט
burkina	בורקינא
burla	בורלא
burnley	בורנלי
burns	בירנז
burqa	בורקע
burrell	בוריל
bursac	בורסאטש
burt	בורט
burton	בורטן
buruk	בורוק
burundi	בורונדי
buryatia	בוריאטיא
busacca	בוסאקא
busby	באסבי
buscemi	בושימי
busch	בוש
bush	בוש
bushmen	בושמן
busk	באסק
buson	בוסון
buster	באסטר
buta	בוטא
butenandt	בוטינאנט
butler	באטלר
butor	בוטור
butrus	בוטרוס
butte	ביוט
buy	באי
buyten	בויטן
buzau	בוזאו
buzek	בוזק
byrd	בירד
byrne	בירן
c.	ק.
caan	קאן
cabanas	קאבאנאס
cabel	קאבל
cabrera	קאברירא
cabrillo	קאברילו
cabrini	קאבריני
cabrita	קאבריטא
caceres	קאסיריס
cadherin	קאדהירין
cadillac	קאדילאק
cafu	קאפו
cage	קייג'
cagliari	קאליארי
cahill	קאהיל
cahors	קאהור
caillebotte	קאייבוט
caine	קיין
cake	קייק
cal	קאל
calabria	קאלאבריא
calais	קאלה
calatrava	קאלאטראבא
calcutta	קאלקוטא
calder	קאלדר
calexico	קאליקסיקו
calgary	קאלגארי
califf	קאליף
calimero	קאלימירו
callaghan	קאלאגאן
callas	קאלאס
calleja	קאליכא
calouste	קאלוסט
calum	קאלום
calvin	קאלוין
calzada	קאלזאדא
camaro	קאמארו
camataru	קאמאטארו
cambiasso	קאמביאסו
cambodia	קמבודיא
camby	קאמבי
camden	קאמדן
camel	קאמל
camelot	קאמלוט
cameron	קאמירון
cameroon	קאמירון
camilla	קאמילא
camille	קאמיל
camillo	קאמילו
camilo	קאמילו
campania	קאמפאניא
campo	קאמפו
campos	קאמפוס
camps	קאמפס
camus	קאמו
canada	קנדא
canberra	קאנבירא
candide	קאנדיד
caneira	קאנירא
canetti	קאניטי
caniggia	קאניגיא
canio	קאניו
canizares	קאניזאריס
cannavaro	קאנאבארו
cannes	קאן
canning	קאנינג
cannon	קאנון
canova	קאנובא
cantabria	קאנטאבריא
canterbury	קאנטרברי
cantona	קאנטונא
cantor	קאנטור
cao	קאו
capa	קאפא
capcom	קאפקום
capecchi	קאפיקי
capek	קאפק
capello	קאפילו
capet	קאפה
capone	קאפונ
cappadocia	קאפאדוקיא
capparoni	קאפארוני
capri	קאפרי
caracalla	קאראקלא
caracas	קאראקאס
caravaggio	קאראבאג'יו
carbajal	קארבאכאל
carbonic	קרבוניק
cardenosa	קארדינוסא
cardilli	קארדילי
cardo	קארדו
cardoso	קארדוסו
carducci	קארדוצ'י
carell	קארל
carew	קארו
carey	קארי
cargill	קארגיל
carini	קאריני
carl	קארל
carla	קארלא
carle	קארל
carles	קארלס
carlos	קארלוס
carlsen	קארלסן
carlton	קארלטון
carly	קארלי
carlyle	קארלאיל
carmagnola	קארמאנולא
carmelo	קארמילו
carnegie	קארנגי
carney	קארני
carniglia	קארניגליא
caro	קארו
carola	קארולא
carole	קארול
carolina	קארולאינא
caroline	קארולאין
carr	קאר
carragher	קאראגר
carrara	קארארא
carrasco	קאראסקו
carrasso	קאראסו
carre	קארה
carrel	קאריל
carrero	קארירו
carrey	קארי
carrick	קאריק
carrie	קירי
carrier	קאריאר
carroll	קארול
carsley	קארסלי
carson	קארסון
cartagena	קארטאגינא
carter	קארטר
carteron	קארטירון
cartier	קארטייה
cartman	קארטמאן
cartwright	קארטראיט
carvalho	קאראבאלהו
cary	קארי
casablanca	קאסאבלאנקא
casanova	קאסאנובא
casarin	קאסארין
case	קייס
caselli	קאסילי
casey	קייסי
casillas	קאסיאס
casimiro	קאזימירו
casiraghi	קאסיראגי
caspar	קאספאר
casper	קאספר
cass	קאס
cassandra	קאסאנדרא
cassano	קאסאנו
cassatt	קאסאט
cassavetes	קאסאביטז
cassian	קאסיאן
cassidy	קאסידי
cassin	קאסין
castano	קאסטאנו
castilla	קאסטילא
castillo	קאסטילו
castonier	קאסטוניר
castro	קאסטרו
cat	קט
catalani	קאטאלאני
catalina	קאטאלינא
catalonia	קאטאלוניא
cate	קאטי
category	קטגורי
caterina	קאטירינא
cathcart	קאתקארט
catherine	קאתירין
cato	קייטו
cattermole	קאטרמול
catton	קאטון
causio	קאוזיו
cavalieri	קאבאליירי
cavanna	קאבאנא
cave	קייב
cavenaghi	קאוונאגי
cavendish	קאבנדיש
caviezel	קאביזל
cayetano	קאיטאנו
cazorla	קאזורלא
cech	צ'ק
cecilia	סיסיליא
cedric	סידריק
celan	צלאן
celentano	צ'לנטאנו
celestine	סילסטין
celsius	סלזיוס
celso	סילסו
celtic	סלטיק
celtics	סלטיקס
cemal	ג'מאל
cena	סינא
ceni	סני
centauri	סנטורי
cerf	סירף
cernan	סירנאן
cerny	קירני
cervantes	סרבאנטס
cesaire	סיזיר
cesar	סיזאר
cesare	סיזר
cetin	ג'טין
ceulemans	קוילמאנס
chaabi	שעבי
chaabo	שעבו
chace	צ'ייס
chacour	שקור
chadili	שאדלי
chadwick	צ'אדויק
chaeruddin	צ'ארודין
chafik	שפיק
chafurin	צ'אפורין
chagall	שאגאל
chagas	שאגאס
chahine	שאהין
chaidari	חאידארי
chaikamdee	צ'איקאמדי
chaim	חיים
chaiman	צ'אימאן
chakib	שקיב
chakvetadze	צ'אקויטאדזה
chalabi	צ'לבי
chalana	צ'אלאנא
chalkias	צ'אלקיאס
chalme	צ'אלמי
chamakh	שמאך
chamanga	צ'אמאנגא
chamberlain	צ'יימברלין
chambers	שאמבירס
chamot	צ'אמוט
chamoun	שאמון
chamran	צ'מראן
chan	צ'אן
chandler	צ'אנדלר
chandra	צ'אנדרא
chandrika	צ'אנדריקא
chanel	צ'אנל
channing	צ'אנינג
chanov	צ'אנוב
chantal	שאנטאל
chao	צ'או
chapman	צ'אפמאן
chappuzeau	שאפוזיו
charalambos	צ'אראלאמבוס
charis	קאריס
charisteas	חאריסטיאס
charles	צ'ארלז
charlton	צ'ארלטון
charpenet	צ'ארפיניט
charvet	טשארוויט
chasseriau	קאסיריו
chauveau	שובו
chauvin	שובן
chaves	שאביס
chavez	צ'אביז
chazz	שאז
cheadle	צ'ידל
cheb	שב
chedid	שדיד
chedli	שאדלי
chehab	שהאב
cheik	שיך
cheikh	שיך
chekhov	צ'כוב
chemnitz	צ'מניץ
chen	צ'ן
chenene	צ'נן
chepita	צ'פיטה
cherry	צ'רי
cheryl	שיריל
chester	צ'סטר
chevrolet	שיברוליי
cheyrou	צ'יירו
chhetri	צ'טרי
chiacchio	צ'יאקיו
chiba	צ'יבא
chicago	שיקאגו
chiellini	קייליני
chiesa	קייזא
chihab	שהאב
chikao	צ'יקאו
chikhaoui	שיכאוי
chiklis	צ'יקליס
childeric	צ'ילדיריק
childs	צ'אילדז
chilembe	צ'ילמבי
chimbonda	צ'ימבונדא
chinghiz	צ'נגיז
chingy	צ'ינגי
chintu	צ'ינטו
chisholm	צ'ישולם
chislenko	צ'יסלנקו
chitou	צ'יטו
chivadze	צ'יבאדזה
chivu	צ'יבו
chiwa	צ'יוא
chloramphenicol	קלוראמפיניקול
cho	צ'ו
chokheli	צ'וכילי
chomsky	צ'ומסקי
chopin	שופאן
chorda	צ'ורדא
choukri	שוקרי
choutos	צ'וטוס
chovanec	צ'ובאניטש
chraibi	שראיבי
chriqui	שריקי
chris	קריס
christa	קריסטא
christanval	קריסטאנבאל
christensen	קריסטנסן
christiaan	קריסטיאן
christian	קריסטיאן
christiansen	קרישצ'אנסן
christie	קריסטי
christina	קריסטינא
christine	קריסטין
christofias	קריסטופיאס
christoph	קריסטוף
christophe	קריסטוף
christopher	קריסטופר
christou	קריסטו
christov	קריסטוב
christy	קריסטי
chrysler	קראיסלר
chrysostome	קריסוסטום
chtaura	שטורה
chuck	צ'אק
chuikov	צ'ויקוב
chulapa	צ'ולאפא
chyler	טשילר
chynna	שינא
ciano	צ'אנו
ciaran	קיאראן
cicinho	סיסינהו
cid	סיד
cienfuegos	סיאנפויגוס
ciesla	סיסלא
cilic	סיליטש
cimabue	צ'ימאבו
cincinnati	סינסינאטי
cinderella	סינדרילא
cindy	סינדי
ciolek	קיוליק
cioran	סיוראן
cipolla	צ'יפולא
cipollini	צ'יפוליני
ciprian	קיפריאן
ciro	צ'ירו
cisse	סיסי
citigroup	סיטיגרופ
citroen	סיטרואן
claesen	קלייסן
clair	קלייר
claire	קלייר
clampett	קלאמפיט
clancy	קלאנסי
clapton	קלאפטון
clare	קלייר
clarence	קלארנס
clark	קלארק
clarke	קלארק
claude	קלוד
claudette	קלודט
claudia	קלאודיא
claudio	קלאודיו
claudius	קלאודיוס
claus	קלאוס
clayderman	קליידרמאן
clearwater	קלירווטר
cleary	קלירי
cleber	קליבר
clemence	קלימינס
clemens	קלימינז
clerc	קלירק
clichy	קלישי
cliff	קליף
clifford	קליפורד
clift	קליפט
clifton	קליפטון
clijsters	קלאיסטרז
clinkenbeard	קלינקינבירד
clint	קלינט
clinton	קלינטון
clovis	קלוביס
clyde	קלייד
coase	קוס
cobain	קוביין
cobeno	קובינו
cobi	קובי
cocard	קוקארד
cocis	קוקיס
cockburn	קוקבורן
coco	קוקו
cocu	קוקו
codina	קודינא
codjia	קודג'א
codrea	קודריא
cody	קודי
coe	קו
coeck	קואק
coelho	קואלו
coffi	קופי
cohade	קוהייד
cohen	כהן
cohn	קון
colak	קולאק
cole	קול
colfax	קולפאקס
colin	קולין
collar	קולאר
colleen	קולין
colleter	קולטר
collette	קוליט
collin	קולן
collins	קולינז
collor	קולור
colmar	קולמאר
colombia	קולומביא
colombier	קולומבייה
colombo	קולומבו
colorado	קולוראדו
colt	קולט
columba	קולומבא
columbia	קולומביא
coluna	קולונא
colvin	קולווין
comaneci	קומאנצ'י
combat	קמבאט
combin	קומבין
combs	קומז
comics	קומיקס
commodus	קומודוס
como	קומו
compaore	קומפאורי
compton	קומפטון
comte	קומט
conakry	קונאקרי
conan	קונאן
conceicao	קונסיסאו
conchita	קונשיטא
concorde	קונקורד
condoleezza	קונדוליזא
confucius	קונפיושוס
congo	קונגו
connelly	קונילי
connery	קונרי
connes	קן
connie	קוני
connors	קונרז
conny	קוני
conor	קונור
conrad	קונראד
constable	קונסטאבל
constans	קונסטנס
constant	קונסטאנט
constanta	קונסטאנטא
constantin	קונסטאנטין
constantine	קונסטאנטין
constantinescu	קונסטאנטינסקו
constantius	קונסטאנטיוס
constanze	קונסטנזא
contador	קונטאדור
conte	קונטי
contra	קונטרא
convey	קונביי
cook	קוק
coolidge	קולידג'
cools	קולז
copa	קופא
copeland	קופלאנד
copenhagen	קופנהאגן
copernicus	קופרניקוס
coppell	קופל
coppola	קופולא
coras	קוראס
cordell	קורדל
cordoba	קורדובא
corelli	קורילי
corey	קורי
corfu	קורפו
cori	קורי
coria	קוריא
corin	קורין
coriolis	קוריוליס
corleone	קורליוני
corluka	קורלוקא
cornelia	קורניליא
corneliu	קורניליו
cornelius	קורניליוס
cornell	קורניל
cornet	קורנה
cornthwaite	קורנתויט
cornwall	קורנואל
cornwell	קורנויל
corrado	קוראדו
correa	קוריא
correia	קוריא
corrie	קורי
corriere	קורייר
corrigan	קוריגאן
corsetti	קורסיטי
corsica	קורסיקא
cortes	קורטיס
cortisol	קורטיזול
corver	קורבר
cory	קורי
corzine	קורזאין
corzo	קורזו
cosby	קוסבי
cosgrove	קוסגרוב
cosmin	קוזמין
cosmo	קוסמו
cossery	קוסרי
cossou	קוסו
costacurta	קוסטאקורטא
costanza	קוסטאנזא
costanzo	קוסטאנזו
coste	קוסט
costello	קוסטילו
costica	קוסטיקא
costinha	קוסטינהא
coty	קוטי
coulais	קולייס
coulibaly	קוליבאלי
coundoul	קונדול
couperin	קופירין
coupet	קופה
courbis	קורביס
couriol	קוריול
courteney	קורטני
courtney	קורטני
courtois	קורטוא
couto	קוטו
coventry	קובנטרי
covey	קובי
cox	קוקס
craddock	קראדוק
craiova	קראיובא
cravero	קראבירו
craxi	קראקסי
crayford	קרייפורד
crayston	קרייסטון
creatine	קריאטין
cremer	קרימר
cremieux	קרימייה
crespo	קריספו
crichton	קריקטון
crick	קריק
crippen	קריפן
cris	קריס
crispus	קריספוס
cristea	קריסטיא
cristian	קריסטיאן
cristiano	קריסטיאנו
cristobal	קריסטובאל
cristoforo	קריסטופורו
croatia	קרויישה
croce	קרוצ'י
croci	קרוקי
crocker	קרוקר
crockett	קרוקיט
cromwell	קרומוול
cronbach	קרונבאך
cronenberg	קרוננברג
crosby	קרוסבי
cross	קרוס
crothers	קרותרס
crouch	קראוטש
crowe	קרו
crowley	קראולי
crudup	קרודאפ
cruyff	קרויף
crvenkovski	קרבינקובסקי
cryptozoology	קריפטוזואולוג'י
cuauhtemoc	קואטימוק
cub	קאב
cuba	קיובא
cube	קיוב
cubillas	קובילאס
cudicini	קודיצ'יני
cuenca	קוינקא
cuevas	קויבאס
cugnot	קוניו
cuiaba	קויאבא
culina	קולינא
cullmann	קולמאן
cumin	קיומין
cunningham	קונינגהאם
curci	קורסי
curro	קורו
curtin	קורטין
curtis	קארטיס
curtiss	קורטיס
curzon	קורזון
cusack	קוזאק
cusco	קוסקו
custers	קוסטרס
cuza	קוזא
cvetkovic	סביטקוביטש
cyndi	סינדי
cynthia	סינתיא
cyprus	סאיפרוס
cyril	סיריל
cyrillic	סיריליק
cysteine	סיסטיין
czeizler	קיזלר
czerniatynski	זרניאטנסקי
czeslaw	צ'יסלאב
d	די
dabo	דאבו
dacia	דאסיא
dacourt	דאקורט
dada	דאדא
dado	דאדו
dae	דיי
daedalus	דידאלוס
daewoo	דאיוו
dafna	דפנא
dafoe	דאפו
dagan	דגן
dagano	דאגאנו
dagestan	דאגסטאן
dagher	דאגר
dagon	דאגון
dahab	דהב
daham	דהאם
dahan	דהאן
dahl	דאל
dahlan	דחלאן
dahlman	דאלמאן
dahomey	דאהומי
dai	דאי
daibes	דעיבס
daihatsu	דאיהאטסו
daiki	דאיקי
dailly	דיילי
daimler	דיימלר
daimyo	דאימיו
dainelli	דאינילי
daisuke	דאיסוק
dakota	דאקוטא
daladier	דלאדייה
dalal	דלאל
dale	דייל
daley	דיילי
dalglish	דאלגליש
dali	דאלי
dalia	דאליא
dalida	דאלידא
dallas	דאלאס
dalli	דאלי
dalmat	דאלמאט
dalmatia	דאלמיישא
dalnet	דאלנט
dalton	דאלטון
dam	דאם
damanakis	דאמאנאקיס
damarcus	דאמארקוס
damas	דאמאס
damien	דאמיאן
damir	דמיר
damjanovic	דאמיאנוביטש
damme	דאם
damon	דאמון
dan	דן
dana	דאנא
dane	דיין
danes	דיינס
daneshvar	דאנשוור
dangda	דאנגדא
dani	דאני
dania	דאניא
daniel	דניאל
daniela	דאניאלא
daniele	דניאל
danielle	דניאל
daniels	דאניילז
danielsen	דאניילסן
danijel	דאנייל
danilo	דאנילו
danna	דאנא
danner	דאנר
danni	דאני
danny	דאני
danon	דאנון
dante	דאנטה
danube	דאנוב
dany	דאני
danyel	דאניאל
dao	דאו
daoud	דאוד
daouda	דואדא
daoudi	אלדאודי
dar	דאר
dara	דארה
daraa	דרעא
darabont	דאראבונט
darcis	דארסיס
dardenne	דארדין
darfur	דארפור
darijo	דאריו
darine	דארין
dario	דאריו
darius	דאריוס
dariusz	דאריוש
darko	דארקו
darmian	דארמיאן
darom	דארום
daron	דארון
darren	דארין
darui	דארוי
darwish	דרויש
daryl	דאריל
dasayev	דאסאייב
dati	דאטי
datsakorn	דאטסאקורן
daud	דאוד
daudet	דודה
davala	דאואלא
dave	ייב
david	דייוויד
davide	דביד
davidka	דאבידקא
davids	דייוידז
davidson	דייבידסן
davies	דייביז
davis	דייויס
davison	דאביסון
davor	דאבור
davydenko	דאווידינקו
dawa	דאוה
dawid	דאויד
dawood	דאוד
dawoud	דאוד
dawson	דוסן
day	דיי
dayton	דייטון
dean	דין
deanna	דיאנא
dearborn	דירבורן
debbagh	דבאג
debbah	דיבא
debbas	דבאס
debbie	דבי
debra	דיברא
deby	דבי
debye	דבי
decane	דיקאן
decius	דקיוס
decker	דיקר
declan	דקלן
dee	די
deedat	דידאט
deem	דים
deen	דין
deena	דינא
deflandre	דיפלאנדר
defoe	דיפו
degania	דגניה
degas	דיגא
degauque	דיגוק
deguerville	דגורביל
dehn	דהן
deimos	דיימוס
deir	דיר
deisenhofer	דאיזנהופר
deisler	דאיסלר
dejan	דיג'אן
dekalim	דקלים
dekel	דקל
dekker	דיקר
del	דיל
delaney	דילייני
delaware	דלאוור
delbruck	דלברוק
dele	דילי
deledda	דילידא
deleuze	דלוז
delfino	דלפינו
delgado	דלגאדו
delhi	דלהי
delic	דיליטש
delilah	דלאילה
delimkhanov	דלימכאנוב
delisle	דילאיל
della	דילא
dellas	דילאס
delmotte	דילמוטי
delphi	דילפי
delson	דילסון
delvecchio	דלביקיו
demba	דימבא
demerit	דימיריט
demichelis	דימיצ'לאס
demidov	דמידוב
demirel	דימיריל
demis	דימיס
demme	דים
dempsey	דמפסי
demyanenko	דימיאנינקו
deng	דינג
denholm	דנהולם
denis	דניס
denisov	דיניסוב
deniz	דניז
denizli	דניזלי
denktas	דנקטאס
denmark	דנמארק
dennis	דניס
denshawai	דנשואי
denver	דנבר
denzel	דינזל
deodoro	דאודורו
derbent	דירבינט
derby	דרבי
derbyshire	דירבישאיר
derdiyok	דרדיוק
derek	דרק
deripaska	דיריפאסקא
dermot	דירמוט
derrida	דרידא
dervite	דרבייט
derwall	דירואל
desai	דסאי
deschamps	דישאמפ
desi	דסי
desiree	דיזירה
desmond	דיסמונד
dessau	דיסאו
detlev	דיטליב
detroit	דיטרויט
deucalion	דוקאליון
deutsche	דוטש
devall	דיבאל
devendra	דיבינדרא
deveric	דיביריטש
devilder	דיבאילדר
devon	דיבון
devouard	דיבואר
dewey	דואי
dey	דיי
dhiab	דיאב
dhorasoo	דוראסו
diab	דיאב
diabate	דיאבייט
diablo	דיאבלו
diaby	דיאבי
diakite	דיאקיטי
diamantino	דיאמאנטינו
diamond	דיאמונד
diamoutene	דיאמוטין
diana	דיאנא
diane	דיאן
dianne	דאיאן
diao	דיאו
diarra	דיארא
dias	דיאס
diatta	דיאטא
diawara	דיאוארא
diaz	דיאז
dib	דיב
diba	דיבא
dica	דיקא
dicaprio	דיקפריו
dichter	דיכטר
dick	דיק
dickens	דיקנז
dickinson	דיקינסון
dickov	דיקוב
dickson	דיקסון
diderik	דידריק
diderot	דידרו
didi	דידי
didier	דידייה
diego	דייגו
dien	דין
diesel	דיזל
dieter	דיטר
dietmar	דיטמאר
dietrich	דיטריך
dietz	דיץ
dieudonne	דיודון
diffie	דיפי
digao	דיגאו
dileita	דילייטא
dili	דילי
dima	דימא
dimba	דימבא
dimethyl	דימיתיל
dimitar	דימיטאר
dimitris	דימיטריס
dimona	דימונה
dimoschaki	דימושאקי
dina	דינא
dinara	דינארא
dindane	דנדאני
dini	דיני
diniyar	דינייאר
dink	דינק
dino	דינו
dinos	דינוס
diocletian	דאיאקלישן
diogenes	דיוגניז
diomansy	דיומאנסי
dion	דיון
dionysius	דיוניסיוס
dionysus	דיוניסוס
diop	דיופ
dior	דיור
diouf	דיוף
diourbel	דיורביל
dirac	דיראק
dirani	דיראני
dire	דאיר
dirk	דירק
dis	די
discovery	דיסקברי
diskin	דיסקין
dismas	דיסמאס
diss	דיס
dissa	דיסא
diwali	דיואלי
dix	דיקס
dixon	דיקסון
diyarbakr	דיארבקר
djakpa	ג'אפקא
djalma	ג'אלמא
djawadi	ג'אואדי
djebar	ג'באר
djelloul	ג'לול
djian	דג'יאן
djibril	ג'יבריל
djilali	ג'ילאלי
djite	דג'יטי
djokovic	דג'וקוביטש
djorkaeff	דג'ורקאייף
djourou	דג'ורו
djvu	דג'בו
dlouhy	דלוהי
dmitriev	דמיטרייב
dmitriy	דמיטרי
dmitriyev	דמיטרייב
dobias	דוביאס
dobson	דובסון
docherty	דוקירטי
dockx	דוקס
dodi	דודי
dodik	דודיק
dodoma	דודומא
doesburg	דוסבורג
dogg	דוג
dohan	דוהאן
doherty	דוירטי
dokhi	דוכי
dolby	דולבי
dolce	דולצ'ה
dolinsky	דולינסקי
dolittle	דוליטל
dolmans	דולמאנז
dolmatov	דולמאטוב
dolores	דולוריס
dolph	דולף
dom	דום
domagk	דומאק
domenech	דומיניק
domenghini	דומנגיני
domenico	דומיניקו
domeyko	דומייקו
domingo	דומינגו
dominic	דומיניק
dominica	דומיניקא
dominik	דומיניק
dominika	דומיניקא
dominique	דומיניק
domitian	דומיטיאן
domna	דומנא
domoraud	דומורו
don	דון
donadel	דונאדיל
donadoni	דונאדוני
donald	דונאלד
donatello	דונאטילו
donato	דונאטו
donetsk	דונטסק
dong	דונג
donitz	דוניץ
donizetti	דוניזיטי
donner	דונר
donnie	דאני
donovan	דונובאן
donskoy	דונסקוי
doody	דודי
dooley	דולי
doolittle	דוליטל
doom	דום
doppler	דופלר
dora	דורא
dorfner	דורפנר
dori	דורי
doria	דוריא
dorian	דוריאן
dorigo	דוריגו
dorin	דורין
dorinel	דורינל
doris	דוריס
dorji	דורג'י
dorothy	דורותי
dorsin	דורסן
dortmund	דורטמונד
dory	דורי
dossena	דוסינא
dostoyevsky	דוסטויבסקי
dotan	דותן
dotchev	דוצ'ב
douala	דואלא
doug	דוג
douglas	דוגלאס
douglass	דוגלאס
douis	דויס
dourif	דוריף
douro	דורו
dov	דוב
downing	דאונינג
doxa	דוקסא
doyle	דויל
dozy	דוזי
dr.	דקטור
draco	דראקו
dragan	דראגאן
dragila	דראגילא
dragnea	דראגניא
dragonair	דראגונייר
dragoslav	דראגוסלאב
drake	דרייק
dramane	דראמאן
drazan	דראזן
drazen	דראזין
dre	דרי
dreamworks	דרימוורקס
drenthe	דרינטה
dresden	דרסדן
dretar	דריטאר
drew	דרו
drewry	דרורי
drioton	דריוטון
drissa	דריסא
drnovsek	דרנובסיק
drogba	דרוגבא
dror	דרור
drovetti	דרוויטי
drucker	דרוקר
drulovic	דרולוביטש
drummond	דרומונד
druze	דרוז
dryden	דראידן
duberry	דוברי
dublin	דבלין
duchovny	דוכובני
ducommun	דוקומון
dudamel	דודאמיל
dudka	דודקא
dudley	דאדלי
dudu	דודו
duff	דאף
duffy	דאפי
dugarry	דוגארי
dujkovic	דויקוביטש
duke	דוק
dulaim	דוליים
dulbecco	דולביקו
dulce	דולסי
dumbledore	דמבלדור
dumitru	דומיטרו
dunai	דונאי
dunam	דונם
dunbar	דנבאר
duncan	דנקאן
dunn	דאן
dunne	דון
dunstaple	דאנסטאפל
duo	דואו
dupas	דופאס
dupont	דופונט
dupre	דופרי
dupree	דופרי
duraid	דורייד
duran	דוראן
durant	דוראנט
durban	דורבאן
durix	דוריקס
durkheim	דורקהיים
durkovic	דרקוביטש
durrell	דאריל
durs	דורס
dusan	דוסאן
duscher	דושיר
dushanbe	דושאנבה
dusseldorf	דוסלדורף
dustin	דאסטין
dutton	דאטן
duvalier	דובאלייה
duvall	דובאל
dvora	דבורה
dvorak	דבורז'אק
dwayne	דויין
dwight	דואיט
dwomoh	דוומוה
dwyane	דואין
dyab	דיאב
dyer	דאיר
dzajic	דזאג'יטש
dzeko	דזיקו
dzhokhar	ג'וחר
dziri	דזירי
dzodzuashvili	דזודזואשבילי
dzurinda	דזורינדא
eagleton	איגלטון
ealing	אילינג
earhart	אירהארט
eastcote	איסטקוט
ebadi	עבאדי
ebeid	עבייד
ebla	אבלא
eboli	אבולי
economist	אקונומיסט
ecuador	אקואדור
eddie	אדי
eden	עדן
edie	אדי
edmond	אדמונד
edmonton	אדמונטון
edmund	אדמונד
edo	אידו
edouard	אדוארד
eduard	אדוארד
eduardo	אדוארדו
edubuntu	אדובונטו
edvard	אדבארד
edward	אדוארד
edwards	אדוארדז
edwin	אדוין
eelam	אילאם
efraim	אפרים
efrat	אפרת
ehud	אהוד
eichmann	איקמאן
eido	עידו
eiffel	איפל
eilat	אילת
eindhoven	אנדהובן
eisner	אייזנר
eitam	איתם
eitan	איתן
ela	אלה
elachi	אלעשי
elazar	אלעזר
elbaradei	אלבראדעי
elbert	אלברט
eldad	אלדד
eleanor	אלאנור
eleftherios	אליפתיריוס
elektra	אלקטרא
elgamal	אלגמל
elghitani	אלגיטאני
elhanan	אלחנן
elia	אליא
eliahu	אליאהו
eliakim	אליקים
elias	אליאס
elijah	אלאיג'ה
elin	אלין
eliot	אליוט
elisabeth	אליזאבת
elisha	אלישע
elissa	אליסא
eliza	אליזא
ellen	אלן
elliot	אליוט
elliott	אליוט
ellison	אליסון
elm	אילם
elmaleh	אלמאלח
elmore	אלמור
eloui	עלוי
elrich	אלריטש
elsamni	אלסמני
elsanhuri	אלסנהורי
elshafei	אלשאפעי
elsonbaty	אלסנבאטי
elst	אלסט
elton	אלטון
elvis	אלביס
elyakim	אליקים
elyashiv	אלישיב
elytis	אליטיס
emam	אמאם
emanuel	עמנואל
emanuele	אמאנואל
emar	אימאר
embraer	אמבראיר
emden	אמדן
emek	עמק
emerson	אמרסון
emilio	אמיליו
emily	אמילי
eminem	אימינם
emma	אימא
emmanuel	עמנואל
emmy	אמי
emo	אימו
empoli	אמפולי
enayati	ענאיאטי
endemol	אנדמול
endless	אנדליס
enfield	אנפילד
england	אנגלאנד
english	אינגליש
enkhbayar	אנכבאיאר
ennio	אניו
enos	אינוס
enric	אנריק
enrico	אנריקו
enron	אנרון
entebbe	אנטבה
enzo	אנזו
epaminondas	איפאמינונדאס
ephraim	אפרים
epstein	אפסטין
erato	אראטו
erbati	ארבאטי
ercolano	ארקולאנו
erekat	עריקאט
eretria	אריטריא
erez	ארז
erhard	ארהארד
eri	אירי
ericson	אריקסון
erie	אירי
erikson	אריקסון
eris	אריס
ernest	ארנסט
ernesto	ארנסטו
ernie	ארני
ernst	ארנסט
eros	אירוס
escobar	אסקובאר
escorial	אסקוריאל
eshel	אשל
eskell	אסקיל
eskisehir	איסקיסיהיר
esna	אסנא
esperanto	אספראנטו
espirito	אספיריטו
espoo	אספו
essam	עסאם
essen	אסן
estadio	אסטאדיו
esteban	אסטבאן
esti	אסטי
estili	אסטילי
estonia	אסטוניא
estudiantes	אסטודיאנטיס
ethane	אתיין
ethel	איתיל
ethiopia	אתיופיא
ethiopian	אתיופיאן
ethology	אתולוג'י
ethylene	אתילין
etna	אטנא
etrog	אתרוג
ettore	איטורי
eugene	יוג'ין
euripides	יוריפידיז
europa	יורופא
europe	יורופ
eurosport	איורוספורט
euterpe	יוטירפי
eva	איבא
evans	איבאנז
evariste	איבריסט
everest	אברסט
evo	איבו
evra	איברא
evrytania	אבריטאניא
exxon	אקסון
eyvind	איבינד
ezer	עזר
ezra	עזרא
ezzaki	אזאקי
f	אף
facchetti	פאקיטי
facundo	פאקונדו
fadel	פאדל
fadi	פאדי
fadiga	פאדיגא
fadl	פאדל
fadlan	פדלאן
fado	פאדו
fae	פיי
fagan	פייגן
fahad	פהד
fahed	פאהד
fahima	פהימה
fahmi	פהמי
fahmy	פהמי
fahrni	פארני
fahrudin	פאהרודן
fairuz	פאירוז
faisal	פאיסל
faison	פייזון
faith	פיית
fakhri	פכרי
fakroun	פקרון
falcao	פאלקאו
falco	פאלקו
falintil	פאלינטיל
falkenmayer	פאלקינמאיר
falla	פאלא
faltermeyer	פאלטרמאיר
fama	פאמא
familia	פאמיליא
famke	פאמקי
fan	פאן
fandel	פאנדל
fangzhuo	פאנגז'ו
fanning	פאנינג
fanny	פאני
fanous	פאנוס
fanta	פאנטא
fanteni	פאנטיני
fantini	פאנטיני
faraday	פאראדאי
farag	פאראג
farah	פארח
farahani	פראהאני
faraj	פרג'
fargeon	פארגיון
farhi	פרחי
farid	פריד
faris	פאריס
farkas	פארקאס
farkash	פארקאש
farman	פארמאן
farouk	פארוק
farran	פאראן
farrell	פאריל
farrokhzad	פרוכזאד
farshad	פרשאד
faruk	פארוק
faso	פאסו
faten	פאטן
fatfat	פאטפאט
fathi	פתחי
fathy	פתחי
fatih	פאטיח
fatima	פאטימה
fatmir	פאטמיר
fatton	פאטון
fauci	פוסי
faudel	פאדל
faulk	פולק
faulkner	פולקנר
faure	פורי
faurisson	פוריסון
faustino	פוסטינו
fausto	פאוסטו
faye	פיי
fayed	פאיד
fayez	פאיז
fayol	פאיול
fayyad	פאיאד
fazah	פזה
fazekas	פאזיקאס
fazio	פאזיו
fazlagic	פאזלאגיטש
fazrul	פאזרול
fechner	פכנר
federer	פדרר
federici	פדריקי
federico	פידיריקו
federline	פידרלאין
fedor	פידור
fehn	פיהן
fehr	פיהר
fei	פיי
feiglin	פייגלין
feiler	פיילר
feingold	פאינגולד
feinstein	פיינשטיין
feist	פיסט
fekri	פקרי
feld	פילד
feldman	פלדמאן
felicia	פילישא
feliciano	פיליסיאנו
felipe	פיליפי
feliu	פילאיו
felix	פיליקס
fellini	פיליני
felsner	פילסנר
fendi	פינדי
fenelon	פנלון
feng	פנג
fenin	פינין
feodor	פיודור
feraoun	פרעון
feras	פראס
ferdi	פירדי
ferdinand	פרדינאנד
ferdinando	פרדינאנדו
ferdoos	פרדוס
ferenc	פירינק
ferguson	פרגוסון
ferhat	פרחאט
feridun	פרידון
ferlito	פרליטו
fermi	פירמי
fernand	פרנאנד
fernandes	פירנאנדיז
fernandez	פרנאנדיז
fernando	פרנאנדו
ferrara	פירארא
ferrari	פירארי
ferrary	פירארי
ferreira	פיריירא
ferrell	פירל
ferrer	פרר
ferri	פירי
ferrier	פירייה
ferrini	פיריני
ferruccio	פירוצ'יו
ferydoon	פריידון
fethi	פטחי
fey	פיי
feyenoord	פיינורד
fiala	פיאלא
fiasco	פיאסקו
fichman	פישמאן
fichtner	פישטנר
fico	פיקו
fidel	פידל
fiedler	פידלר
field	פילד
fielding	פילדינג
fiennes	פיאנס
fifa	פיפא
fifi	פיפי
figaro	פיגארו
fighting	פאיטינג
figo	פיגו
figueroa	פיגירוא
filip	פיליפ
filippo	פיליפו
fillion	פיליון
fillon	פיון
film	פילם
filo	פאילו
fincher	פינשר
finger	פינגר
finidi	פינידי
finkelstein	פינקלסטאין
finland	פינלאנד
finn	פין
finnan	פינאן
finney	פיני
fiona	פיונא
fiore	פיורי
fiori	פיורי
fiqh	פיק
firas	פיראס
fire	פאיר
firman	פרמאן
firmani	פירמאני
fischer	פישר
fischler	פישלר
fish	פיש
fisher	פישר
fisichella	פיסיקילא
fisk	פיסק
fiston	פיסטון
fitzgerald	פיצג'ראלד
fizeau	פיזו
flaherty	פלאהירטי
flamion	פלאמיון
flanders	פלאנדרז
fleihan	פליחאן
fleischer	פלאישר
fleming	פלימינג
flemming	פלימינג
fletcher	פליטשיר
flitter	פליטר
flohe	פלוה
florence	פלורנס
florent	פלורינט
florentin	פלורנטין
florentino	פלורנטינו
flores	פלוריס
florian	פלוריאן
florianopolis	פלוריאנופוליס
florida	פלורידא
florin	פלורין
floyd	פלויד
flynn	פלין
fode	פוד
foeke	פוקי
foggia	פוג'יא
fogh	פוג
fognini	פוניני
foiros	פוירוס
fojut	פוג'וט
foley	פולי
folke	פולק
foly	פולי
fonda	פונדא
fonseca	פונסיקא
fontaine	פונטיין
fontana	פונטאנא
foote	פוט
ford	פורד
foreman	פורמאן
forest	פוריסט
forlan	פורלאן
forman	פורמאן
formosa	פורמוזא
forough	פורוג
forrester	פורסטר
forssmann	פורסמאן
forster	פורסטר
forsyth	פורסאית
fort	פורט
fortaleza	פורטאליזא
fortune	פורטשן
fortuno	פורטונו
fortuny	פורטוני
fortuyn	פורטוין
foster	פוסטר
foucault	פוקו
fouhami	פוהאמי
fouine	פוין
fourest	פוריסט
fournier	פורנייר
foxx	פוקס
fradique	פראדיק
fran	פראן
france	פראנס
frances	פראנסס
francesca	פראנססקא
francesco	פראנשיסקו
francescoli	פראנסיסקולי
francileudo	פראנסילודו
francini	פראנשיני
francis	פראנסס
franciscan	פרנסיסקן
francisco	פראנסיסקו
franck	פראנק
franco	פראנקו
francois	פרנסוא
franjo	פראניו
frank	פראנק
frankfurt	פראנקפורט
frankie	פראנקי
franklin	פראנקלין
franklyn	פראנקלין
franky	פראנקי
frans	פראנס
fransman	פראנסמאן
frantisek	פראנטיסק
franz	פראנז
frasco	פראסקו
fraser	פרייזר
frau	פראו
fred	פריד
freddy	פרידי
frederic	פרידריק
frederick	פרידיריק
fredericks	פרידריקס
frederik	פרידיריק
fredric	פרידריק
fredrik	פרידריק
fredriksson	פרידריקסון
free	פרי
frege	פריגה
frei	פריי
freier	פרייר
freire	פרייר
freleng	פרילינג
french	פרינטש
frey	פריי
frick	פריק
frida	פרידה
frideric	פרידריק
fridman	פרידמאן
fridtjof	פרידג'וף
friedel	פרידל
friedensreich	פרידנסראיש
friedman	פרידמאן
friedmann	פרידמאן
friedrich	פרידריק
frings	פרינגז
frisk	פריסק
friz	פריז
frodo	פרודו
fromm	פרום
frontera	פרונטירא
frost	פרוסט
fuchs	פוקס
fukuda	פוקודא
fukui	פוקוי
fukunishi	פוקונישי
fukuyama	פוקויאמא
ful	פול
fuller	פולר
fulton	פולטון
fumihiko	פומיהיקו
fumimaro	פומימארו
fumio	פומיו
funke	פונקה
furlong	פורלונג
furuya	פורויא
fusako	פוסאקו
fuseli	פוסלי
fusi	פוזי
fuste	פוסטי
futon	פוטון
fyodor	פיודור
gaafar	ג'עפר
gaarder	גארדר
gabbidon	גאבידון
gaber	גאבר
gabi	גבי
gabilondo	גאבילונדו
gable	גייבל
gabor	גאבור
gaborone	גאבורון
gabriel	גבריאל
gabriela	גאבריאלה
gabriele	גאבריאל
gaby	גאבי
gad	גד
gadish	גאדיש
gaetan	גאיטאן
gaga	גאגא
gago	גאגו
gail	גייל
gajdůsek	גאידוסיק
galahad	גאלאהאד
galakos	גאלאקוס
galal	גלאל
galasek	גאלאסיק
galbraith	גאלבריית
galeazzo	גאליאצו
galen	גיילן
galic	גאליק
galilei	גאליליי
galileo	גאלילאו
galili	גלילי
galimzyan	גאלימזיאן
galinovic	גאלינוביטש
galis	גאליס
galla	גאלא
gallardo	גאלארדו
gallas	גאלאס
galler	גאלר
galletti	גאליטי
galli	גאלי
gallice	גאליסי
gallo	גאלו
gallois	גאלוא
galois	גאלוא
galsworthy	גאלזוורתי
galton	גאלטון
galvani	גאלוואני
galvin	גאלבין
gamal	גמאל
gamar	גמר
gamarra	גאמארא
gamberini	גאמביריני
gamil	גמיל
gamliel	גמליאל
gammoudi	גמודי
gamsakhurdia	גאמסאכורדיא
gamzatov	גמזטוב
gandhi	גאנדי
gandolfini	גאנדולפיני
ganea	גאניא
ganges	גאנג'ז
gangnihessou	גאנגניהיסו
ganim	גנים
ganis	גאניס
gann	גאן
ganzouri	גנזורי
gaon	גאון
garadanow	גאראדאנוב
garang	גאראנג
garaudy	גארודי
garay	גאראי
garba	גארבא
garbarek	גארבארק
garbo	גארבו
garbutt	גארבוט
garcia	גארסיא
gard	גארד
garde	גארד
gardner	גארדנר
garfield	גארפילד
gargano	גארגאנו
gargo	גארגו
gargula	גארגולא
garibaldi	גאריבאלדי
gariseb	גאריסב
garmendia	גארמנדיא
garner	גארנר
garrincha	גארינשא
garry	גארי
gary	גארי
garzon	גארזון
gascoigne	גאסקוין
gascony	גאסקוני
gaskell	גאסקל
gaspar	גאספאר
gaspard	גאספאר
gaspoz	גאספוז
gasquet	גאסקה
gassama	גאסאמא
gassid	גאסיד
gates	גייטס
gateshead	גייטסהיד
gattuso	גאטוסו
gaudi	גאודי
gauguin	גוגן
gautama	גוטאמא
gavin	גאבן
gavras	גאבראס
gavriel	גבריאל
gavriil	גאבריל
gavrilov	גאברילוב
gazankulu	גאזאנקולו
gaziantep	גאזיאנטפ
gazprom	גאזפרום
gazzaniga	גאזאניגא
gbagbo	גבאגבו
gdansk	גדאנסק
geagea	געגע
gebrselassie	גבריסילאסי
geczi	גקזי
geddes	גידיס
gediminas	גידימינאס
geels	גילז
geert	גירט
gehan	גיהאן
gehry	גירי
gein	גין
geir	גיר
gekas	גיקאס
geldof	גילדוף
gelsenkirchen	גילסנקירשן
gelson	גילסון
gemmei	גימיי
gemmrich	גימריטש
genda	גנדא
gene	ג'ין
genghini	גינגיני
gennadi	גינאדי
gennady	גינאדי
gennaro	גנארו
genrikh	גינריך
gensho	גינשו
gentiana	ג'נטיאנא
gentile	ג'נטילי
geoff	ג'ף
geoffrey	ג'פרי
geology	גי'ולוג'י
georg	גאורג
georges	ג'ורג'
georgescu	ג'ורג'סקו
georgi	ג'ורג'י
georgia	ג'ורג'א
georgios	גיורגיוס
georgy	ג'ורג'י
ger	גר
gerald	ג'ראלד
geraldine	ג'ראלדין
gerard	ג'רארד
gercaliu	גירקאליו
geresh	גרש
gerets	גיריץ
gerhard	גרהארד
gerhart	גרהארט
geri	גירי
gerizim	גריזים
gernot	גירנו
geronimo	ג'ראנימו
gerrard	ג'רארד
gerry	גירי
gershon	גרשון
gershwin	גירשוין
gerson	גרסון
gerty	גרטי
gesher	גשר
gestapo	גסטאפו
getulio	גיטוליו
geynrikh	גיاנריך
geza	גזא
ghali	גאלי
ghaly	גאלי
ghana	גאנא
ghanem	גאנם
ghannam	גנאם
ghannouchi	גנוצ'י
gharib	גאריב
ghassan	גסאן
ghayeghran	גאיגראן
ghazi	גאזי
gheorghe	גיורגי
ghezal	גזאל
ghiggia	גיגיא
ghionea	גיוניא
ghorban	גורבאן
ghosh	גוש
ghosn	גוסן
ghraib	גרייב
ghulam	גולאם
giacinto	ג'אסינטו
giacomo	ג'אקומו
giagnoni	ג'אניוני
giamatti	ג'אמאטי
giampiero	ג'אמפיירו
giancarlo	ג'אנקארלו
gianluca	ג'אנלוקא
gianluigi	ג'אנלויג'י
giannakopoulos	ג'יאנאקאפולוס
gianni	גwאני
giannini	ג'אניני
giannis	ג'יאניס
gibb	גיב
gibbon	גיבון
gibbs	גיבז
gibli	גיבלי
gibson	גיבסון
gicquel	גיקיל
gide	גיד
gideon	גידיון
giggs	גיגז
gigi	ג'יג'י
giichi	גיצ'י
gil	גיל
gila	גילא
gilad	גלעאד
gilardino	גילארדינו
gilbert	גילברט
gilberto	גילברטו
gilboa	גלבוע
gildas	גילדאס
gilead	גיליאד
gili	גילי
gillars	גילרז
gillerman	גילרמאן
gilles	גיל
gillespie	גיליספי
gillo	גילו
gillon	גילון
gimelstob	גימלסטוב
gimme	גימי
ginaton	גינתון
gino	ג'ינו
ginola	גינולא
ginsburg	גינסבורג
ginzburg	גינסבורג
gioachino	ג'ואקינו
giolitti	ג'וליטי
giora	גיורא
giordano	ג'ורדאנו
giorgio	ג'ורג'ו
giorgos	ג'יורגוס
giosue	ג'וסו
giourkas	ג'ורקאס
giovane	ג'יובאני
giovanna	ג'ובאנא
giovanni	ג'ובאני
giraldo	גיראלדו
gish	גיש
gita	גיטא
giuliani	ג'וליאני
giuseppe	ג'וזיפי
givat	גבעת
given	גיבן
givet	גיביט
givi	גיבי
giza	גיזה
gizenga	גיזינגא
gjirokaster	גירוקאסטר
gladstone	גלאדסטון
glam	גלאם
glau	גלאו
glazer	גליזר
gleeson	גליסון
gleick	גליק
glen	גלן
glenda	גלינדא
glotov	גלוטוב
glover	גלובר
glutamine	גלוטאמין
glycine	גליסין
glynn	גלין
gnako	גנאקו
gnome	נום
goa	גוא
gobbi	גובי
goda	גודא
godel	גודל
godfrey	גודפרי
godwin	גודוין
godwinson	גודוינסון
goebbels	גובלז
goethals	גותאלס
goethe	גתה
gofman	גופמאן
gogh	גוג
gogol	גוגול
gohar	גוהר
gohouri	גוהורי
goian	גויאן
gokhan	גוכאן
golan	גולן
golanski	גולאנסקי
golbourne	גולבורן
gold	גולד
golda	גולדא
goldberg	גולדברג
goldblum	גולדבלום
golding	גולדינג
goldman	גולדמאן
goldstein	גולדסטין
goldwater	גולדווטר
golestan	גולסטאן
golgi	גולגי
goll	גול
golmohammadi	גולמוחמדי
goma	גומע
gomes	גומיז
gomez	גומיז
gomis	גומיס
gonen	גונן
gonnohyoe	גונוהיו
gonzalo	גונזאלו
goodison	גודיסון
goodman	גודמאן
goodyear	גודייר
google	גוגל
googoosh	גוגוש
goor	גור
goran	גוראן
gorani	גוראני
gordian	גורדיאן
gordimer	גורדימר
gordon	גורדון
goring	גורינג
gorky	גורקי
gorlitz	גורליץ
gorniak	גורניאק
gorshkov	גורשקוב
gosh	גוש
gosho	גושו
gosling	גוסלינג
goth	גות
gotsmanov	גוטסמאנוב
gottfried	גוטפריד
gotthelf	גוטהילף
gottlieb	גוטליב
gottlob	גוטלוב
gould	גולד
goumas	גומאס
gounaris	גונאריס
gourcuff	גורקוף
govedarica	גובידאריקא
govou	גובו
grabar	גראבאר
grace	גרייס
graeme	גראם
graf	גראף
graham	גראהאם
grainger	גריינג'ר
gramsci	גראמשי
granado	גראנאדו
grand	גראנד
grande	גראנד
grandes	גראנדס
graner	גראנר
granite	גראניט
granqvist	גראנקביסט
grant	גראנט
grass	גראס
grassi	גראסי
grava	גראבא
gray	גריי
grazer	גרייזר
grazia	גראזיא
graziani	גראציאני
greaves	גריבז
greco	גריקו
greeley	גרילי
green	גרין
greenberg	גרינבירג
greene	גרין
greengrass	גרינגראס
greenland	גרינלאנד
greenwood	גרינווד
greg	גריג
gregoire	גריגויר
gregor	גריגור
gregorio	גריגוריו
gregory	גריגורי
gregotti	גריגוטי
greiss	גריס
grella	גרילא
grenada	גרינאדא
grenet	גריניט
grenoble	גרינובל
grenville	גרנביל
greta	גריטא
grey	גריי
grichting	גריקטינג
griffith	גריפית
grigore	גריגורי
grigori	גריגורי
grillon	גרילון
grillparzer	גרילפארצר
grimaldi	גרימאלדי
grimi	גרימי
grimonpon	גרימונפון
grimsson	גרימסון
grint	גרינט
gris	גריס
grisham	גרישאם
grnemeyer	גרנמייר
gromyko	גרומיקו
grondona	גרנדונא
gronkjar	גרונקיאר
grosjean	גרוסג'ין
gross	גרוס
grossman	גרוסמאן
grosso	גרוסו
grove	גרוב
grover	גרובר
grun	גרון
grunbein	גרונביין
grundig	גרונדיג
grybauskaite	גריבאוסקאיטי
grygera	גריגירא
gryzlov	גריזלוב
grzegorz	גרזיגורז
guadeloupe	גואדלופ
guadiana	גואדיאנא
guanghu	גואנגהו
guarino	גוארינו
guarneri	גוארניירי
guatemala	גואטימאלא
guayana	גויאנא
guccini	גוצ'יני
guccione	גוצ'יון
gudelj	גודילי
guderian	גודיריאן
guenon	גוינון
guerin	גוארין
guernsey	גירנזי
guerreiro	גוירירו
guerrero	גורירו
guevara	גווארא
gueye	גויי
guggenheim	גוגנהאים
gugino	גוגינו
guglielmo	גוגלילמו
guido	גוידו
guillaume	גויאם
guillermo	גוילירמו
guillot	גוילוט
guinness	גיניס
guirane	גויראני
guiscard	גיסקארד
guity	גיטי
guiza	גויזא
gul	גול
gulbenkian	גולבנקיאן
gundam	גאנדאם
gunnar	גונאר
gunnarsson	גונארסון
gunter	גונטר
guojohnsen	גוג'ונסון
gurpegui	גורפיגי
gus	גאס
gusarov	גוסארוב
gustaf	גוסטאף
gustav	גוסטאב
gustave	גוסטאב
gustavo	גוסטאבו
gutenberg	גוטנברג
guthrie	גאתרי
gutierrez	גוטייריז
guttmann	גוטמאן
gutzkow	גוטסקוב
guus	גוס
guzan	גוזאן
guzzanti	גוצאנטי
gwen	גוין
gyan	גיאן
gygax	גיגאקס
gyorgy	גיורגי
gyula	גיולא
haaretz	הארץ
haas	האס
haase	האסי
habash	חבש
haber	האבר
haberkorn	האברקורן
habermas	האברמאס
habib	חביב
habibi	חביבי
habre	חברי
hachilensa	האצ'ילינסא
hackett	האקיט
hadad	חדאד
hadar	הדר
hadchiti	חדשיטי
haddad	חדאד
haddock	האדוק
haden	היידן
hadi	האדי
hadid	חדיד
hadith	חדית
hadj	חאג'
hadjaoui	חג'אוי
hadji	חאג'י
hadziabdic	האדזיאבדיטש
hadzibegic	האדזיביגיטש
haeckel	היקל
haehnel	האהניל
hafez	חאפז
hafid	חפיד
hafiz	חאפז
hagen	האגן
haggai	חגי
hagi	האגי
hai	האי
haibin	האיבין
haider	חידר
haidong	האידונג
haifa	חיפה
haig	הייג
haile	האילי
haim	חיים
hainan	האינאן
hairuddin	האירודין
haitham	האיתם
haiti	האיטי
hajduk	האידוק
hajeri	חג'רי
hajim	חאג'ים
hakan	האקאן
hakikar	האקיקאר
hakim	חאקים
hakki	חקי
hakkinen	האקינן
hakovesh	הכובש
hakuho	האקוהו
hal	האל
halberstam	האלברסטאם
halevy	הלוי
halford	האלפורד
halhul	חלחול
halil	הליל
halilhodzic	חלילהודזיטש
halimi	חלימי
hall	הול
halldor	האלדור
halle	הל
halley	האלי
halliwell	האליוול
halloumi	חלומי
halls	האלז
halo	האלו
halonen	האלונין
halutz	חלוץ
ham	חאם
hamad	חאמאד
hamaguchi	האמאגוצ'י
hamann	האמאן
hamasaki	האמאסאקי
hamburg	האמבורג
hamdani	חמדאני
hamdi	חמדי
hamdy	חמדי
hameed	חמיד
hamer	האמר
hamid	חמיד
hamidou	חמידו
hamilton	האמילטון
haminu	האמינו
hamit	חמיט
hamm	האם
hammadi	חמאדי
hammerfest	האמרפיסט
hammett	האמיט
hammill	האמל
hammond	האמונד
hammoud	חמוד
hamouche	חמוש
hamoud	חמוד
hampden	האמפדן
hampstead	האמפסטיד
hampton	האמפטון
hamrouche	חמרוש
han	האן
hana	הנא
hanan	חנאן
hanania	חנאניא
hananu	הנאנו
hanaoui	חנאוי
hanbal	חנבל
hancock	האנקוק
handal	חנדל
handel	האנדל
handke	האנדקה
handler	האנדלר
hanegbi	הנגבי
hanescu	האניסקו
haney	הייני
hani	האני
hanif	חניף
haniyeh	הניה
hank	האנק
hanks	האנקס
hanna	חנא
hannes	האניס
hanni	האני
hannibal	האניבאל
hannigan	האניגאן
hanns	האנס
hanny	הני
hanoi	האנוי
hanoun	חאנון
hanoune	חנון
hanover	האנובר
hans	האנס
hansard	האנסארד
hansen	האנסן
hansi	האנסי
hanssen	האנסן
hansson	האנסון
hantuchova	האנטשובא
hany	האני
hanyu	האניו
hanzo	האנזו
hao	האו
happel	האפל
haqqi	חקי
hara	הארא
haraam	חראם
harada	האראדא
harakat	חרקת
harald	האראלד
haran	חאראן
harare	הרארי
harari	הרארי
harb	חארב
harbin	הארבין
hard	הארד
hardaway	הארדאויי
harden	הארדן
hardin	הארדין
hardy	הארדי
harel	הראל
harewood	האריווד
hargreaves	הארגריבז
hari	הארי
hariri	חרירי
haris	חאריס
harissa	חריסא
harith	חארית
harkus	הארקוס
harlan	הארלאן
harlem	הארלם
harlow	הארלו
harnik	הארניק
harper	הארפר
harpo	הארפו
harrell	הארל
harrelson	הארלסון
harris	האריס
harrison	האריסון
harry	הארי
harsanyi	הארסאני
hartfield	הארטפילד
hartman	הארטמאן
hartmann	הארטמאן
hartmut	הארטמוט
hartnett	הארטניט
hartree	הארטרי
haruki	הארוקי
harvey	הארבי
haryana	האריאנא
hasan	חסן
hasek	האסיק
hasekura	האסיקורא
hasenclever	האסנקליבר
hasharon	השרון
hashemian	האשמיאן
hashi	האשי
hashim	האשים
hashimoto	האשימוטו
hashomron	השומרון
hasler	האסלר
hasni	חסני
hass	האס
hassan	חסן
hassanal	חסנל
hasse	האס
hastings	הייסטינגס
hat	האט
hata	האטא
hatem	חאטם
hathairattanakool	האתאיראטאנאקול
hathor	חטחור
hatshepsut	חטשפסוט
hatsumi	האטסומי
hatta	חטא
hatthaporn	האטאפורן
hattori	האטורי
hatzor	חצור
hauer	האויר
hauptmann	האופטמאן
hausdorff	האוסדורף
hausmann	האוסמאן
havana	האבאנא
havard	האוארד
havilland	האבילאנד
hawaii	האואי
hawass	חאואס
hawatmeh	חוואטמה
hawi	חאוי
hawsawi	האוסאוי
hawthorne	האותורן
haya	היה
hayam	היאם
hayami	האיאמי
hayao	האיאו
hayato	האיאטו
hayatou	חיאטו
hayden	האידן
haydn	האידן
hayek	חאיק
hayes	הייז
hayez	האיז
hayflick	הייפליק
haykel	האיקל
hayley	היילי
haymanot	האימאנוט
haysbert	הייזבירט
haytham	היתם
hazazi	הזאזי
hazboun	חזבון
haßler	האסלר
headey	הידי
healey	הילי
heaney	היני
heath	הית
heather	התר
heathrow	היתרו
heaton	היטון
heaviside	היביסאיד
hebert	היבירט
hebuterne	אבוטארן
heche	הש
hector	היקטור
hecuba	היקובא
hedi	הדי
hediger	הדיגר
hedman	הדמאן
hedy	הידי
heenan	הינאן
hegel	היגל
heggy	הגי
heichel	האישל
heidegger	האידגר
heidelberg	האידלברג
heidi	האידי
heigl	היגל
heihachiro	הייהאצ'ירו
heike	היק
heiko	הייקו
heiner	הינר
heini	היני
heintje	האין
heintze	הינצה
heinz	היינז
heinze	האינז
heioar	הייור
heisenberg	הייזנבירג
heisserer	הייסרר
heitinga	היטינגא
hejlsberg	הילסברג
held	הילד
helder	הילדר
helen	הלן
helena	הלנא
helga	הילגא
helge	הילג
helguera	הילגירא
helguson	הילגוסון
hellebuyck	היליבויק
hellenic	היליניק
hellinger	הילנגר
hellman	הילמאן
hellmut	הילמוט
helman	הלמאן
helmholtz	הלמהולץ
helmut	הלמוט
helou	חלו
helpman	הילפמאן
helsinki	הלסינקי
helt	הילט
hematocrit	הימאטוקריט
hemdan	חמדאן
hemed	חמד
hemidi	חמידי
hemingway	המינגווי
henan	הינאן
henchoz	הינצ'וז
hendel	הנדל
henderson	הנדרסון
hendrie	הינדרי
hendrik	הנדריק
hendry	הנדרי
henedi	הנידי
heng	הינג
henkin	הנקין
henman	הינמאן
henning	הינינג
henri	הנרי
henrik	הנריק
henriksen	הנריקסן
henrique	הנריקה
henry	הנרי
henryk	הנריק
henze	הינז
hephaestus	היפיסטוס
heracles	היראקליס
heraclitus	היראקליטס
heraclius	הראקליוס
heraklion	היראקליון
hercules	הירקיוליז
herda	הירדא
herget	הרגט
herman	הרמאן
hermann	הירמאן
hermesh	חרמיש
hernan	הירנאן
hernandez	הרנאנדיז
herodias	הירודיאס
herodotus	הירודוטוס
herold	הרולד
herschel	הירשיל
hershko	הירשקו
hertford	הירטפורד
hertzberger	הירצברגר
herut	חירות
herve	הירבה
herzberg	הירצבירג
herzl	הרצל
herzliya	הרצליה
herzog	הרצוג
heshmat	חשמט
hesperides	היספירידיס
hess	הס
hesse	היסה
hesselink	היסילינק
hester	הסטר
hestia	הסטיא
het	היט
hetfield	היטפילד
heurelho	הורילהו
heydar	חאידר
heyerdahl	האירדאל
heylens	היילנס
heyligen	היליגין
heynckes	הינקס
heynemann	היינימאן
heyse	הייס
hiam	היאם
hibbert	היברט
hicham	הישאם
hick	היק
hickersberger	היקרסבירגר
hidaka	הידאקא
hidalgo	הידאלגו
hidd	חיד
hiddink	הידינק
hideaki	הידיאקי
hidegkuti	הידיקוטי
hidekatsu	הידיקאטסו
hideki	הידיקי
hiden	הידן
hideo	הידיו
hidetoshi	הידיטושי
hiele	הילי
hierro	היירו
higgs	היגז
highmore	האימור
hijazi	חיג'אזי
hikaru	היקארו
hikmat	חקמט
hikmet	חיקמט
hila	הילה
hilarion	הילאריון
hilary	הילארי
hilbert	הילברט
hilde	הילדי
hildebrand	הילדבראנד
hilditch	הילדיטש
hill	היל
hillary	הילארי
hillel	הילל
hillingdon	הילינגדון
hilton	הילטון
hilu	חילו
hima	הימא
himmler	הימלר
hind	הינד
hindley	הינדלי
hines	האינז
hinkel	הינקל
hino	הינו
hintermaier	הינטרמאיר
hipolito	היפוליטו
hippolyte	היפוליט
hirano	היראנו
hiranuma	היראנומא
hirata	היראטא
hiro	הירו
hiroaki	הירואקי
hirobumi	הירובומי
hirofumi	הירופומי
hirohashi	הירוהאשי
hirohito	הירוהיטו
hiroki	הירוקי
hiroshi	הירושי
hiroshige	הירושיגה
hirosue	הירוסו
hiroyuki	הירויוקי
hirsch	הירש
hirschfeld	הירשפילד
hirsi	הירסי
hirz	חירז
hisato	היסאטו
hisham	הישאם
hispaniola	היספאניולא
hissene	חיסן
histadrut	הסתדרות
hitchcock	היצ'קוק
hitler	היטלר
hitman	היטמאן
hitomi	היטומי
hitoshi	היטושי
hittin	חיטין
hitzfeld	היצפילד
hjalmar	היאלמאר
hleb	הליב
hmam	חמאם
hmede	חמידה
hobart	הובארט
hobbes	הובז
hobeika	חובייקה
hochu	הוצ'ו
hocine	הוסין
hod	הוד
hoddle	הודל
hoeneß	הוניס
hoffman	הופמאן
hoffmann	הופמאן
hofi	חופי
hofstadter	הופשטאדטר
hogan	הוגאן
hojeij	חוג'ייג'
hojo	הוג'ו
hoko	הוקו
hokusai	הוקוסאי
holcer	הולקר
holden	הולדין
holderlin	הולדרלין
holguin	הולגוין
holiday	הולידאי
holl	הול
holland	הולאנד
hollein	הוליין
hollerith	הולירית
hollis	הוליס
holloway	הולויי
holly	הולי
holman	הולמאן
holmboe	הולמבוי
holmes	הולמז
holodomor	הולודומור
holon	חולון
holst	הולסט
holstein	הולסטין
holt	הולט
holyfield	הוליפילד
holzenbein	הולזנבאין
homaidan	חומידאן
homayoun	הומאיון
homnabad	הומנבאד
homocysteine	הומוסיסטין
hon	הון
honda	הונדא
honduras	הונדוראס
honecker	הוניקר
hong	הונג
honshu	הונשו
hoodia	הודיא
hooke	הוק
hope	הופ
hopkins	הופקינס
horacio	הוראסיו
horatio	הוריישיו
horie	הורי
horikawa	הוריקאוא
horison	הוריסון
horiuchi	הוריוצ'י
horizonte	הוריזונטי
horna	הורנא
horne	הורן
horowitz	הורוביץ
horst	הורסט
horwitz	הורויץ
hoshi	הושי
hoshino	הושינו
hoshyar	הושיאר
hosic	הוסיטש
hoskins	הוסקינס
hosni	חוסני
hosny	חוסני
hossam	חוסאם
hossein	חוסין
hosseini	חוסייני
hostilius	הוסטיליוס
houari	הוארי
houbara	חובארא
houghton	הוטון
houllier	הולייה
houssay	הוסאי
houssine	חוסין
houston	היוסטן
howard	האוארד
howe	האו
howells	האוולז
hoyte	הויט
hrant	הראנט
hrawi	הראוי
hrbaty	הרבאטי
hristo	הריסטו
hristov	הריסטוב
hrithik	הריתיק
hrodna	הרודנא
hrubesch	הרובש
hrvoje	הירבוי
hsien	חסין
huayna	הואינא
hubail	חובייל
hubais	הובייס
hubbard	הובארד
hubbert	הוברט
hubble	האבל
hubei	הוביי
huber	הובר
hubert	היוברט
huchel	הוכל
huckabee	האקאבי
huddlestone	האדלסטון
hudhayfah	חודייפה
hudna	הודנה
hudson	הודסון
huerta	הוארטא
huesca	הואסקא
huffman	הופמאן
huggel	האגל
hughes	היוז
hugo	היוגו
hugues	הוגיז
hui	הוי
hulagu	הולאגו
hulk	הלק
hull	הל
hulusi	חולוסי
humberto	הומבירטו
humboldt	האמבולט
hume	היום
hummelt	הומילט
humphrey	המפרי
humpty	האמפטי
humssi	חומסי
hunke	הונקה
hunt	האנט
huntington	האנטנגטון
huppert	הופירט
hurndall	הרנדל
hurst	הורסט
hurt	הורט
hurwitz	הורויץ
hus	הוס
husain	חוסיין
husbands	האזבינדז
husni	חוסני
hussain	חוסיין
hussam	חוסאם
hussein	חוסיין
husseini	חוסייני
husserl	הוסרל
huston	היוסטן
hutchinson	הוטשינסון
hutchison	האצ'יסון
huth	הות
hutu	הוטו
huub	הוב
huxley	האקסלי
huygens	הוגינס
hyam	הים
hyang	היאנג
hyde	האיד
hydrographic	האידרוגראפיק
hydrography	האיג'רוגראפי
hyori	היורי
hyundai	היונדאי
hyypia	היפיא
ian	איאן
iaquinta	איאקוינטא
iba	איבא
iberia	איביריא
ibiza	איביזא
ibn	איבן
ibrahim	איבראהים
ibtisam	איבטיסאם
idaho	אידאהו
idi	עידי
ido	אידו
idris	אידריס
ifeanyi	איפאניי
ifil	איפיל
iftar	איפטאר
igarashi	איגאראשי
iglesias	איגליסיאס
ignac	איגנץ
igor	איגור
ihara	איהארא
iii	אייי
ikea	איקיא
ikebana	איקיבאנא
ilan	אילן
ilana	אילנה
ileana	איליאנא
ilham	אילהאם
ilia	איליא
ilkhanate	אלכאנאט
illiasu	אליאסו
illinois	אילינוי
ilya	איליא
imamura	אימאמורא
imbarek	אמבארק
imereti	אימיריטי
imlay	אימליי
imola	אימולא
imperia	אמפיריא
imre	אימרי
imsaad	אמסאעד
inca	אינקא
india	אינדיא
indian	אינדיאן
indiana	אינדיאנא
indonesia	אינדוניז'א
indurain	אינדוריין
indyk	אינדיק
ingeborg	אינגיבורג
ingmar	אינגמאר
ingushetia	אנגושיטיא
inmarsat	אינמארסאט
innsbruck	אינסברוק
inonu	אינונו
insulin	אינסולין
into	אינטו
intron	אינטרון
ioannis	יואניס
iofan	איופאן
ion	איון
ionescu	איוניסקו
iordanescu	יורדאניסקו
irakli	איראקלי
iran	איראן
iraola	איראולא
iraqi	עיראקי
irbid	אירביד
ireland	אירלנדא
irina	אירינא
irit	אירית
irkutsk	אירקוטסק
irne	אירן
iroquois	אירוקויס
irvine	אירבאין
irving	אירבינג
irwin	אירוין
ishihara	אישיהארא
ishtar	אשטאר
isidore	איזידור
isilkul	איסילקול
isis	אייסיס
iskandar	איסקנדר
iskra	איסקרא
islam	איסלאם
ismail	אסמאעיל
ismet	עיסמט
israels	איזרילז
issam	עסאם
isser	איסר
issta	איסטא
issyk	איסיק
istanbul	איסטנבול
istra	איסטרא
istvan	איסטבאן
italy	איטאלי
itamar	איתמר
ivanhoe	איבאנהו
ivanovic	איבאנוביטש
ivanovo	איבאנובו
iverson	איברסון
ivo	איבו
ivri	איברי
izhar	איזהאר
izmir	איזמיר
jaafari	ג'עפרי
jaap	ג'אפ
jaaskelainen	יאסקילאינן
jabal	ג'בל
jaber	ג'אבר
jabi	ג'אבי
jableh	גבלה
jabotinsky	ג'בוטנסקי
jacek	ג'אסיק
jacinto	ג'אסינטו
jack	ג'ק
jackie	ג'קי
jackman	ג'אקמאן
jackson	ג'אקסון
jacky	ג'קי
jacmot	ג'אקמוט
jacobi	ג'אקובי
jacobs	ג'ייקובס
jacobson	ג'אקובסון
jacopo	יאקופו
jacquard	ג'אקאר
jacquet	ג'אקה
jad	ג'אד
jafargholi	ג'עפרגולי
jagdeo	ג'אגדיו
jahan	ג'האן
jahangir	ג'האנגיר
jahin	ג'אהין
jahn	יאן
jahsh	ג'חש
jaidi	ג'אידי
jaime	ג'יימי
jairzinho	ג'ארזיניו
jakob	ג'אקוב
jakub	ג'אקוב
jalal	ג'לאל
jaloo	ג'אלו
jamal	ג'מאל
jame	ג'יים
jamel	ג'אמל
jameson	ג'יימסון
jamie	ג'יימי
jamieson	ג'מיסון
jammeh	ג'אמע
jamuovandu	ג'אמובאנדו
jana	יאנא
jandali	ג'נדלי
jandl	יאנדל
jane	ג'יין
janez	ג'אניז
janine	ג'אנין
janis	ג'אניס
janko	יאנקו
jankovic	יאנקוביטש
janos	יאנוש
janovic	יאנוביטש
janowski	ג'אנוסקי
jansen	יאנסן
janssen	ג'אנסן
janssens	יאנסינס
jansson	ג'אנסון
janusz	יאנוש
jaouad	ג'ואד
jardel	ג'ארדל
jared	ג'אריד
jarkko	יארקו
jarno	יארנו
jaromir	יארומיר
jaroslav	יארוסלאב
jaroslaw	יארוסלו
jarrod	ג'ארוד
jasem	ג'אסם
jashari	ישארי
jasmila	יאסמילא
jason	ג'ייסן
jaspers	יאספרז
jassem	ג'אסם
jasseron	ג'אסירון
jassim	ג'אסים
jaurs	ג'אורס
javad	ג'אוואד
javier	חאבייר
jawad	ג'אואד
jawdat	ג'אודאט
jawed	ג'אווד
jawhar	ג'אוהר
jay	ג'יי
jaycee	ג'ייסי
jaziri	ג'זירי
jean	ג'ין
jeandupeux	ג'אנדופו
jedina	ג'דינא
jeff	ג'ף
jeffrey	ג'פרי
jehad	ג'האד
jelinek	יליניק
jellinek	יליניק
jenas	ג'ינאס
jencks	ג'נקס
jenei	ג'יניי
jenner	ג'נר
jenni	ג'ני
jennifer	ג'ניפר
jennings	ג'נינגז
jens	ינס
jensen	ג'נסן
jeremie	ג'רמי
jeremy	ג'רמי
jericho	ג'ריקו
jerkovic	ירקוביטש
jermain	ג'רמיין
jermaine	ג'רמיין
jerry	ג'רי
jerusalem	ג'רוסאלם
jerzy	יירזי
jesper	יספר
jesse	ג'סי
jessica	ג'סיקא
jesus	חיסוס
jettou	ג'טו
jezek	יזיק
jia	ג'יא
jiang	ג'יאנג
jianqing	ג'יאנקינג
jiayi	ג'יאי
jibril	ג'יבריל
jiechi	ג'יצ'י
jigoro	ג'יגורו
jihad	ג'יהאד
jim	ג'ים
jimmy	ג'ימי
jinyu	ג'יניו
jiri	ג'ירי
jito	ג'יטו
jlloyd	ג'לויד
jo	ג'ו
joachim	ג'ואקים
joan	ג'ון
joanna	ג'ואנא
joao	ג'ואו
joaquin	ג'ואקין
job	ג'וב
jocelyn	גוסלין
jocelyne	ג'וסלין
jochi	ג'וטשי
jodar	ג'ודאר
jody	ג'ודי
joel	ג'ול
joey	ג'וי
johan	יוהאן
johann	יוהאן
johanna	יוהנא
johannes	יוהאנס
johannesburg	ג'והאנסברג
johansson	יוהאנסון
johar	ג'והר
john	ג'ון
johnny	ג'וני
johns	ג'ונז
johnson	ג'ונסון
joji	ג'וג'י
jol	ג'ול
joleon	ג'וליון
jomei	ג'ומיי
jomo	ג'ומו
jon	ג'ון
jonah	ג'ונא
jonas	ג'ונאס
jonathan	ג'ונתן
jonbenet	ג'ונביניט
jonbent	ג'ונבינט
jones	ג'ונז
jongbloed	יונגבלויד
jonny	ג'וני
jonquet	ג'ונקויט
jonson	ג'ונסון
joop	ג'ופ
jop	ג'ופ
jordan	ג'ורדאן
jordao	חורדאו
jordi	יורדי
jorg	ג'ורג
jorge	ג'ורג'
jorgensen	יורגנסן
jorginho	ג'ורג'יניו
joris	יוריס
jorn	יורן
jorquera	חורקיירא
jorvan	ג'ורבאן
jos	ג'וס
joschka	יושקא
jose	חוסה
joseba	ג'וסיבא
josef	ג'וסף
josep	ג'וסיפ
joseph	ג'וזף
josephine	ג'וזפין
josephs	ג'וסיפז
josh	ג'וש
joshua	ג'ושוא
josip	ג'וסיפ
jospin	ג'וספאן
jostein	ג'וסטאין
josu	חוסו
jouhaux	ג'והו
jovan	ג'ובאן
jovian	ג'וביאן
joya	ג'ויא
joyce	ג'ויס
jozef	ג'וזף
jozsef	ג'וזיף
jrme	ג'רם
juan	חואן
juana	חואנא
juarez	ואריז
jubayr	ג'ובאיר
judah	ג'ודה
judd	ג'אד
judit	ג'ודית
judt	ג'ודט
juhasz	ג'והאז
juhfiyah	ג'וחפיה
jujiro	ג'וג'ירו
jules	ז'ול
julia	ג'וליא
julian	ג'וליאן
juliano	ג'וליאנו
julien	גול'יאן
juliet	ג'ולייט
julio	יוליו
julius	ג'וליוס
jumblatt	ג'ונבלאט
jun	ג'ון
junayd	ג'ונייד
jundiaad	ג'ונדיאד
junger	ג'ונגר
junghans	יונגהאנז
junichi	ג'וניצ'י
junichiro	גוניטשירו
juninho	ג'ונינהו
junior	ג'וניור
junko	ג'אנקו
junnin	ג'ונין
jupp	יופ
jurg	יורג
jurgen	יורגין
jurkemik	יורקמיק
jurota	ג'ורוטא
jussi	יוסי
just	ג'אסט
justin	ג'אסטן
justine	ג'אסטין
jusufi	יוסופי
jutland	גו'טלאנד
juuso	יוסו
juventud	ג'ובינטוד
kabardin	קאבארדין
kabil	קאביל
kabila	קאבילא
kabongo	קאבונגו
kaboul	קאבול
kabul	קאבול
kachalin	קאצ'אלין
kaczynski	קאטשינסקי
kadar	קאדאר
kaddoumi	קדומי
kadeer	קדיר
kader	קאדר
kadima	קדימה
kadisha	קאדישא
kadlec	קאדליץ
kadyrov	קדירוב
kaebi	קעבי
kafi	קאפי
kafka	קאפקא
kafr	קאפר
kagan	קאגאן
kago	קאגו
kahalani	קהלאני
kahana	כהנא
kahane	קאהאנא
kahlo	קאהלו
kahn	קאהן
kahneman	קאהנמאן
kahramanmaras	קהרמאנמאראס
kahwaji	קהווג'י
kaia	קאיא
kaiafas	קאיאפאס
kaifeng	קאיפנג
kaifu	קאיפו
kaimbi	קאימבי
kais	קייס
kaiserslautern	קאיזרסלאוטרן
kaishu	קאישו
kaizen	קאיזן
kaj	קאי
kajava	קאיאווא
kaji	קאג'י
kajiura	קאג'יורא
kakha	קאכא
kakheti	קאכיטי
kakhi	קקי
kaklamanakis	קאקלאמאנאקיס
kakonje	קאקונג'י
kaku	קאקו
kakuei	קאקויי
kakuro	קאקורו
kal	קאל
kalabane	קאלאבאן
kalac	קאלאטש
kaladze	קאלאדזה
kalaf	קאלאף
kalam	קלאם
kalanga	קאלאנגא
kalashnikov	קלאשניקוב
kalavryta	קאלאבריטא
kalfat	קאלפאט
kalifa	חליפה
kalililo	חלילילו
kaliningrad	קאלינינגראד
kalla	קאלא
kallon	קאלון
kallstrom	קאלסטרום
kalmykia	קאלמיקיא
kalo	קאלו
kalou	קאלו
kaltz	קאלץ
kalusha	קאלושא
kama	קמא
kamal	קמאל
kamamoto	קאמאמוטו
kamara	קאמארא
kambonde	קאמבונדי
kamei	קאמיי
kamen	קאמן
kamikawa	קאמיקאוא
kamil	קאמל
kamiya	קאמיא
kampf	קאמפף
kanaan	כנען
kanafani	קנפאני
kanchelskis	קאנצ'לסקיס
kandahar	קנדהאר
kander	קאנדר
kandinsky	קאנדינסקי
kaneto	קאניטו
kanfory	קאנפורי
kankoune	קנקוני
kanno	קאנו
kano	קאנו
kanoute	קאנוטי
kanpur	קאנפור
kansas	קאנסאס
kant	קאנט
kantaria	קנטאריא
kantaro	קאנטארו
kante	קאנטי
kanther	קאנתר
kanu	קאנו
kanye	קאנייה
kaori	קאורי
kaoru	קארו
kapadze	קאפאדזה
kapitsa	קאפיטסא
kaplan	קפלאן
kaplinsky	קאפלינסקי
kaplychnyi	קאפליצ'ני
kapo	קאפו
kappei	קאפיי
kapsis	קאפסיס
karaboue	קאראבויה
karadeniz	קאראדינז
karadzic	קאראדיטש
karaganda	קאראגאנדא
karagounis	קאראגוניס
karamanlis	קאראמנליס
karami	קראמי
karan	קאראן
karanusic	קראנוסיטש
karazon	קאראזון
kardec	קארדק
kareem	קרים
karel	קאריל
karembeu	קארימבו
karen	קארן
kargus	קארגוס
karim	קרים
karimi	קרימי
karin	קארין
kariokka	קאריוקא
kariri	קרירי
karkar	קארקאר
karl	קארל
karle	קארל
karlheinz	קארלהאינז
karloff	קארלוף
karlovy	קארלובי
karlsruhe	קארלסרוה
karlsson	קארלסון
karmi	כרמי
karnataka	קארנאטאקא
karnei	קארניי
karo	קארו
karol	קארול
karolina	קארולאינא
karolos	קארולוס
karoly	קארולי
karoui	קרוי
karpenko	קארפינקו
karrar	קראר
karren	קארין
karrer	קארר
karroubi	קארובי
kary	קארי
karzai	קרזאי
kasdan	קאסדאן
kasdi	קאסדי
kasey	קייסי
kashmir	קשמיר
kashua	קשוע
kasonde	קאסונדי
kaspar	קאספאר
kasper	קאספר
kasraoui	קסראוי
kassai	קאסאי
kassir	קסיר
kasyanov	קאסיאנוב
kata	קטע
katakana	קאטאקאנא
katalinski	קאטאלינסקי
katan	קטן
katanec	קאטאניטש
katayama	קאטאיאמא
kate	קייט
kateb	קאטב
katerina	קאטרינא
katharine	קאתארין
katherine	קאתרין
kathleen	קאתלין
kathmandu	קאתמנדו
kathy	קאתי
katie	קייטי
katip	קאטיפ
katlego	קאטליגו
katongo	קאטונגו
katowice	קאטויסא
katsav	קצב
katsina	קאטסינא
katsouranis	קאטסוראניס
katsu	קאטסו
katsuki	קאטסוקי
katsura	קאצורא
katzer	קאטזר
katzir	קציר
katzrin	קצרין
kaufman	קאופמאן
kaufmann	קופמאן
kav	קאב
kavakci	קאוקג'י
kavazashvili	קאבאזאשבלי
kaviedes	קאבידס
kawai	קאואי
kawakami	קאואקאמי
kawasumi	קאואסומי
kay	קיי
kayal	קאיאל
kaye	קיי
kayrouz	קיירוז
kaysone	קאיסון
kazakhstan	קאזאכסטאן
kazan	קאזאן
kazantzakis	קאזאנצאקיס
kazaz	קאזאז
kazenga	קאזינגא
kazimir	קאזימיר
kazimova	קאזימובא
kazuhiko	קאזוהיקו
kazuki	קאזוקי
kazuya	קאזויא
kazuyoshi	קאזויושי
keach	קיטש
keane	קין
keaton	קיטון
keats	קיטס
kedumim	קדומים
keegan	קיגאן
keene	קין
kees	קיז
kehl	קאהל
kei	קיי
keigo	קייגו
keiji	קייג'י
keiser	קיסר
keisuke	קיסוקה
keita	קייטא
keitel	קאיטל
keith	קית
keizo	קייזו
keketi	קקיטי
kela	קילה
keller	קלר
kelley	קילי
kelly	קילי
kelso	קילסו
kemal	קמאל
kemerovo	קימירובו
kemoko	קימוקו
kemp	קמפ
kempes	קימפס
kempff	קימפף
ken	קן
kenan	קינאן
kendo	קנדו
kendrick	קנדריק
kenenisa	קיניניסא
kengo	קינגו
kenji	קנג'י
kennedy	קינידי
kenneth	קינית
kenny	קיני
kenshin	קינשין
kensington	קנסינגטון
kent	קנט
kentaro	קינטארו
kentucky	קנטאקי
kenya	קיניא
kenyatta	קיניאטא
kenzaburo	קנזאבורו
kenzo	קנזו
kepler	קפלר
kerckhoffs	קירקהופס
keri	קירי
kerim	קרים
kerimov	קרימוב
kerkouane	קרקואן
kerlon	קירלון
kerrigan	קיריגאן
kerry	קירי
kertesz	קירטיז
kerviel	קרבייל
kesarev	קיסאריב
kessai	קיסאי
kesselring	קיסלרינג
ketone	קיטון
kettering	קיטירינג
kevin	קווין
kewell	קיוול
keynes	קינז
kfar	כפר
kfoury	קפורי
khachaturian	חאצ'אטוריאן
khader	חאדר
khairat	חאיראט
khalaf	חלף
khaldoun	חלדון
khaldun	חלדון
khaled	חאלד
khali	קאלי
khalid	חאלד
khalifah	חליפה
khalil	חליל
khalilou	חלילו
khallikan	חליקאן
khamees	חמיס
khamis	חמיס
khamtai	חאמטאי
khan	חאן
khashoggi	חאשוגי
khashuri	חאשורי
khatami	חאטמי
khatibi	חטיבי
khayachi	כאיאשי
khayyam	חיאם
kherson	חירסון
khidiyatullin	חידיאטולין
khizanishvili	קיזאנישבילי
khodadad	חודאדאד
khoren	חורין
khouloud	חולוד
khoury	חורי
khrushchev	חרושצ'ב
khumalo	קומאלו
khums	חומס
khurtsilava	חורטסילאבא
khusainov	חוסיינוב
khuwaylid	חואילד
kiarostami	קיארוסטאמי
kiatisuk	קאיטיסוק
kibaki	קיבאקי
kidd	קיד
kidman	קידמאן
kidmat	קידמט
kido	קידו
kiefer	קיפר
kieft	קיפט
kienast	קינאסט
kieran	קיראן
kieron	קירון
kiev	קייב
kiichi	קיצ'י
kiichiro	קיטשירו
kijuro	קיג'ורו
kiki	קיקי
kikuchi	קיקוצ'י
kila	קילא
kilambe	קילאמבי
killen	קילן
kilmer	קילמר
kilpin	קילפן
kim	קים
kimberly	קימברלי
kimi	קימי
kinan	קנאן
kingsley	קינגסלי
kingson	קינגסון
kingston	קינגסטון
kinkel	קינקל
kinmochi	קינמוצ'י
kinnear	קיניאר
kinney	קיני
kinnock	קינוק
kinsey	קינזי
kinshasa	קינשאסא
kinski	קינסקי
kipling	קיפלינג
kira	קירא
kiran	קיראן
kirby	קירבי
kirchner	קירשניר
kiri	קירי
kiribati	קיריבאטי
kirichenko	קיריצ'נקו
kiril	קיריל
kirilenko	קירילנקו
kirk	קירק
kirkilas	קירקילאס
kirschen	קירשן
kirschenbaum	קירשנבאום
kirshner	קירשנר
kirsten	קירסטן
kiryat	קרית
kisaichi	קיסאיצ'י
kiselyov	קיסיליוב
kishi	קישי
kisho	קישו
kisnorbo	קיסנורבו
kissinger	קיסינג'ר
kissufim	כיסופים
kist	קיסט
kit	קיט
kitano	קיטאנו
kitazawa	קיטאזאוא
kittisak	קיטיסאק
kitts	קיטס
kiwus	קיווס
kiyomori	קיומורי
kiyotaka	קיוטאקא
kiyoura	קיורא
kjar	קיאר
kjeld	קילד
klaipeda	קלאיפידא
klas	קלאס
klasnic	קלאסניטש
klaus	קלאוס
klaws	קלוס
klee	קליי
kleff	קליף
kleiber	קליבר
klein	קלאין
kleinert	קלאינירט
kliment	קלימנט
klimov	קלימוב
klimt	קלימט
kling	קלינג
klinger	קלינגר
klinghoffer	קלינגופר
klinsmann	קלינסמאן
klopp	קלופ
klose	קלוס
kluivert	קלויברט
knapp	קנאפ
knepper	נפר
knez	ניז
knezevic	ניזיביטש
knight	נאיט
knighton	נאיטון
knipper	קניפר
knobel	נובל
knowles	נוולז
knox	נוקס
knud	נוד
knut	קנוט
knuth	קנות
kobayashi	קובאיאשי
kobe	קובי
koblenz	קובלנז
kobushi	קובושי
kocharyan	קוצ'אריאן
kocsis	קושיס
koda	קודא
kodjo	קודג'ו
koechner	קושניר
koeman	קומאן
koevermans	קוברמאנס
kofi	קופי
koga	קוגא
kogyoku	קוגיוקו
koharu	קוהארו
kohl	קול
kohler	קולר
kohlschreiber	קולשראיבר
kohn	קון
koichi	קויצ'י
koiso	קויסו
koizumi	קויזומי
koji	קוג'י
koken	קוקן
koki	קוקי
kokoschka	קוקושקא
kokoszka	קוקוזקא
kol	קל
kolkata	קלקטא
kollhoff	קולהוף
kollontai	קולונטאי
kolmogorov	קולמוגורוב
kolo	קולו
kolodin	קולודין
kolodziejczak	קולודזיטשאק
koloman	קולומאן
kolotov	קולוטוב
koman	קומאן
komano	קומאנו
komljenovic	קומלינוביטש
komodo	קומודו
komora	קומורא
konchesky	קונשיסקי
kondo	קונדו
kondratiev	קונדראטייב
konev	קוניב
kong	קונג
konin	קונין
konishi	קונישי
konno	קונו
konoe	קונויה
konosuke	קונוסוקה
konrad	קונראד
konstantin	קונסטאנטין
konstantinos	קונסטאנטינוס
konstantinou	קונסטאנטינו
koolhaas	קולהאס
kopa	קופא
kopke	קופקה
koppel	קופל
korban	קורבן
korbut	קורבט
korea	קוריא
korean	קוריאן
korekiyo	קוריקיו
koren	קורן
korkmaz	קורקמאז
kornberg	קורנברג
kornel	קורנל
korneyev	קורנייב
korolenkov	קורולנקוב
korolyov	קורוליוב
koruturk	קורוטורק
koshi	קושי
kosin	קוסין
kossel	קוסל
kostas	קוסטאס
koster	קוסטר
kostic	קוסטיטש
kostikos	קוסטיקוס
kostunica	קוסטוניקא
kosugi	קוסוגי
kosuke	קוסוקי
kosygin	קוסיגין
kotarba	קוטארבא
kotaro	קוטארו
kotler	קוטלר
kotoko	קוטוקו
kotoku	קוטוקו
kouchner	קושנר
koudas	קודאס
kouis	קויס
kournikova	קורניקובא
kouyoumdjian	קויומגיאן
kovac	קובאטש
kovacevic	קובאטשיביטש
kovalyov	קובאליוב
kowalewski	קואלוסקי
kowloon	קאולון
koyama	קויאמא
koyamada	קויאמאדא
koyasu	קויאסו
koyre	קוירי
kozma	קוזמא
kozo	קוזו
kragujevac	קראגוג'יבאק
krajicek	קראיטשק
krakow	קראקו
kramer	קריימר
kramnik	קראמניק
kranjcar	קראניקאר
krankl	קראנקל
krasnodar	קראסנודאר
krauss	קראוס
krav	קרב
kreisky	קרייסקי
kremer	קרימר
kremers	קרימרז
kremnitz	קרמניץ
kreuzer	קרוזר
krim	קרים
kris	קריס
kristanna	קריסטאנא
kristen	קריסטין
kristensen	קריסטנסן
kristian	קריסטיאן
kristiansand	קריסטיאנסאנד
kristiansen	קריסטיאנסן
kristin	קריסטין
kristof	קריסטוף
krogh	קרוג
krol	קרול
kroldrup	קרולדרופ
kropotkin	קרופוטקין
kroto	קרוטו
krueger	קרוגר
krug	קרוג
kruger	קרוגר
krul	קרול
krutikov	קרוטיקוב
kruzen	קרוזן
krychowiak	קריצ'וביאק
krylov	קרילוב
krystian	קריסטיאן
krzynowek	קרזינוויק
kuan	קואן
kubala	קובאלא
kubar	קובאר
kublai	קובלאי
kubo	קובו
kubrick	קובריק
kubuntu	קובונטו
kudrow	קודרו
kuffer	קאפר
kufuor	קופור
kuhn	קון
kuka	קוקא
kul	קול
kulthum	קלתום
kumai	קומאי
kumar	קומאר
kumaratunga	קמאראטונגא
kumbh	קומב
kumm	קום
kundera	קונדירא
kunert	קונרט
kuni	קוני
kunihiko	קוניהיקו
kunishige	קונישיגי
kunitsyn	קוניטסין
kuntar	קונטאר
kuntz	קונץ
kuranyi	קוראני
kurdahi	קורדאחי
kurdistan	קורדיסטאן
kuroda	קורודא
kurokawa	קורוקאוא
kurosaki	קורוסאקי
kurosawa	קורוסאוא
kurt	קורט
kurtz	קורטז
kurzweil	קרזוייל
kusao	קוסאו
kusch	קוש
kushnir	קושניר
kusumi	קוסומי
kuszczak	קוצ'אק
kutaisi	קוטאיסי
kutcher	קאטשר
kuwashima	קואשימא
kuyt	קויט
kuznetsov	קוזניטסוב
kuznetsova	קוזנטסובא
kvasnak	קבאסנאק
kwadwo	קואדוו
kwai	קואי
kwanzaa	קואנזא
kwon	קוון
kyd	קיד
kyi	קי
kyle	קאיל
kyoto	קיוטו
kyrastas	קיראסטאס
kyrenia	קיריניא
kyrgiakos	קירגיאקוס
kyrklund	קירקלונד
kyu	קיו
kyuma	קיומא
kyzyl	קיזיל
labaki	לאבאקי
laban	לבן
labone	לאבון
lacarne	לאקארן
lacombe	לאקומב
lacour	לאקור
lacuesta	לאקויסטא
lada	לאדא
ladbroke	לאדברוק
ladd	לאד
ladislav	לאדיסלאב
ladovsky	לאדוביסקי
lady	ליידי
laertius	לירטיוס
lafuente	לאפוינטי
lagerback	לאגרבאק
lagerkvist	לאגרקביסט
lagos	לאגוס
laguna	לגונה
lahad	לחד
laheeb	להיב
lahham	לחאם
lahm	לאם
lahore	לאהור
lahoud	לחוד
lahzami	לחזאמי
lai	לאי
laird	לירד
lajos	לאיוס
lakis	לאקיס
lal	לאל
lama	לאמא
lamar	לאמאר
lamari	לאמארי
lambert	לאמבירט
lamberto	לאמברטו
lamborghini	לאמבורגיני
lambourde	לאמבורד
lambrichts	לאמבריכטס
lamia	לאמיא
lamine	לאמאין
lammens	לאמנס
lamont	לאמונט
lamport	לאמפורט
lampros	לאמפורוס
lamu	לאמו
lamy	לאמי
lamyaghri	למיאגרי
lana	לאנא
lanark	לאנאנרק
lancashire	לאנקשיר
lancaster	לאנקסטר
lance	לאנס
lancelot	לאנסלוט
landau	לאנדאו
landreau	לאנדרו
landry	לאנדרי
landsteiner	לאנדשטאינר
lanese	לאניזי
lang	לאנג
lange	לאנג
langer	לאנגר
langton	לאנגטון
lansana	לאנסאנא
lansbury	לאנסבורי
lansing	לאנסינג
lapetra	לאפיטרא
lapid	לפיד
laplace	לאפלאס
lara	לארא
larcher	לארשה
larfaoui	לערפאוי
larijani	לאריג'אני
larnaca	לארנקא
laroui	לערוי
larrionda	לאריונדא
larry	לארי
lars	לארס
larsen	לארסן
larsson	לארסון
larter	לארטר
laryea	לאריא
lascelles	לאסילס
lashley	לאשלי
laskarina	לאסקארינא
lasker	לאסקר
laslandes	לאסלאנד
lassalle	לאסאל
lassana	לאסאנא
lassina	לאסינא
last	לאסט
laszlo	לאסזלו
latimer	לאטימר
latina	לאטינא
latins	לאטינז
latoundji	לאטונג'י
latuff	לאטוף
latvia	לאטביא
lau	לאו
laudrup	לאודרופ
laughter	לאפטר
lauper	לופר
laura	לורא
lauren	לורן
laurence	לורנס
laurens	לורנס
laurent	לורינט
lauridsen	לאורידסן
laurie	לורי
laursen	לאורסן
lausanne	לוזאן
lava	לאבא
laval	לאבאל
lavan	לבן
laver	לאבר
lavey	לייבי
lavi	לביא
lavie	לאבי
lavigne	לאבין
lavoisier	לאבואזייה
lavon	לאבון
lavra	לאברא
lavronenko	לאברונינקו
lavrov	לאברוב
law	לו
lawal	לאואל
lawrence	לורנס
lawton	לוטון
laxness	לאקסנס
layne	ליין
layton	לייטון
lazare	לאזאר
lazarev	לאזאריב
lazaro	לאזארו
lazaroni	לאזארוני
lazaros	לאזארוס
lazarus	לאזארוס
lazio	לאזיו
lazzaro	לאזארו
lea	ליא
leah	ליה
leandro	ליאנדרו
lear	ליר
lebed	ליביד
lebert	ליברט
leblanc	לבלאנק
lech	לך
lecuona	ליקונא
lederberg	לידרברג
ledesma	לידיסמא
ledley	לידלי
lee	לי
leekens	ליקנז
legend	לג'נד
legia	ליגיא
legrottaglie	ליגרוטאלי
legwinski	ליגבינסקי
lehmann	ליהמאן
lei	ליי
leib	ליב
leibniz	לאיבנץ
leif	ליף
leigh	לי
leighton	לייטון
leila	לילא
leilei	לייליי
leipzig	לאיפזיג
leitgeb	ליטגיב
leko	ליקו
lem	לם
lemasson	למאסון
lemerre	לומיר
lemmouchia	לימוטשיא
len	לן
lena	לינה
lendvai	לינדבאי
lenev	לנב
lengeh	לנגה
lenglen	לנגלן
lennon	לנון
lenny	לני
lenstra	לינסטרא
lenz	לינז
leo	ליאו
leon	ליון
leonardo	ליונארדו
leone	ליון
leonel	ליונל
leonhard	ליונהארד
leonid	ליוניד
leonidas	ליונידס
leonor	ליונור
leonov	ליונוב
leopardi	ליופארדי
lepiller	ליפיליר
lepine	ליפאין
leptin	ליפטין
lerby	לרבי
lerdorf	לרדורף
lermontov	לרמנטוב
lerond	לירונד
leroux	לירו
leroy	לירוי
les	לס
lescott	ליסקוט
leslie	ליסלי
lesnar	ליסנר
lesniak	לסניאק
lessig	ליסיג
lessing	ליסינג
lestrade	ליסטראד
leterrier	לטרייר
leto	ליטו
leucine	לוסין
leumi	לאומי
leuven	לובין
lev	לב
levchenko	ליבצ'נקו
levi	ליואי
leviev	לבייב
levin	לוין
levine	לוין
levinger	לבינג'ר
levinson	לווינסון
levitsky	לויצקי
levy	לוי
lew	לו
lewandowski	ליבאנדובסקי
lewinsky	לוינסקי
lewis	לויס
leyton	לייטון
lezion	לזיון
lia	ליא
liakhov	ליאקוב
liam	ליאם
liamine	ליאמין
liane	ליאן
liaoning	לאיונינג
libar	ליבאר
libby	ליבי
libertadores	ליברטאדוריס
libeskind	ליבסקינד
libor	ליבור
libre	ליבר
lichtsteiner	ליכטסטיינר
licka	ליקא
lidice	לידיס
lidocaine	לידוקאין
lie	לאי
lieberman	ליברמאן
liebermann	ליברמאן
liedholm	לידהולם
liguria	ליגוריא
likud	ליכוד
lil	ליל
lilian	ליליאן
lilienthal	לילינטאל
lille	ליל
lillehammer	לילהאמר
lilli	לילי
lillian	ליליאן
lilly	לילי
lily	לילי
lima	לימא
liman	לימאן
limassol	לימאסול
limor	לימור
lin	לין
linares	לינאריס
lincoln	לינקולן
linda	לינדא
linder	לינדר
linderoth	לינדרות
lindfield	לינדפילד
lindh	לינד
lindsay	לינדסיי
lineker	ליניקר
ling	לינג
linn	לין
linney	ליני
linus	לאינוס
linux	לינוקס
linvoy	לינבוי
lionel	לאיונל
liotta	לאיוטא
lipa	ליפא
lipchitz	ליפשיץ
lipmann	ליפמאן
lipoma	ליפומא
lippi	ליפי
lippmann	ליפמאן
lipstadt	ליפסטדאט
lipton	ליפטון
lisa	ליסא
lisandro	ליסאנדרו
lissitzky	ליסיצקי
list	ליסט
liston	ליסטון
lita	ליטא
lithuania	ליתואיניה
littbarski	ליטבארסקי
little	ליטל
litton	ליטון
litvinenko	ליטבינינקו
litvinov	ליטבינוב
litzman	ליצמאן
liu	לו
liv	ליב
lively	לאיבלי
liverani	ליוויראני
livingston	ליבינגסטון
livingstone	ליבינגסטון
liviu	ליביו
livni	ליבני
livorno	ליבורנו
liz	ליז
liza	ליזא
lizarazu	ליזאראזו
ljubicic	ליוביסיטש
ljubinko	ליובינקו
ljubisa	ליוביסא
ljubljana	ליובליאנא
lloyd	לויד
loa	לוא
lobont	לובונט
loboue	לובוי
locarno	לוקארנו
lockhart	לוקהארט
lockheed	לוקהיד
locklear	לוקליר
loco	לוקו
lodetti	לודיטי
lodovico	לודוביקו
loetscher	לוטשר
logie	לוגי
logofet	לוגופיט
lohr	לוהר
loic	לואק
loko	לוקו
lola	לולא
lombroso	לומברוסו
lome	לום
london	לונדן
loos	לוס
lopez	לופז
lorca	לורקא
lordan	לורדאן
lordi	לורדי
loren	לורין
lorenz	לורנז
lorenzo	לורינזו
lorimer	לורימר
lossemy	לוסימי
lota	לוטא
lothair	לותייר
lothar	לותאר
lotte	לוט
lou	לו
louis	לויס
louisiana	לויזיאנא
loukas	לוקאס
lous	לוס
love	לוב
lovelace	לובלייס
lovell	לוביל
lovett	לוביט
lovric	לובריטש
low	לו
lowe	לו
lowenthal	לוינתאל
lowry	לאורי
lualua	לואלוא
luanda	לואנדא
lubitsch	לוביטש
lublin	לובלין
luc	לוק
luca	לוקא
lucarelli	לוקארילי
lucas	לוקאס
luccin	לוקין
luce	לוס
lucescu	לוקיסקו
lucia	לוסיא
luciano	לוסיאנו
lucien	לוסיאן
lucilio	לוסיליו
lucille	לוסיל
lucio	לוסיו
lucius	לוסיוס
lucky	לאקי
lucy	לוסי
ludo	לודו
ludovic	לודוביק
ludovico	לודוביקו
ludvik	לודביק
ludwig	לודביג
ludza	לודזא
lugano	לוגאנו
lugo	לוגו
luhansk	לוהאנסק
luigi	לויג'י
luis	לויס
luisao	לויסאו
luiz	לויז
luka	לוקא
lukacs	לוקאש
lukas	לוקאס
lukashenko	לוקאשינקו
lukasz	לוקאס
luke	לוק
lukoil	לוקויל
lule	לולי
lulea	לוליא
lumbini	לומביני
lumumba	לומומבא
lundgren	לאנדגרין
lundin	לונדין
lunney	לאני
luol	לואל
lupatelli	לופאטילי
lupe	לופ
lupescu	לופיסקו
lupolianski	לופוליאנסקי
lurie	לורי
lurz	לורז
lusaka	לוסאקא
lushan	לושאן
lussenhoff	לוסינהוף
lutfi	לוטפי
luther	לותר
lutz	לאץ
luxemburg	לוקסמבורג
luxemburgo	לאקסומבורגו
luyindula	לויינדולא
luzzatto	לוזאטו
lviv	לביב
lvov	לבוב
lydia	לידיא
lyman	לימאן
lymari	לימארי
lynch	לינץ'
lyndon	לינדון
lynn	לין
lynndie	לינדי
lynne	לין
lyonnais	ליונה
lyonne	ליון
lyudmila	לודמילא
maamar	מועמר
maariv	מעריב
maarouf	מערוף
maarten	מארטן
maastricht	מאסטריכט
maathai	מאתאי
maaya	מאיא
mabrouk	מברוק
mac	מאק
macala	מאצ'אלא
macanga	מאקאנגא
macapa	מאקאפא
macarthur	מאקארתר
macau	מאקאו
macbride	מאקבראיד
maccabi	מכבי
maccoby	מאקובי
macdiarmid	מאקדירמיד
macdonald	מאקדונאלד
macdowell	מאקדאול
maceio	מאסיו
macfadyen	מאקפאדין
machaalani	משעלאני
machine	מאשין
machlas	מאצ'לאס
macho	מאצ'ו
macias	מאסיאס
maciej	מאסיג'
mack	מאק
mackinnon	מאקינון
maclaine	מאקליין
macmillan	מאקמילאן
madame	מדאם
madanchi	מעדנצ'י
madani	מדני
maddah	מדאח
maddalena	מאדאלינא
madeira	מאדירא
madeleine	מאדלין
madelung	מאדלונג
maderno	מאדירנו
madison	מאדיסן
madjer	מאג'ר
madonna	מאדונא
madono	מאדונו
madrasah	מדרסה
madre	מאדרי
madrid	מדריד
madruzzo	מאדרוצו
madsen	מאדסן
maeda	מאידא
maezono	מייזונו
magalhaes	מאגאלהאיז
magath	מאגאת
magda	מאגדה
magdeburg	מאגדיבורג
magdi	מגדי
magellan	מאגלאן
maggie	מאגי
maghreb	מאגרב
magic	מאג'יק
magid	מגיד
magister	מאג'יסטר
magnificat	מאניפיקאט
magnin	מאגנין
magno	מאגנו
magnus	מאגנוס
magog	מגוג
magomedov	מאגומידוב
maguire	מאגואיר
mahabharata	מהאבהאראטא
mahal	מחל
mahalia	מאהאליא
mahamadou	מחמדו
maharashtra	מאהאראשטרא
mahdavikia	מהדאוויקיא
mahdi	מהדי
mahdoufi	מחתופי
maher	מאהר
mahesh	מאהש
mahfouz	מחפוז
mahler	מאהלר
mahmoud	מחמוד
mahmud	מחמוד
mahr	מאר
mahrous	מחרוס
mahut	מאהוט
mahyadi	מאהיאדי
mai	מאי
maia	מאיא
maidin	מאידן
maier	מאיר
maiga	מאיגא
maik	מאיק
maillart	מאילארט
maillet	מיילט
maillol	מאיול
maimon	מאימון
maine	מיין
mainz	מיינז
mairead	מיריד
majalli	מג'לי
majdi	מג'די
majed	מג'ד
majeed	מג'יד
majewski	מאג'וסקי
major	מייגו'ר
majorca	מאיורקא
majorelle	מאג'וריל
majstorovic	מאיסטרוביטש
majus	מג'וס
makaay	מקאי
makarios	מקאריוס
makasa	מאקאסא
makassar	מאקאסאר
makdisi	מקדיסי
maki	מאקי
makinwa	מאקינוא
makonnen	מאקונין
makoto	מאקוטו
makoun	מאקון
maksim	מאקסים
malaga	מאלאגא
malakian	מלקיאן
malakouti	מאלאקוטי
malal	מלאל
malalai	מלאלאי
malaren	מאלארין
malatesta	מאלאטיסטא
malawi	מאלאוי
malaysia	מאלייז'א
malbranque	מאלבראנק
malchiel	מלכיאל
malcolm	מאלקולם
maldera	מאלדירא
maldini	מאלדיני
maldives	מאלדאיבז
maldonado	מאלדונאדו
malek	מאלק
malevich	מאליביטש
malfoy	מאלפוי
malick	מאליק
malik	מאליק
malin	מאלין
malisse	מאליסה
malivai	מאליבאי
malkhaz	מאלכאז
malkin	מאלקין
malko	מאלקו
malloum	מעלום
mallya	מאליא
malmo	מאלמו
malone	מאלון
malot	מאלו
malouda	מאלודא
malta	מאלטא
maltese	מאלטיז
mamadou	מאמאדו
mamady	מאמאדי
mamdouh	ממדוח
mamet	מאמט
mami	מאמי
mamiko	מאמיקו
mamluk	ממלוק
mammeri	מעמרי
mamo	מאמו
mamoru	מאמורו
manaf	מנאף
managua	מאנאגוא
manama	מנאמה
mancini	מאנשיני
manda	מאנדא
mandala	מאנדאלא
mandanda	מאנדאנדא
mandi	מאנדי
mandola	מאנדולא
mandriva	מאנדריבא
mandy	מאנדי
manea	מאניע
maneiro	מאניירו
manet	מאנה
manfred	מאנפרד
manfredonia	מאנפרידוניא
manga	מאנגה
mangnall	מאנגנאל
manhattan	מאנהאטן
maniche	מאניש
manitoba	מאניטובא
manmohan	מאנמוהאן
mann	מן
mannheim	מאנהאים
mannin	מאנין
manning	מאנינג
manninger	מאנינגר
manolete	מאנוליטי
manouchehr	מנוצ'הר
mansare	מאנסארי
mansfield	מאנספילד
mansour	מנסור
mansouri	מנסורי
mantell	מאנטל
manu	מאנו
manuel	מאנויל
manuele	מאנויל
manzoni	מאנזוני
maozhen	מואז'ן
mapai	מפאי
maqam	מקאם
maqluba	מקלובה
mara	מרה
marach	מאראצ'
maranhao	מאראנהאו
marat	מאראט
marathon	מאראתון
marbrook	מרברוק
marbury	מארבורי
marc	מארק
marcel	מארסל
marcelino	מארסילינו
marcell	מארסיל
marcello	מארצ'לו
marcelo	מארטצ'לו
marchena	מארצ'ינא
marchetto	מארקיטו
marcia	מארסיא
marciano	מארסיאנו
marcin	מארצן
marco	מארקו
marcomanni	מארקומאני
marconi	מארקוני
marcos	מארקוס
marcus	מארקוס
marcuse	מארקוז
mardi	מארדי
mardy	מארדי
marek	מאריק
maresca	מאריסקא
margaret	מארגריט
margarete	מארגרט
margherita	מארגריטא
mari	מארי
maria	מאריא
marian	מאריאן
mariana	מאריאנא
marianne	מאריאן
mariano	מאריאנו
marias	מאריאס
maric	מאריק
marica	מאריקא
marie	מארי
mariette	מארייט
marilyn	מארילין
marin	מארין
marina	מארינא
marinca	מארינקא
mariner	מארינר
marinetti	מאריניטי
marino	מארינו
mario	מאריו
marion	מאריון
mariot	מאריוט
maris	מאריס
marisa	מאריסא
mariupol	מאריופול
marius	מאריוס
marjane	מרג'אן
mark	מארק
marketa	מארקיטא
markku	מארקו
marko	מארקו
marks	מארקס
markus	מארקוס
marlborough	מארלבורו
marlee	מארלי
marlene	מארלין
marley	מארלי
marlon	מארלון
maroc	מארוק
marois	מארוא
marom	מרום
maron	מארון
marouf	מערוף
maroun	מארון
marques	מארקיס
marquez	מארקיז
marrakchi	מראקשי
marriner	מארינר
marsden	מארסדן
marshall	מארשאל
mart	מארט
marta	מארטא
martelli	מארטילי
martens	מארטינז
martha	מארתא
martien	מארטין
martin	מארטן
martina	מארטינא
martinelli	מארטינילי
martinez	מארטיניז
martins	מארטינז
marton	מארטן
martov	מארטוב
martti	מארטי
marulanda	מארולאנדא
marwahin	מרווחין
marwan	מרואן
marx	מארקס
mary	מרי
maryam	מריאם
maryan	מאריאן
maryland	מארילאנד
marzel	מארזל
marzouk	מרזוק
marzouq	מרזוק
masaaki	מאסאקי
masaccio	מאסאצ'ו
masahiro	מאסאהירו
masai	מאסאי
masakazu	מאסאקאזו
masaki	מאסאקי
masakiyo	מאסאקיו
masako	מאסאקו
masami	מאסאמי
masaru	מאסארו
masaryk	מאזאריק
masashi	מאסאשי
masaya	מאסאיא
masayoshi	מאסאיושי
mascherano	מאסקיראנו
maserati	מסיראטי
mashal	משעל
masharawi	משהראוי
mashego	מאשיגו
mashhad	משהד
mashhur	משהור
mashrabiya	משרביה
masi	מאסי
masilela	מאסילילא
masing	מאסינג
masinga	מאסינגא
maskhadov	מסכאדוב
maslachenko	מאסלאצ'נקו
maslow	מאסלו
masny	מאסני
masopust	מאסופסט
masoud	מסעוד
massa	מאסא
massad	מסעד
massamasso	מאסאמאסו
massari	מסארי
massaro	מסארו
massawa	מאסאוע
massey	מאסי
massi	מאסי
massimo	מאסימו
massoud	מסעוד
masuda	מאסודא
masudi	מאסודי
matadi	מאטאדי
matar	מטר
mate	מאטי
matejovsky	מאטיובסקי
mateo	מאטיו
materazzi	מאטיראצי
mateut	מאטיוט
mathieu	מאטיו
mathijsen	מאתיסן
mati	מאטי
matias	מאטיאס
matilda	מאטילדא
matisse	מאטיס
matlin	מאטלין
mato	מאטו
matovinovic	מאטובינוביטש
matrai	מאטראי
mats	מאטס
matsuda	מאטסודא
matsui	מאטסוי
matsukata	מאטסוקאטא
matsukaze	מאטסקאזי
matsumoto	מאטסומוטו
matsuo	מאטסוו
matsuoka	מאטסוקא
matsushita	מאטסושיטא
matsuzawa	מאטסוזאוא
matt	מאט
matteo	מאטאו
matthaus	מאטאוס
matthew	מאתיו
matthias	מאטיאס
matti	מאטי
matty	מאטי
matus	מאטוס
matviyenko	מאטביינקו
matyas	מאטיאס
matza	מצה
maura	מורא
maureen	מורין
maurer	מורר
mauri	מורי
mauriac	מוריאק
maurice	מוריס
mauricio	מוריסיו
mauritania	מוריטייניא
maurizio	מוריזיו
mauro	מאורו
mauroy	מורוי
mauss	מאוס
mavros	מאברוס
max	מאקס
maxfield	מאקספילד
maxi	מאקסי
maxim	מקסים
maxime	מאקסים
maximilian	מאקסימיליאן
maximilien	מאקסמליאן
maximus	מקסימוס
maxwell	מאקסויל
may	מיי
maya	מאיא
mayakovsky	מאיאקובסקי
maybach	מייבאך
mayer	מאיר
mayne	מיין
mayumi	מאיומי
mazar	מזאר
mazarin	מאזארין
mazda	מאזדא
mazhar	מזהר
mazinho	מאזינהו
maziq	מאזיק
mazloum	מזלום
mazowiecki	מאזויקי
mazut	מאזוט
mazuz	מאזוז
mazzola	מאצולא
mbabane	מבאבאן
mbamba	מבאמבא
mbeki	מביקי
mbia	מביא
mbida	מבידא
mbo	מבו
mboma	מבומא
mbuyane	מבויאן
mcavoy	מקאבוי
mcbeal	מקביל
mcbride	מקבראיד
mccallany	מקאלאני
mccann	מקאן
mccarthy	מקארתי
mccartney	מקארטני
mcclair	מקליר
mccoist	מקויסט
mcconaughey	מאקונאהי
mccormick	מאקורמיק
mccracken	מקראקין
mcdaniel	מקדאניאל
mcdermott	מקדירמוט
mcdonnell	מקדוניל
mcdormand	מקדורמאנד
mcgrady	מקגריידי
mcgraw	מאקגראו
mcguinness	מאקגינס
mcindoe	מאקינדו
mckenna	מאקקינא
mckimson	מקימסון
mclachlan	מקלאקלאן
mclaren	מאקלארין
mclean	מקלין
mcmahon	מקמאהון
mcmanaman	מאקמאנאמאן
mcmillan	מאקמילאן
mcnab	מאקנאב
mcneil	מקניל
mcneill	מקניל
mcqueen	מאקקוין
mcstay	מקסטיי
mctiernan	מקטירנאן
mdledle	מדלידלי
meade	מיד
meazza	מיאצא
mechner	מקנר
meciar	מיצ'יאר
medan	מידאן
medawar	מדוור
medellin	מידילין
medvedev	מידבידיב
mee	מי
meeno	מינו
meeuws	מיוס
meg	מיג
mega	מגא
megabyte	מיגאבאיט
megalith	מיגלית
megalodon	מיגאלודון
meghni	מגני
megiddo	מגידו
mehaidli	מחידלי
mehanna	מהנא
mehdi	מהדי
mehlis	מיליס
mehmed	מחמד
mehran	מהראן
mehrdad	מהרדאד
mehri	מהרי
mehrzad	מהרזאד
meidani	מידאני
meier	מאיר
meiji	מייג'י
mein	מיין
meireles	מירילס
meissen	מיסן
mejdi	מג'די
mekan	מקאן
mekawy	מקאוי
mekorot	מקורות
mel	מל
melamed	מלמד
melanie	מילאני
melbourne	מלבורן
melchior	מלקיור
melhem	מלחם
melho	מלחו
melinda	מלינדא
melissa	מליסיא
meliton	מיליטון
melki	מלקי
mellberg	מלבירג
meller	מילר
mellouli	מלולי
melo	מילו
melora	מילורא
melpomene	מילפומיני
melrose	מלרוז
melvil	מלביל
melville	מילביל
melvin	מלווין
memering	מימירנג
memphis	ממפיס
men	מן
mena	מנא
menachem	מנחם
menchu	מנצ'ו
mendeleev	מנדלייב
mendelsohn	מנדלסון
mendelssohn	מנדלסון
menderes	מנדיריס
mendes	מינדיס
mendez	מינדיז
mendonca	מנדונקא
mendoza	מנדוזא
mendy	מנדי
menegazzo	מיניגאזו
menem	מנעם
menendez	מינינדיז
menezes	מיניזיס
mengele	מנגלה
menichelli	מניקילי
meno	מינו
mensah	מינסאה
mental	מינטאל
menzo	מינזו
mer	מר
merbah	מרבאח
mercator	מירקאטור
mercedes	מרסידס
mercosur	מירקוסור
mercure	מירקיור
mercury	מירקורי
meriah	מריאח
meridor	מרידור
merieme	מריאם
merk	מירק
merkaz	מרכז
merkel	מירקל
merneptah	מרנפטאח
mernissi	מרניסי
meron	מירון
mersenne	מירסין
mertesacker	מירטסאקר
merton	מירטון
mervyn	מירבין
meryl	מיריל
mesa	מסא
mesbah	מסבאח
meshir	משיר
meshulam	משולם
meskhi	מיסכי
mesrob	מסרוב
messali	מסאלי
messi	מסי
messier	מסייה
messina	מסינא
mesut	מיסוט
meszoly	מיסזולי
metallica	מיטאליקא
metgod	מיטגוד
methane	מיתיין
metin	מיטן
metreveli	מיטריבילי
metropolitana	מטרופוליטאנא
metsu	מיטסו
mettomo	מיטומו
metwalli	מטוואלי
metzelder	מצלדר
metzger	מצגר
metzudat	מצודת
meucci	מיוצ'י
meutstege	מוטסטיג
mevo	מיבו
mexes	מקסיס
mexico	מקסיקו
mey	מיי
meynieu	מייניו
meyrieu	מיריו
mezey	מיזי
mezzogiorno	מידזוגורנו
mhlongo	מהלונגו
mia	מיא
micah	מיקה
michael	מאיקל
michaels	מאיקלז
michal	מיקאל
michel	מישל
michelangelo	מאיקלאנג'ילו
michelet	מישליט
michelle	מישל
micheľ	מיכיל
michigan	מישיגאן
michiru	מיטשירו
mick	מיק
mickael	מקאיל
mickey	מיקי
micky	מיקי
micoud	מיקו
microsoft	מאיקרוסופט
middendorf	מידנדורף
middleton	מידלטון
midler	מידלר
midori	מידורי
midorikawa	מידוריקאוא
miescher	מישר
mignogna	מיניונא
migron	מיגרון
miguel	מיגל
migueli	מיגוילי
mihai	מיהאי
mihail	מיהאיל
mihajlovic	מיהאילוביטש
mika	מיקא
mikael	מיקאיל
mikari	מיקארי
mikati	מיקאטי
mike	מאיק
mikel	מיקל
mikey	מאיקי
mikhail	מיכאיל
mikheil	מיכאיל
miki	מיקי
mikimoto	מיקימוטו
mikio	מיקיו
mikis	מיקיס
mikkel	מיקל
mikko	מיקו
miklos	מיקלוס
mikoyan	מיקויאן
mikulas	מיקולאס
mil	מיל
mila	מילא
milad	מילאד
miladinovic	מילאדינוביטש
milan	מילאן
milano	מילאנו
milburn	מילבורן
mildred	מילדריד
mile	מיל
milenko	מילנקו
miles	מאילז
miletus	מיליטוס
mileva	מיליבא
miley	מאילי
milford	מילפורד
mili	מילי
miliband	מיליבאנד
milito	מיליטו
miljan	מיליאן
miljanic	מילאניטש
miljoona	מילג'ונא
milka	מילקא
mill	מיל
milla	מילא
millard	מילארד
millecamps	מיליקאמפס
miller	מילר
milli	מילי
millichip	מיליצ'יפ
milligan	מיליגאן
mills	מילז
milner	מילנר
milo	מאילו
milorad	מילוראד
milos	מילוש
milosevic	מילוסיביטש
milosz	מילוש
miloud	מילוד
milt	מילט
milton	מילטון
milutin	מילוטין
milutinovic	מילוטינוביטש
milva	מילבא
mimi	מימי
mimoun	מימון
mimouna	מימונה
mimouni	מימוני
mina	מינא
minagawa	מינאגאוא
minambres	מינאמבריס
minami	מינאמי
minamoto	מינאמוטו
minar	מינאר
minavand	מינאואנד
minerva	מינרבא
ming	מינג
mingyi	מינגי
mingyu	מינגיו
minh	מין
minix	מיניקס
minkowski	מינקובסקי
minnesota	מיניסוטא
minnie	מיני
minobe	מיינוב
minor	מינור
minorca	מינורקא
minoru	מינורו
minot	מינוט
minoungou	מינונגו
minsk	מינסק
mintoff	מינטוף
mintz	מינץ
miodrag	מיודראג
mira	מירא
miralem	מיראלם
miran	מיראן
miranda	מיראנדא
mirbeau	מירבו
mircea	מירסיא
mireille	מיריי
mirek	מיריק
mirel	מירל
miri	מירי
miriam	מיריאם
mirjalol	מירג'לול
mirko	מירקו
mirnyi	מירני
miro	מירו
miron	מירון
miroslav	מירוסלאב
mirsad	מירסאד
mirsadeghi	מירסאדקי
mischa	מישא
mishima	מישימא
miskito	מיסקיטו
missaoui	מיסאוי
mississauga	מיסיסוגא
mississippi	מיסיסיפי
mistral	מיסטראל
mit	מיט
mitanni	מיטאני
mitch	מיטש
mitchell	מיטשל
mite	מאיט
mitic	מיטיטש
mitnick	מיטניק
mitoraj	מיטוראי
mitropoulos	מיטרופולוס
mitsuaki	מיטסואקי
mitsubishi	מיטסובישי
mitsumasa	מיטסומאסא
mitsumune	מיטסומוני
mitsuo	מיטסו
mitt	מיט
mittal	מיטאל
mitterrand	מיטיראן
mitzpe	מצפה
miura	מיורא
miyake	מיאקי
miyamoto	מיאמוטו
miyano	מיאנו
miyata	מיאטא
miyazaki	מיאזאקי
miyazawa	מיאזאוא
miyu	מיו
miyuki	מיוקי
mizoram	מיזוראם
mizrahi	מזרחי
mizuki	מיזוקי
mizuno	מיזונו
mizushima	מיזושימא
mjallby	מג'אלבי
mkhalele	מכאללה
mladen	מלאדן
mladic	מלאדיטש
mladinic	מלאדיניטש
mlađan	מלאדיאן
mnari	מנארי
mndez	מנדיז
mngomeni	מנגומיני
moawad	מועואד
mobali	מובעלי
mobius	מוביוס
mobley	מובלי
mobutu	מובוטו
moby	מובי
moctezuma	מוקטיזומא
modena	מודנה
moder	מודר
modi	מודי
modiri	מודירי
modise	מודיסי
modou	מודו
modric	מודריטש
moeneeb	מוניב
moggi	מודג'י
moglen	מוגלין
mohaisen	מוחייסן
mohajerani	מוהאג'ראני
mohamed	מוחמד
mohammad	מוחמד
mohammadou	מוחמדו
mohs	מוס
mohsen	מוחסן
moisiu	מויסיו
moizan	מויזאן
mokdad	מוקדאד
mokhtar	מוחטאר
mokhtari	מוחטארי
mokoena	מוקוינא
molby	מולבי
moldova	מולדובא
moldovan	מולדובאן
moliere	מולייר
molina	מולינא
molla	מולא
mollemann	מולימאן
moller	מולר
molnar	מולנאר
mombasa	מומבאסא
momcilo	מומסילו
mommens	מומנז
mommsen	מומסן
mona	מונא
monaco	מונאקו
monaghan	מונאגאן
moncayo	מונקאיו
mond	מונד
monde	מונד
mondrian	מונדריאן
moneo	מוניו
monfils	מונפיס
monge	מונג
mongi	מונגי
mongke	מונקי
monica	מוניקא
moniz	מוניז
mononoke	מונונוק
monroe	מונרו
monrovia	מונרוביא
monsef	מונסף
montagnier	מונטאנייה
montague	מונטאגיו
montale	מונטאלי
montana	מונטאנא
montand	מונטאן
montasser	מונתסר
montcourt	מונטקורט
monte	מונטי
monteiro	מונטירו
montenegro	מונטיניגרו
montero	מונטירו
monterrey	מונטיריי
monterroso	מונטירוסו
montessori	מונטיסורי
monteverdi	מונטיבירדי
montevideo	מונטיבידיו
montez	מונטיז
montgomery	מונטגומרי
monti	מונטי
montmartre	מונטמארטר
montolivo	מונטוליבו
montparnasse	מונפארנאס
montpellier	מונפילייה
montt	מונט
monty	מונטי
monza	מונזא
moore	מור
moradi	מוראדי
morales	מוראליס
moran	מוראן
moratti	מוראטי
moravcik	מוראבצ'יק
moravia	מוראביא
mordechai	מורדכי
mordor	מורדור
more	מור
moreau	מורו
morell	מוריל
morello	מורילו
moreno	מורינו
moresby	מורסבי
moretti	מוריטי
morgenstern	מורגנסטירן
morgner	מורגנר
mori	מורי
morientes	מוריאנטס
morihei	מוריהיי
morihiro	מוריהירו
morikawa	מוריקאוא
morikubo	מוריקובו
morin	מורין
morini	מוריני
moriri	מורירי
morishima	מורישימא
morissette	מוריסיט
morita	מוריטא
moritz	מוריץ
morjane	מורג'יין
morley	מורלי
moro	מורו
morozevich	מורוזיביטש
morozov	מורוזוב
morphy	מורפי
morrell	מורל
morricone	מוריקוני
morris	מוריס
morrison	מוריסון
morro	מורו
morrow	מורו
morse	מורס
morte	מורטי
morten	מורטן
mortensen	מורטינסין
morton	מורטן
mosa	מוסא
mosab	מוסעב
mosaddeq	מוסאדק
moscoso	מוסקוסו
moseley	מוזלי
moshav	מושב
moshe	משה
moshoeu	מושיו
mosisili	מוסיסילי
moslem	מוסלם
mosley	מוזלי
moss	מוס
mosteghanemi	מוסטגאנמי
mosul	מוסול
motahhari	מוטהרי
moteab	מוטעב
moti	מוטי
motoko	מוטוקו
motran	מוטראן
motta	מוטא
motti	מוטי
mottram	מוטראם
mouath	מועאת
mouloud	מולוד
moumouni	מומוני
mounier	מוניר
mourad	מוראד
mourid	מוריד
mourinho	מורינהו
moussa	מוסא
moutinho	מוטינהו
mouynet	מויניט
mozambique	מוזאמביק
mphela	מפילא
mpumalanga	מפומאלאנגא
mr.	מיסטר
msarri	מסארי
mstislav	מסטיסלאב
mt	מט
muammar	מועמר
mubarak	מובארק
mubarek	מובארק
mudar	מודאר
mudhafar	מוזפר
mudi	מודי
mudingayi	מודינגאי
mudrik	מודריק
mugabe	מוגאבי
mughrabi	מוגרבי
mugihito	מוגיהיטו
muhamed	מוחמד
muhammadu	מוחמדו
muhammed	מוחמד
muharram	מוחארם
muhren	מוהרן
muin	מועין
muir	מויר
mukasey	מוקייזי
mukerji	מוקרג'י
mula	מולא
mulan	מולאן
mulenga	מולינגא
mulilo	מולילו
mulla	מולא
mullery	מולרי
mullis	מוליס
multatuli	מולטאטולי
mumbai	מומבאי
mumtaz	מומטאז
munaron	מונארון
munch	מונק
mundell	מאנדל
munich	מיוניך
munir	מוניר
munitis	מונאיטיס
munk	מנק
munoz	מונוז
munro	מונרו
munster	מונסטר
muntasser	מונתסר
munteanu	מונטינו
muntyan	מונטיאן
murad	מוראד
murakami	מוראקאמי
murano	מוראנו
murasaki	מוראסאקי
murawski	מוראוסקי
murayama	מוראיאמא
murcutt	מורקוט
murdoch	מורדוק
murdock	מרדוק
muren	מורן
muriel	מוריאל
murphy	מירפי
murray	מרי
mursal	מורסאל
murtala	מורטאלא
murtaz	מורטאז
murty	מורטי
musa	מוסא
musampa	מוסאמפא
muscat	מוסקאט
musemic	מוסימיטש
musharraf	מושארף
muslim	מוסלים
muslin	מוסלין
musonda	מוסונדא
musso	מוסו
mustafa	מוסטפא
mutal	מוטאל
mutarelli	מוטארילי
muti	מוטי
mutiu	מוטיו
mutran	מוטראן
mutu	מוטו
muwanga	מוואנגא
muzdalifah	מוזדליפה
muzinic	מוזיניטש
mwai	מואי
mwanza	מואנזא
mwaruwari	מוארווארי
mweene	מויני
myanmar	מיאנמאר
mykhaylychenko	מיכאליטשינקו
mykolaiv	מיקולאיב
mykonos	מיקונוס
myles	מאילז
myra	מאירא
myrdal	מירדאל
myriam	מיריאם
myskina	מיסקינא
myspace	מאיספייס
mytilene	מיטילין
mzali	מזאלי
naan	נאן
nabatame	נאבאטאמי
nabeel	נביל
nabih	נאבי
nabil	נביל
nacer	נאסר
nachbar	נאכבאר
nachshon	נחשון
nada	נאדא
nadal	נאדאל
nadav	נדב
nader	ניידר
nadia	נאדיא
nadim	נדים
nadine	ניידין
nadir	נדיר
naeim	נעים
naelson	ניילסון
nafa	נפאע
nafi	נאפי
nafti	נפטי
nagai	נאגאי
nagaland	נאגאלאנד
nagano	נאגאנו
nagi	נאגי
nagma	נאגמא
nagui	נאגי
naguib	נגיב
nahal	נחל
nahariya	נהריה
nahla	נחלה
nahman	נחמן
nahnah	נחנאח
nahuatl	נאהואטל
nahum	נחום
nahyan	נאהיאן
naif	נאיף
naihoum	נאיהום
naik	נאיק
naismith	נייסמית
najah	נג'אח
naji	נאג'י
najib	נג'יב
naka	נאקא
nakache	נקאש
nakagawa	נאקאגאוא
nakahara	נאקאהארא
nakai	נאקאי
nakamatsu	נאקאמאצו
nakamura	נאקאמורא
nakao	נאקאו
nakasone	נאקאסונה
nakata	נאקאטא
nakayama	נאקאיאמא
nakazawa	נאקאזאוא
nakshawani	נאקשוואני
nalbandian	נאלבאנדיאן
nambaryn	נאמבארין
nambu	נאמבו
namie	נאמי
nan	נאן
nana	נאנא
nanbudo	נאנבודו
nancy	נאנסי
nandor	נאנדור
nani	נאני
nanninga	נאנינגא
nansen	נאנסן
nantes	נאנטס
naohiro	נאוהירו
naoki	נאוקי
naoko	נאוקו
naomi	נעמי
naor	נאור
naotake	נאוטאקי
naphtali	נפתלי
naples	נאפלס
napolitano	נאפוליטאנו
naqqash	נקאש
nara	נארא
narazaki	נאראזאקי
narendra	נארינדרא
narey	נארי
narimene	נארימן
narita	נאריטא
narmer	נארמר
narongchai	נארונגצ'אי
narriman	נארימאן
nasdaq	נאסדאק
naseem	נאסים
naseer	נסיר
naser	נאסר
nash	נאש
nasheed	נאשיד
nashef	נאשף
nasib	נסיב
nasief	נאסיף
nasim	נסים
nasir	נאסיר
nasr	נסר
nasra	נסרה
nasrallah	נסראללה
nasreddin	נאסראדין
nasri	נסרי
nassar	נסאר
nasser	נאסר
nassim	נאסים
nasyrow	נסירוב
nat	נאט
natacha	נאטאשא
natale	נאטאלי
natalia	נאטאליא
natalie	נאטאלי
natanz	נאטאנז
natasa	נאטאסא
natasha	נאטאשא
nathalie	נאטאלי
nathan	נייתן
nathaniel	נאתאניאל
nathanson	נייתנסון
nativ	נתיב
nato	נאטו
natsume	נאטסומה
nattaporn	נאטאפורן
naumann	נאומאן
nauseb	נאוסב
navarre	נאבאר
navarro	נאבארו
navas	נאבאס
naveen	נאבין
naveh	נוה
navon	נבון
nawaz	נאואז
nawel	נואל
nayef	נאיף
naysmith	נייסמית
nazar	נזאר
nazem	נאזם
nazif	נזיף
nazik	נאזיק
nazim	נאזים
nazis	נאציז
nazli	נאזלי
ndadaye	נדאדאי
ndao	נדאו
ndikumana	נדיקומאנא
neal	ניל
neaman	ניעמאן
nebahat	נבאהט
nebraska	נבראסקא
ned	נד
neda	נדא
nedum	נידום
nedved	נדביד
neeman	נימאן
neeskens	ניסקינז
neeson	ניסון
nefertiti	נפרטיטי
nehoda	ניהודא
nehru	נהרו
neil	ניל
neill	ניל
nein	נאין
neira	ניירא
nekounam	נקונאם
nellis	ניליס
nelly	נלי
nelo	נילו
nelsen	נלסן
nelson	נלסון
nemanja	נימאניא
nemec	נימיטש
nemo	נמו
nenad	נינאד
nene	ניני
neot	ניות
nepal	נפאל
neptune	ניפטון
nereo	ניריו
neri	נירי
nermin	נרמין
nernst	נרנסט
nero	נירו
neruda	נירודא
nery	נירי
nessim	נסים
nesterov	נסטרוב
nestor	נסטור
netafim	נטפים
netanyahu	נوניהו
netivot	נתיבות
netolicka	ניטוליקא
netto	ניטו
neumann	נוימאן
neuville	נוביל
nevada	ניבאדא
neves	ניביס
neveu	נובו
neville	נוויל
new	ניו
newman	ניומאן
newsted	ניוסטד
newtown	ניוטאון
ney	ניי
nezami	נזאמי
ngatjizeko	נגאטג'זיקו
nhlapo	נהאלפו
niall	ניאל
niamey	ניאמי
niang	ניאנג
nicanor	ניקאנור
niccolo	ניקולו
nice	ניס
nick	ניק
nicklas	ניקלאס
nicky	ניקי
niclas	ניקלאס
nico	ניקו
nicola	ניקולא
nicolae	ניקולאי
nicolas	ניקולאס
nicole	ניקול
nicolet	ניקולה
nicolita	ניוקליטא
nicolo	ניקולו
niculae	ניקוליי
nidal	נידאל
nielsen	נילסן
nieminen	ניימינין
niemoller	נימולר
niepce	ניפס
niflheim	ניפלהאים
nigam	ניגאם
nigel	נאיג'ל
nigeria	נאיג'יריא
nightingale	נאיטינגייל
nighy	נאי
nihat	ניהאט
niigaki	ניגאקי
nik	ניק
nikki	ניקי
niklas	ניקלאס
nikola	ניקולא
nikolaev	ניקולאייב
nikolai	ניקולאי
nikolaos	ניקולאוס
nikolaou	ניקולאו
nikolay	ניקולאי
nikolayev	ניקולאייב
nikolic	ניקוליטש
nikoloudis	ניקולודיס
nikopolidis	ניקופולידיס
nikos	ניקוס
nili	נילי
nils	נילס
nilsson	נילסון
nilton	נילטון
nimar	נימר
nimeiry	נמיירי
nimitz	נימיץ
nina	נינא
nino	נינו
nippon	ניפון
nir	ניר
nisa	ניסא
nisan	ניסאן
nisanit	ניסנית
nishikawa	נישיקאוא
nishikori	נישיקורי
nishimura	נישימורא
nishizawa	נאשיזאוא
nisr	ניסר
nissan	ניסאן
nistelrooy	ניסטלרוי
nita	ניטא
nitra	ניטרא
nitza	ניצה
niue	ניו
niv	ניב
nivola	ניבולא
nixon	ניקסון
nizam	ניזאם
nizar	ניזאר
nkrumah	נקרומא
nnamdi	נאמדי
noah	נואה
noam	נועם
nobel	נובל
noble	נובל
noboru	נובורו
nobre	נוברי
nobunaga	נובונאגא
nobusuke	נובוסוקה
nobutoshi	נובטושי
nobuyuki	נובויוקי
nocerino	נוצ'ירינו
nodia	נודיא
noether	נותר
nogly	נוגלי
nohair	נוהייר
nojima	נוג'ימא
nokia	נוקיא
nolan	נולאן
nolasco	נולאסקו
nomvethe	נומביטי
nonacosane	נונאקוסיין
nonda	נונדא
nonie	נוני
noor	נור
norbert	נורברט
nordahl	נורדאל
nordin	נורדין
nordisk	נורדיסק
nordstrom	נורדסטרום
noreena	נורינא
norfolk	נורפולק
norgay	נורגיי
nori	נורי
noriaki	נוריאקי
noriega	נורייגא
norihiro	נוריהירו
noriko	נוריקו
norio	נוריו
norizan	נוריזאן
norman	נורמאן
normandy	נורמאנדי
norodom	נורודום
norrie	נורי
norte	נורט
northam	נורתאם
northfield	נורתפילד
norton	נורטן
nosrati	נוסרטי
nostra	נוסטרא
nostradamus	נוסטראדאמוס
noto	נוטו
notting	נוטינג
nottingham	נוטינגהאם
nou	נו
nouadhibou	נואדיבו
nouakchott	נואקשוט
nour	נור
nouri	נורי
nouvel	נובל
novak	נובאק
novartis	נובארטיס
novin	נובין
novotel	נובוטל
novotna	נובוטנא
nowitzki	נוביטסקי
nowruz	נורוז
nozomi	נוזומי
nozomu	נוזומו
nsibambi	נסיבאמבי
nubar	נובאר
nudelman	נודלמאן
numa	נומא
numan	נומאן
numidia	נומידיא
nunavut	נונאבוט
nunez	נוניז
nuno	נונו
nurenberg	נורינבירג
nuri	נורי
nurmi	נורמי
nursultan	נורסולטאן
nussbaum	נוסבאום
nussimbaum	נוסימבאום
nuwas	נוואס
nwaneri	נואנירי
nwankwo	נואנקו
nyarko	ניארקו
nyathi	ניאתי
nyerere	נירירי
nyilasi	נילאסי
nyquist	נאיקסט
obama	אובאמא
obeid	עובייד
oblast	אובלאסט
obsidian	אובסידיאן
octane	אוקטאן
octave	אוקטאב
octavio	אוקטאביו
octonion	אוקטוניון
odense	אודנסי
ofakim	אופקים
ofer	אופר
ofra	עפרה
ogogo	אוגוגו
ohara	אוהארא
ohio	אוהיו
oil	אויל
ojeili	עוג'יילי
okafor	אוקאפור
okamoto	אוקאמוטו
okazaki	אוקאזאקי
okello	אוקילו
okko	אוקו
oklahoma	אוקלאהומא
okuma	אוקומא
okwunwanne	אוקוונואני
olafur	אולאפור
olarra	אולארא
old	אולד
oldfield	אולדפילד
oldham	אולדהאם
olga	אולגה
olimpia	אולימפיא
oliveira	אוליביירא
oliver	אוליבר
olivero	אוליבירו
olivier	אוליבייר
olmert	אולמרט
olsson	אולסן
olympiad	אולימפיאד
olympias	אולימפיאס
olympic	אולימפיק
olympus	אולימפוס
omaar	עומר
omar	עומר
omari	עומארי
omri	עמרי
oncken	אונקין
ontario	אונטייריו
oppenheimer	אופנהימר
orabi	עוראבי
oracle	אוראקל
oranim	אורנים
oregon	אוריגון
orinoco	אורינוקו
orlandoni	אורלאנדוני
orleans	אורלינז
orlev	אורליב
orlov	אורלוב
ornella	אורנילא
orson	אורסון
ortega	אורטיגא
orwell	אורויל
oryol	אוריול
osama	אוסאמה
osborn	אוסבורן
osho	אושו
oskarsdottir	אוסקארסדוטיר
oslo	אוסלו
osman	עוסמאן
osment	אוסמנט
osseiran	עוסייראן
ossetia	אוסטיא
ostrava	אוסטראבא
osvaldo	אוסבאלדו
otaif	עוטייף
oti	אוטי
otmar	אוטמאר
ouanes	ואניס
ouarzazate	ורזאזאת
oued	וד
oulmou	אולמו
oumar	עומר
ousmane	עוסמאן
ovadia	עובדיה
owen	אוין
oyama	אויאמא
ozer	עוזייר
ozil	אוזיל
paasilinna	פאסילינא
pacifico	פאסיפיקו
packie	פאקי
pad	פאד
pagani	פאגאני
paganini	פאגאניני
page	פייג'
pagels	פייגלז
pagnani	פאניאני
pagnol	פאניול
paille	פייל
paillot	פאילוט
paine	פיין
painton	פיינטון
paintsil	פיינציל
pairetto	פאיריטו
paisley	פייזלי
pakistan	פאקיסטאן
pakito	פאקיטו
pakradouni	פקראדוני
palacio	פאלאסיו
palahniuk	פאלאניוק
palais	פאלה
palatinate	פאלאטינייט
palau	פאלאו
palermo	פאלרמו
palikir	פאליקיר
palin	פאלין
palladino	פאלאדינו
palladio	פאלאדיו
pallister	פאליסטר
palma	פאלמא
palmachim	פלמחים
palmas	פאלמאס
palminteri	פאלמינטרי
palmiro	פאלמירו
palop	פאלופ
paloschi	פאלוסקי
palotai	פאלוטאי
paltel	פאלטל
pam	פאם
pamarot	פאמארוט
pamplona	פאמפלונא
pamungkas	פאמונגקאס
pana	פאנא
panadol	פאנאדול
panagoulias	פאנאגוליאס
panandetiguiri	פאנאנדיטיגוירי
pancoast	פנקוסט
pancsics	פאנקסיקס
pandora	פאנדורא
panenka	פאנינקא
paneriai	פאניראי
pankhurst	פאנקהורסט
pantanal	פאנטאנאל
pantelic	פאנטיליטש
panucci	פאנוצ'י
paola	פאולא
paoli	פאולי
paolo	פאולו
papa	פאפא
papadopoulos	פאפאדופולוס
papafloratos	פאפאפלוראטוס
papas	פאפאס
pape	פאפי
papetti	פאפיטי
paphlagonia	פאפלאגוניא
paphos	פאפוס
papin	פאפין
papoulias	פאפוליאס
pappe	פאפה
papua	פאפוא
par	פאר
paracetamol	פאראסיטאמול
paradiso	פאראדיסו
paradorn	פאראדורן
paraguay	פאראגואי
paramor	פאראמור
parana	פאראנא
parc	פארק
pareto	פאריטו
parietti	פאריאטי
paris	פאריס
park	פארק
parkinson	פארקינסון
parkour	פארקור
parks	פארקס
parma	פארמא
parmenides	פארמנידס
paro	פארו
parreira	פארירא
parrish	פאריש
parsons	פארסונס
parthenon	פארתינון
partizan	פארטיזאן
pasanski	פאסאנסקי
pascal	פאסקאל
pascale	פאסקאל
pascani	פאסקאני
pasco	פאסקו
pascoal	פאסקואל
pascual	פאסקואל
pasdar	פאסדאר
pasha	פאשא
pasqual	פאסקואל
pasquale	פאסקואלי
pasqualetti	פאסקואליטי
passarella	פאסארילא
passy	פאסי
pastan	פאסטאן
pasternak	פאסטרנאק
pasteur	פאסטור
paston	פאסטון
pastrana	פאסטראנא
pasulko	פאסולקו
pat	פאט
patagonia	פאטאגוניא
paterson	פאטרסון
patience	פיישאנס
patil	פאטיל
patmos	פאטמוס
pato	פאטו
patocka	פאטוקא
patrice	פאטריס
patricia	פאטרישא
patricio	פאטריסיו
patrick	פאטריק
patrik	פאטריק
pattaya	פאטאיא
patterson	פאטירסון
patti	פאטי
pattinson	פאטינסון
patton	פאטן
pau	פאו
paul	פול
paula	פאולא
pauleta	פאוליטא
paulina	פאולינא
pauline	פולין
paulino	פאולינו
paulo	פאולו
paulson	פולסון
paulus	פאולוס
pausini	פאוזיני
paxton	פאקסטן
payne	פיין
payton	פייטון
paz	פאז
pazdan	פאזדאן
pearce	פירס
pearl	פירל
pearson	פירסון
peary	פירי
peck	פיק
pedersen	פידרסן
pedretti	פידריטי
pedros	פידרוס
peel	פיל
pegasus	פגאסוס
peggy	פגי
peguy	פיגוי
pekerman	פקרמאן
pele	פלה
pelle	פילי
pellegrini	פיליגריני
pelli	פילי
peloponnese	פילופוניז
pelosi	פילוסי
peltier	פלטייר
peltola	פלטולא
pelton	פילטון
peluce	פלוס
pena	פינא
penelope	פנלופי
peng	פינג
penh	פן
penn	פן
pennac	פנאק
pennant	פינאנט
pentecost	פנטיקוסט
peoria	פיוריא
pepe	פפה
pepin	פפין
pepper	פיפר
pepsi	פפסי
per	פיר
percy	פירסי
perec	פרק
pereira	פיריירא
perelman	פרלמאן
peres	פרס
peretz	פרץ
perez	פיריז
perham	פירהאם
peri	פרי
perkins	פירקינז
perl	פירל
perlman	פרלמאן
perlmutter	פירלמוטר
pero	פירו
peron	פירון
perrin	פירין
perrineau	פירינו
perry	פירי
persephone	פירסיפוני
persie	פירסי
persson	פירסון
peru	פירו
perusic	פירוסיטש
perusini	פירוסיני
perutz	פירוץ
peruzzi	פירוצי
peseiro	פסיירו
pessoa	פיסוא
petain	פיטאן
peter	פיטר
peterson	פיטרסון
petit	פיטיט
petr	פיטר
petra	פיטרא
petras	פטראס
petre	פיטרי
petri	פיטרי
petric	פטריטש
petronio	פיטרוניו
petropolis	פטרופוליס
petros	פטרוס
petrosian	פיטרוסיאן
petru	פיטרו
petter	פיטר
pettis	פטיס
petty	פיטי
peya	פיא
peyton	פייטון
pezzey	פיזיי
pfannkuch	פפאנקוטש
pfeiffer	פפאיפר
pfister	פפיסטר
pflugler	פפלוגלר
phanrit	פאנריט
pharaon	פרעון
phau	פאו
phelps	פילפס
phenylketonuria	פינאילקיטונוריא
phil	פיל
philadelphia	פילאדלפיא
philip	פיליפ
philipp	פיליפ
philippe	פיליפ
philippines	פיליפינז
philippoussis	פיליפוסיס
philips	פיליפס
phillimon	פילימון
phillip	פיליפ
phillips	פיליפס
phnom	פנום
phoenix	פיניקס
photoshop	פוטושופ
piaf	פיאף
piano	פיאנו
piatra	פיאטרא
piatti	פיאטי
piaui	פיאוי
picasso	פיקאסו
piccadilly	פיקאדילי
piccinino	פיטשינינו
piccoli	פיקולי
piceno	פיסינו
pickett	פיקיט
pienaar	פינאר
pierangelo	פייראנגלו
pierce	פירס
pierino	פיירינו
pierluigi	פיירלויג'י
piero	פיירו
pierre	פיאר
piet	פיט
pieter	פיטר
pietro	פייטרו
pike	פאיק
pilguy	פילגוי
pim	פים
pinchas	פנחס
pinel	פיניל
pinhas	פנחס
pini	פיני
pininfarina	פינינפארינא
pink	פינק
pinochet	פינושה
pinter	פינטר
piola	פיולא
pioline	פיולין
piontek	פיונטיק
piotr	פיוטר
pious	פאיוס
pipes	פאיפס
piquionne	פיקיון
pirandello	פיראנדילו
pire	פיר
pires	פיריז
pirlo	פירלו
piroxicam	פירוקסיקאם
pisa	פיזא
piscator	פיסקאטור
pistoia	פיסטויא
pistone	פיסטוני
piszczek	פיזשיק
pitesti	פיטיסטי
pitt	פיט
pitts	פיטס
piturat	פיטוראט
piturca	פיטורקא
pizarro	פיזארו
pjanic	פיאניטש
placente	פלאסנטי
placido	פלאסידו
plamen	פליימן
planinc	פלאנינק
planus	פלאנוס
plasil	פלאסיל
plata	פלאטא
platini	פלאטיני
platko	פלאטקו
plautz	פלאוץ
pless	פליס
plessers	פליסירז
plessis	פליסיס
pletikosa	פליטיקוסא
ploetz	פלוטז
ploiesti	פלויסטי
plunkett	פלאנקיט
plus	פלאס
pluskal	פלוסקאל
plutarch	פלוטארך
pluto	פלוטו
pnina	פנינה
pocahontas	פוקאהונטאס
pocatello	פוקאטילו
pochettino	פוטשיטינו
podesta	פודיסטא
podgorica	פודגוריקא
podolski	פודולסקי
poe	פו
poirot	פוירוט
poisson	פואסון
poitier	פואטייה
pol	פול
polanski	פולאנסקי
polat	פולאט
polgar	פולגאר
poll	פול
pollak	פולק
polleunis	פולינס
polley	פולי
pollock	פולוק
polly	פולי
pollyanna	פוליאנא
polo	פולו
polyene	פוליין
polyhymnia	פוליהימניא
polykleitos	פוליקליטוס
polynesia	פוליניזיא
pompeii	פומפיי
pompeo	פומפיו
pompeu	פומפיו
pompidou	פומפידו
pompilius	פומפיליוס
pompon	פומפון
ponaryo	פונאריו
pond	פונד
ponedelnik	פונידילניק
ponnet	פוניט
pontes	פונטיס
pontoppidan	פונטופידאן
ponzi	פונזי
ponzio	פונזיו
poom	פום
popa	פופא
popescu	פופיסקו
popluhar	פופלוהאר
popper	פופר
porphyria	פורפיריא
porsche	פורש
portas	פורטאס
porterfield	פורטרפילד
portland	פורטלאנד
portman	פורטמאן
portoghesi	פורטוגסי
porush	פורוש
poseidon	פוסידון
posey	פוזי
pospech	פוספיך
pot	פוט
potato	פוטאטו
poti	פוטי
potito	פוטיטו
potocari	פוטוקארי
potok	פוטוק
potomac	פוטומאק
potsdam	פוטסדאם
potter	פוטר
poul	פול
poulantzas	פולאנצאס
pound	פאונד
poupakis	פופאקיס
pourcel	פורסל
pourpirar	פורפיראר
poussin	פוסן
poznan	פוזנאן
pozo	פוזו
pozzo	פוצו
pradesh	פראדיש
prado	פראדו
praia	פראיא
prandelli	פראנדילי
pranjic	פראניטש
praseodymium	פראסיודימיום
prati	פראטי
premysl	פרימסל
prescott	פריסקוט
preseren	פריסירן
presley	פריסלי
preston	פריסטון
pretoria	פריטוריא
price	פראיס
prieto	פרייטו
primorsko	פרימורסקו
primus	פראימוס
prince	פרינס
princess	פרינסס
prion	פריון
priscus	פריסקוס
pristina	פריסטינא
prodi	פרודי
progeria	פרוגיריא
prokop	פרוקופ
proline	פרולין
prometheus	פרומיתיוס
promethium	פרומיתיום
propane	פרופיין
propolis	פרופוליס
prost	פרוסט
protocol	פרוטוקול
proust	פרוסט
proxima	פרוקסימא
proyas	פרויאס
prso	פרסו
prudius	פרודיוס
prunier	פרונייה
prussia	פראשא
pruzzo	פרוצו
pryor	פראיור
pteranodon	פטיראנודון
puchner	פוכנר
puerta	פוארטא
puerto	פוארטו
puglisi	פוליזי
puhl	פול
pulcheria	פולכריא
pulci	פולשי
puli	פולי
pulitzer	פוליצר
pulsa	פולסא
purcell	פורסל
puricelli	פוריצ'לי
pushkin	פושקין
puskas	פוסקאס
putin	פוטין
putnam	פוטנאם
puttan	פוטאן
puyol	פויול
puzo	פוזו
pygmalion	פיגמאליון
pykalisto	פיקאלסטו
pyotr	פיוטר
python	פאיתון
qabbani	קבאני
qalqilyah	קלקיליה
qana	קאנא
qanso	קאנסו
qantas	קואנטאס
qaraoun	קרעון
qaruh	קארוה
qasim	קאסים
qin	קוין
qosimov	קוסימוב
quagliarella	קואליארילא
quaid	קוייד
quan	קואן
quaresma	קואריסמא
quashie	קואשי
quasimodo	קואזימודו
qubad	קובאד
quebec	קויביק
queensland	קוינסלאנד
queeny	קויני
quesnay	קיניי
queudrue	קודרו
quidde	קויד
quim	קוים
quinn	קוין
quintin	קוינטין
quinto	קוינטו
quinton	קוינטון
quixote	קיוטי
qumran	קומראן
qusay	קוסיי
qutb	קוטב
quzman	קוזמאן
qvist	קביסט
raab	ראב
rabah	ראבח
rabbah	ראבא
rabia	רביע
rabie	רביע
rabin	רבין
rabindranath	ראבנדראנאת
rabiu	ראביו
rabuel	ראבואל
rachad	ראצ'אד
rachael	ראיצ'ל
rachel	רייצ'ל
rachid	רשיד
rachmaninoff	רכמאנינוף
radanovic	ראדאנוביטש
radcliffe	ראדקליף
radek	ראדיק
radha	ראדהא
radhi	ראדי
radice	ראדישי
radio	ראדיו
radiohead	ראדיוהד
radoi	ראדוי
radojko	ראדויקו
radomir	ראדומיר
radon	ריידון
radoslav	ראדוסלאב
radovan	ראדובאן
radu	ראדו
raducioiu	ראדוסיו
radwanska	ראדואנסקא
raef	ראאף
raemon	ראימון
rafa	רפא
rafael	רפאל
rafah	רפח
rafal	ראפאל
rafe	רפה
raffaele	רפאלי
raffi	רפי
rafi	רפי
rafik	רפיק
ragheb	ראגב
raghib	ראגיב
rahel	ראחיל
rahman	רחמן
rahmati	ראמאטי
rai	ראי
raikkonen	ראיקונן
raimi	ראימי
rainea	ראיניא
rainer	ראינר
raja	רג'א
rajab	רג'ב
rajavi	רג'אבי
rajko	ראיקו
rajoelina	רג'ולינא
rajoub	ר'גוב
rakhsh	ראכש
rakosi	ראקוסי
raldes	ראלדיס
raleb	ראלב
ralf	ראלף
ralph	ראלף
ralston	ראלסטון
rama	ראמא
ramage	ראמאג'
ramamurthy	ראמאמורתי
ramat	ראמאט
ramayana	ראמאיאנא
ramaz	ראמאז
ramazan	רמזאן
ramazzotti	ראמאזוטי
rambutan	ראמבוטאן
ramdane	רמדאן
rameau	ראמו
ramel	ראמל
ramesses	רמסיס
rami	ראמי
ramin	ראמין
ramires	ראמירס
ramirez	ראמיריז
ramla	רמלה
ramljak	ראמליאק
rammal	רמאל
ramn	ראמן
ramon	ראמון
ramos	ראמוס
rampal	ראמפאל
ramsay	ראמסיי
ramsey	ראמסיי
ramzan	רמזאן
ramzi	רמזי
ramzy	רמזי
rand	ראנד
randolph	ראנדולף
rani	ראני
ranieri	ראניירי
ransford	ראנספורד
ransome	ראנסום
rapaic	ראפאייטש
raphael	רפאל
rapp	ראפי
ras	ראס
rasa	ראסא
raschke	ראשקי
rashad	רשאד
rasheed	רשיד
rashid	רשיד
rashidi	רשידי
rashomon	ראשומון
rasizade	ראסיזאדה
raslan	רסלאן
rasmus	ראסמוס
rasmussen	ראסמוסין
rasoul	רסול
rastafari	ראסטאפארי
rasul	רסול
rat	ראט
rateb	ראטב
ratko	ראטקו
ratomir	ראטומיר
rats	ראטס
ratzel	ראטזל
raul	ראול
ravenna	ראבינא
raver	רייבר
ravi	ראבי
ravier	ראוייר
ravin	ראבין
ravitz	רביץ
raviv	רביב
ravousis	ראבוסיס
ravshan	ראבשאן
rawhi	ראוחי
rawls	רולז
ray	ריי
raymond	ראימונד
rayyan	ריאן
raz	ראז
razak	רזק
razvan	ראזבאן
razzano	ראזאנו
reagan	רייגן
rebecca	רביקא
recoba	ריקובא
recouderc	ריקודירק
reda	רדא
redd	רד
redfa	רדפא
redha	רדא
redknapp	רידנאפ
redmond	רדמונד
rednic	רידניק
redon	רידון
redondo	רידונדו
reed	ריד
reem	רים
regan	ריגן
regensburg	ריגנסברג
regueiro	ריגיירו
rehavam	רחבעם
rehema	רחימה
rehman	רחמאן
rehnquist	רינקויסט
rehovot	רחובות
reich	ראיק
reichs	ריקס
reichstein	ראיכשטאין
reid	ריד
reijiro	רייג'ירו
reiki	רייקי
reilly	ראילי
reimann	ראימאן
reinaldo	רינאלדו
reinders	ריינדירס
reiner	ראינר
reinhard	רינהארד
reinhardt	ראינהארט
reinhart	ריינהארט
reinhold	ראינהולד
reiser	רייזר
reitsch	ראיטש
rejewski	רג'וסקי
relmy	רילמי
rem	רים
rembrandt	רמבראנט
remetter	רימיטיר
remi	רימי
remy	רמי
rena	רינא
renan	רינאן
renat	רנאט
renate	רינאט
renato	רינאטו
renaud	רינו
renault	רינולט
rene	רנה
renner	רינר
reno	רינו
renones	רינוניס
renquin	רינקוין
renschler	רנשלר
rensenbrink	רינסינברינק
rensing	רינסניג
renzo	רינזו
rep	רפ
repetto	ריפיטו
reto	ריטו
reuter	רויטר
reuven	ראובן
revaz	ריבאז
reveillere	ריביליר
revelle	רבל
revere	ריביר
revie	ריבי
rex	רקס
rexhep	רג'פ
rexhepi	רקפי
reyad	ריאד
reyes	רייס
reymont	ריימונט
reynaud	רינו
reynolds	רינאלדז
reza	רזא
rhee	רי
rhodesia	רודיסיא
ri	רי
riad	ריאד
ribbeck	ריביק
ribeiro	ריביירו
ribisi	ריביסי
ribot	ריבו
rica	ריקא
ricardinho	ריקארדינהו
riccardo	ריקארדו
ricci	ריצ'י
rice	ראיס
richard	ריצ'ארד
richards	ריצ'ארדז
richardson	ריצ'ארדסון
richelieu	רישיליו
richert	ריצ'רט
richie	ריצ'י
richter	רישטר
richthofen	רישטהופן
ricin	ריסין
ricki	ריקי
rickman	ריקמאן
rico	ריקו
ridgewell	רידג'וול
ridley	רידלי
rie	ריה
riedl	רידל
riedle	רידל
riegel	ריגל
riemann	רימאן
rietveld	ריטוילד
rieu	ריו
rifaat	ריפעט
riggott	ריגוט
rigobert	ריגוברט
rigoberta	ריגובירטא
riise	רייסה
rijkaard	ריקארד
rijsbergen	ריסבירגן
rik	ריק
rikdo	ריקדו
rikiya	ריקיא
riley	ראילי
rimbaud	רימבו
rimet	רימיט
rimini	רימיני
rimitti	רימיטי
rimon	רימון
rina	רינא
rinaldo	רינאלדו
rinat	רינת
rincon	רינקון
ringo	רינגו
rinko	רינקו
rino	רינו
rio	ריו
rioch	ריוצ'
riou	ריו
ripley	ריפלי
riquelme	ריקילמי
riskin	ריסקין
risser	ריסר
rissos	ריסוס
risto	ריסטו
ritchie	ריצ'י
ritsos	ריטסוס
ritt	ריט
ritter	ריטר
riva	ריבא
rivas	ריבאס
rivera	ריבירא
riveros	ריבירוס
rivest	ריבסט
rivilla	ריבילא
rivoli	ריבולי
riyashi	ריאשי
rizal	ריזאל
rizik	ריזיק
rizk	ריזק
rizwan	ריזואן
rizzitelli	ריציטילי
rmaich	רמייש
rob	רוב
robben	רובן
robbie	רובי
robbins	רובניז
robert	רוברט
roberto	רוברטו
roberts	רוברטס
robertson	רוברטסון
robeson	רובסון
robin	רובן
robinho	רובינהו
robinson	רובנסון
robinsons	רובינסונז
robredo	רוברידו
robson	רובסון
rocchi	רוקי
rocco	רוקו
rocha	רושא
roche	רוש
rochelle	רושיל
rochemback	רוצ'מבאק
rocheteau	רוצ'יטו
rochus	רושוס
rockmond	רוקמונד
rockwell	רוקוול
rod	רוד
roddick	רודיק
roddy	רודי
roderick	רודריק
rodin	רודאן
rodney	רודני
rodolfo	רודולפו
rodolphe	רודולף
rodrigo	רודריגו
rodrigues	רודריגז
rodriguez	רודריגיז
rodzik	רודזיק
roeder	רודר
roehler	רולר
roentgenium	רונטגניום
rogen	רוגן
roger	רוג'ר
rogerio	רוגיריו
rogers	רוג'רז
rogge	רוג
roggeveen	רוגיבין
roitman	רויטמאן
roko	רוקו
roland	רולאנד
roleder	רולדר
rolfes	רולפס
rolff	רולף
rolland	רולאנד
rollo	רולו
romain	רומיין
roman	רומאן
romania	רומייניה
romanians	רומייניאנז
romano	רומאנו
romanos	רומאנוס
romarin	רומארין
romario	רומאריו
rome	רום
romeo	רומיו
romer	רומר
romero	רומירו
romi	רומי
romney	רומני
romuald	רומאלד
romulus	רומיולוס
ron	רון
ronald	רונאלד
ronaldinho	רונאלדינהו
ronaldo	רונאלדו
rondonia	רונדוניא
ronen	רונן
roni	רוני
ronit	רונית
ronnie	רוני
ronny	רוני
rony	רוני
rool	רול
room	רום
rooney	רוני
roosevelt	רוזוולט
root	רוט
roraima	רוראימא
rosa	רוזא
rosalind	רוזאלינד
rosario	רוזאריו
rosato	רוזאטו
rose	רוז
roseau	רוסו
rosenbaum	רוזנבאום
rosenberg	רוזנברג
rosenblatt	רוזנבלאט
rosenblum	רוזנבלום
rosenior	רוסיניור
rosetti	רוזיטי
rosh	רוש
rosi	רוסי
rosicky	רוסיקי
rosneft	רוסנפט
ross	רוס
rossana	רוזאנא
rossellini	רוסוליני
rossi	רוסי
rossini	רוסיני
rossum	רוסום
rosti	רוסטי
rostislav	רוסטיסלאב
rostom	רוסטום
rotana	רוטאנא
rotaru	רוטארו
rotblat	רוטבלאט
roth	רות
rothbard	רותבארד
rothlisberger	רותליסבירגר
rothman	רותמאן
rothschild	רותשילד
rotson	רוטסון
rott	רוט
rotterdam	רוטרדאם
rouani	רואני
roudbarian	רודבאריאן
roudhan	רודאן
roudolphe	רודולף
rouissi	רויסי
rourke	רורק
rous	רוס
rousseau	רוסו
rousset	רוסיט
roussos	רוסוס
rouwaida	רואידא
roux	רו
rovaniemi	רובאניאמי
rovinj	רובינג'
rowan	רואן
rowen	רוון
rowland	רולאנד
rowling	רולינג
roxas	רוקסאס
roy	רוי
royal	רויאל
rozehnal	רוזיהנאל
ruben	רובן
rubicon	רוביקון
rubik	רוביק
rubin	רובין
rubinstein	רובינסטין
rubio	רוביו
rudakov	רודאקוב
rudd	רוד
ruddy	רודי
rudi	רודי
rudolf	רודולף
rudolph	רודולף
rudy	רודי
rudyard	רדיארד
ruffalo	רופאלו
rugova	רוגובא
ruhl	רול
rui	רוי
ruislip	רוסליפ
ruiter	רויטר
ruiz	רויז
rulfo	רולפו
rumer	רומר
rumiko	רומיקו
runje	רונג'י
runstrom	ראנסטרום
rupert	רופרט
ruppin	רופין
rusedski	רוסדיסקי
rush	ראש
rushdy	רושדי
rushmore	רשמור
rusk	ראסק
ruslan	רוסלאן
russ	רוס
russell	ראסל
russia	ראשא
russo	רוסו
rustavi	רוסטאבי
rutan	רוטאן
ruth	רות
rutherford	רתרפורד
rutland	רוטלאנד
ruud	רוד
ruutel	רוטל
ruwi	רוי
ruy	רוי
ryan	ראיאן
ryanair	ראיאנר
rybak	ריבאק
ryder	ראידר
ryedale	ראידיל
rykov	ריקוב
rym	רים
ryo	ריו
ryoichi	ריוצ'י
ryoji	ריוגصי
ryokichi	ריוקיצ'י
ryoko	ריוקו
ryoma	ריומא
ryuji	ריוג'י
ryusei	ריוסיי
ryutaro	ריוטארו
saab	סעב
saad	סעד
saadane	סעדאן
saadavi	סאדאבי
saadi	סעדי
saakashvili	סאקאשבילי
saari	סערי
saartjie	סארטג'י
saba	סאבא
sabah	סבאח
saban	סאבאן
sabat	סאבאט
sabatini	סאבאטיני
sabau	סאבאו
sabbatai	שבתאי
sabeer	סאביר
saberi	סאברי
sabin	סאבין
sabina	סאבינא
sabir	סאביר
sabri	סאברי
sabrina	סאברינא
sabur	סאבור
saca	סאקא
sacchi	סאקי
sacramento	סאקראמנטו
sada	סאדא
sadako	סאדאקו
saddam	סדאם
sadegh	סאדק
sadeghi	סאדגי
sadeq	סאדק
sadiq	סאדיק
sadir	סדיר
sadler	סאדלר
sadra	סדרא
saeed	סעיד
saenko	סאינקו
saez	סאיז
safafa	ספאפא
safet	סאפיט
safin	סאפין
safina	סאפינה
safra	ספרא
safran	ספרן
safranek	סאפראניק
safri	ספרי
saganowski	סאגאנווסקי
sagisu	סאגיסו
sagna	סאניא
sagnol	סאניול
sagunto	סאגונטו
saha	סאהא
sahab	סחאב
sahar	סחר
sahashi	סאהאשי
sahel	סאחל
sahin	סאהין
sahnoun	סחנון
sahraoui	סחראוי
said	סעיד
saidou	סאידו
saif	סאיף
saiga	סאיגא
saionji	סאיונג'י
saipan	סאיפאן
saito	סאיטו
saivet	סאיביט
saiwaeo	סאיוואו
sakaguchi	סאקאגוצ'י
sakamoto	סאקאמוטו
sakichi	סאקיצ'י
sakimoto	סאקימוטו
sakurai	סאקוראי
salah	סלאח
salam	סלאם
salama	סלאמה
salamanca	סאלאמאנקא
salandra	סאלאנדרא
salata	סאלאטה
salazar	סאלאזאר
salbutamol	סאלבוטאמול
saldana	סאלדאנא
saleem	סלים
saleh	סאלח
salekhard	סאלכארד
salem	סיילם
salenko	סאלינקו
sales	סיילז
salfit	סלפיט
salford	סאלפורד
salhab	סלהב
sali	סאלי
salibi	סליבי
salih	סאלח
salim	סלים
salinas	סאלאינס
salk	סולק
salloukh	סאלוך
sally	סאלי
salman	סלמאן
salmeen	סאלמין
salomaa	סאלומא
salomon	סאלומון
salpigidis	סאלפיגידיס
salvador	סלבאדור
salvadore	סאלבאדור
salvatore	סאלבאטורי
salviati	סאלביאטי
salzburg	סאלזבורג
salzman	סאלצמאן
sam	סאם
samaha	סמאחה
samantha	סאמאנתא
samaras	סאמאראס
samarkand	סמרקנד
samba	סאמבא
sambusac	סמבוסק
samer	סאמר
sami	סאמי
samih	סמיח
samir	סמיר
samitier	סאמיטייר
sammer	סאמר
samosa	סאמוסא
sampaio	סאמפאיו
sampi	סאמפי
sampras	סאמפראס
sampson	סאמפסון
samson	סאמסון
samsun	סאמסון
samtredia	סאמטרידיא
samuel	סאמואל
samy	סאמי
sanaa	סאנא
sanader	סאנאדר
sanae	סאניי
sanbar	סנבר
sanchez	סאנשיז
sancho	סאנשו
sanders	סאנדרז
sandor	סאנדור
sandoval	סאנדובאל
sandra	סאנדרא
sandrelli	סאנדרילי
sandro	סאנדרו
sandy	סאנדי
sanetomi	סאנטומי
sanger	סאנגר
sanguinetti	סאנגויניטי
sanhedrin	סנהדרין
sani	סאני
sanjo	סאנג'ו
sanli	סאנלי
sanogo	סאנוגו
sanou	סאנו
sansom	סאנסום
santa	סאנטא
santamaria	סאנטאמאריא
santamarina	סאנטאמארינא
santana	סאנטאנא
santangelo	סאנטאנג'לו
sante	סאנטי
santi	סאנטי
santiago	סנטיאגו
santillana	סאנטילאנה
santini	סאנטיני
santo	סאנטו
santon	סאנטון
santorini	סאנטוריני
santoro	סאנטורו
santos	סאנטוס
sanu	סנוע
sanz	סאנז
sao	סאו
saori	סאורי
saphir	ספיר
sapunaru	סאפונארו
saqr	סאקר
sar	סר
sara	סארא
sarabia	סאראביא
sarah	סארה
sarandon	סאראנדון
sarayoot	סאראיוט
sardinia	סרדיניא
saree	סארי
saretta	סאריטא
sargon	סרגון
sarhan	סרחאן
sari	סרי
sarin	סארין
sarinana	סארינאנא
sarioglu	סאריוגלו
sarit	שרית
sark	סארק
sarkis	סארקיס
sarkozy	סארקוזי
sarpei	סארפיי
sarr	סאר
sarraute	סארוט
sarriegi	סאריגי
sarrionandia	סאריונאנדיא
sars	סארס
sarsgaard	סארסגארד
sarsur	סרסור
sartawi	סרטאווי
sarton	סארטון
sartre	סארטר
sarukhan	סארוכאן
sasaki	סאסאקי
sassari	סאסארי
sassi	סאסי
sassoon	סאסון
sato	סאטו
satoru	סאטורו
satoshi	סאטושי
satrapi	סאטראפי
satsuki	סאצוקי
satu	סאטו
saturday	סאטרדיי
satyagraha	סאטיאגראהא
saud	סעוד
saudi	סעודי
sauer	סאוור
saul	סול
saumel	סאומיל
sauvage	סובאג'
saveljic	סאבילייטש
savicevic	סאביצ'ביטש
savio	סאביו
saviola	סאביולא
savo	סאבו
sawa	סאווא
sawashiro	סאואשירו
sawiris	סאויריס
sawt	סאוט
saxony	סאקסוני
sayaka	סאיאקא
sayako	סאיאקו
sayed	סייד
sayyid	סאייד
sbarro	סבארו
sberbank	סבירבנק
scala	סקאלא
scaloni	סקאלוני
scandinavia	סקאנדינאביא
scarlett	סקארליט
scarpa	סקארפא
scatman	סקאטמאן
schaaf	שאף
schachner	שאצ'נר
schacht	שאכט
schafik	שפיק
schally	סקאלי
schami	שאמי
schefer	שפר
scherbius	שירביוס
scherzinger	שירזינגר
scheuring	שוירינג
scheveningen	שיבינינגן
schiavone	שיאבוני
schickard	שיקארד
schiff	שיף
schiffer	שיפר
schindler	שינדלר
schliemann	שלימאן
schlossberg	שלוסברג
schmeichel	שמאיקל
schmid	שמיד
schmidhuber	שמاדהובר
schmidt	שמידט
schmitt	שמיט
schmolck	שמולק
schnabel	שנאבל
schneider	שנאידר
schober	שוביר
scholes	סקולז
scholl	שול
schon	סטשון
schopenhauer	שופנהאור
schrijvers	שריברז
schroder	שרודר
schroeder	שרודר
schrojf	שרויף
schubert	שוברט
schultz	שולטז
schulze	שולצה
schumpeter	שומפיטר
schussel	שוסל
schuster	שוסטר
schutz	שוץ
schwartz	שוארץ
schwartzman	שוארmמן
schwarzenegger	שוארצניגר
schwarzer	שוארצר
schweinsteiger	שבאינשטאיגר
schweitzer	שוייצר
schwimmer	שוימר
scifo	סקיפו
scirea	שיריא
scofield	סקופילד
scola	סקולא
scorsese	סקורסיזי
scot	סקוט
scott	סקוט
scotty	סקוטי
sculli	סקולי
sderot	שדרות
seagal	סיגאל
seale	סיל
seaman	סימאן
seamus	שיימוס
sean	שון
seattle	סיאטל
seb	סב
sebastian	סיבאסטיאן
sebastiano	סיבאסטיאנו
sebastiao	סבאסטיאו
sebastien	סיבאסטיאן
sedarous	סידארוס
sedik	סדיק
sedna	סידנא
sedonoude	סידונודי
seedorf	סידורף
seehawong	סיהאוונג
seeldrayers	סילדראירס
seeler	סילר
sefer	ספר
seferis	ספריס
sefrioui	ספריוי
sega	סגא
segal	סיגאל
segev	סגב
segway	סגוויי
seidath	סיידאת
seif	סיף
seifert	סיפירט
seiichiro	סייצ'ירו
seiji	סייג'י
seinfeld	סיינפילד
seitaridis	סיטארידיס
sejdiu	סידיו
seki	סקי
seko	סיקו
seksan	סאקסאן
sektioui	סקטיוי
sekularac	סיקולאראק
sela	סילא
selassie	סילאסי
selemani	סלימאני
selena	סילינא
selene	סילין
seles	סיליש
selkirk	סילקירק
selma	סלמא
selten	סלטן
selway	סילויי
seman	סימאן
semih	סמיח
semmeling	סמילינג
semshov	סימשוב
semyonov	סימיונוב
sen	סן
senac	סינאק
senaki	סינאקי
senamuang	סינאמואנג
senderos	סינדירוס
sendhil	סנדהיל
senjuro	סינג'ורו
sennett	סיניט
senturk	סנטורק
seoul	סיאול
seppi	סיפי
serafin	סראפין
serao	סיראו
serena	סירינא
serge	סירג'
sergei	סירגיי
sergey	סירגיי
serginho	סירגינהו
sergio	סרג'יו
seri	סרי
serine	סירין
serj	סירג'
serotonin	סירוטונין
serpentinite	סרפנטינאיט
serra	סירא
sertic	סירטיטש
server	סירבר
servet	סרוויט
servetus	סירביטוס
serzh	סירז'
sese	סיסי
sesto	ססטו
sesumaga	סיסומאגא
seth	סית
sethrida	סתרידא
setsubun	סיטסובון
severino	סיבירינו
severo	סיבירו
severus	סיבירוס
seville	סיביל
sexton	סקסטון
seymour	סימור
sezen	סיזין
sfar	ספאר
sfax	ספאקס
sforza	ספורזא
sfumato	ספומאטו
shaaban	שעבאן
shaarawi	שעראוי
shabab	שבאב
shabani	שאבאני
shabazi	שבזי
shady	שאדי
shafik	שפיק
shafiq	שפיק
shagari	שאגארי
shah	שאה
shahab	שהאב
shahak	שחק
shahd	שאד
shaheen	שאהין
shahid	שהיד
shahnameh	שאהנאמה
shai	שי
shailene	שיילין
shaka	שאקא
shaked	שקד
shakespeare	שקספיר
shakib	שאקיב
shakira	שאקירא
shalala	שלאלא
shalhoub	שלהוב
shalit	שליט
shalmaneser	שלמנסר
shaltut	שלטוט
shamekh	שאמך
shamil	שאמיל
shamir	שמיר
shamkhani	שאמכאני
shamlou	שאמלו
shamma	שמה
shammas	שמאס
shams	שאמס
shamsul	שמסול
shan	שאן
shandong	שאנדונג
shane	שיין
shania	שאניא
shankar	שאנקאר
shannon	שאנון
shaobo	שאובו
shapour	שאפור
shaquille	שאקיל
sharansky	שאראנסקי
sharbat	שרבאט
sharett	שאריט
shariati	שריעטי
sharir	שריר
sharma	שארמא
sharon	שרון
sharpe	שארפ
shasta	שאסטא
shatili	שאטילי
shatskikh	שאצקיך
shaukat	שאוקאט
shaul	שאול
shaun	שון
shaw	שו
shawarma	שאורמא
shawkat	שאוקאט
shawki	שאוקי
shawky	שוקי
shawn	שון
shawqat	שוקט
shawqi	שאוקי
shay	שי
shayne	שיין
shays	שייז
shearim	שיארים
sheba	שיבא
sheen	שין
sheetrit	שטרית
shefer	שפר
sheffield	שיפילד
shehab	שהאב
shehu	שהו
shelby	שילבי
sheldon	שילדון
shelley	שלי
shelly	שלי
shelton	שילטן
shengelia	שינגיליא
shepard	שיפארד
shepherd	שיפארד
sheraton	שראטון
sheridan	שירידאן
sherihan	שריהאן
sheringham	שירנגהאם
sherlock	שרלוק
sherman	שרמאן
sherwood	שרווד
sheryl	שיריל
shevardnadze	שיברדנאדזה
shevchenko	שבצ'נקו
shi	שי
shiba	שיבא
shibam	שיבאם
shibata	שיבאטא
shidehara	שידיהארא
shield	שילד
shiff	שיף
shigeru	שיגירו
shigeyoshi	שיגיושי
shih	שיה
shikabala	שיקאבאלא
shikibu	שיקיבו
shikma	שיקמא
shilla	שילא
shiller	שילר
shilpa	שילפא
shilton	שילטון
shimla	שימלא
shimomura	שימומורא
shimshon	שמשון
shin	שין
shinawatra	שינאואטרא
shiningayamwe	שינינגאיאמוי
shinji	שינג'י
shinkansen	שינקאנסן
shinkichi	שינקיצ'י
shinoda	שינודה
shinrikyo	שינריקיו
shinzo	שינזו
shiozawa	שיוזאוא
shipman	שיפמאן
shirai	שיראי
shiri	שירי
shirin	שירין
shirley	שירלי
shiro	שירו
shishakli	שישאקלי
shittu	שיטו
shiva	שיבא
shklovsky	שקלובסקי
shkoder	שקודר
shlaim	שלאים
shlomi	שלומי
shlomo	שלמה
shmona	שמונה
shmuel	שמואל
sho	שו
shoaib	שועיב
shobair	שובייר
shockley	שוקלי
shojaei	שוג'אעי
shola	שולא
sholes	שולז
shomu	שומו
shorey	שורי
shosh	שוש
shoshana	שושנה
shotokan	שוטוקאן
shouaa	שועאע
shoukry	שוקרי
shoval	שובל
showtaro	שוטארו
shraga	שרגא
shrek	שרק
shriki	שריקי
shroot	שרוט
shui	שוי
shuichi	שויטשי
shukeiri	שוקיירי
shulamit	שולמית
shumei	שומיי
shunsuke	שונסוקי
shusaku	שוסאקו
shustikov	שוסטיקוב
shuttleworth	שאטלוורת
shwery	שוירי
si	סאי
sibenik	סיביניק
sibiu	סיביו
sibusiso	סיבוסיסו
sid	סיד
siddig	סידיג
siddiq	סדיק
sidhom	סידהום
sidi	סידי
sidibe	סידיבי
sidney	סידני
sidon	סידון
sidorenko	סאידורניקו
sidqi	סידקי
sidwell	סידויל
sie	סי
siegfried	סיגפריד
sienkiewicz	סינקיביטש
sienna	סיאנא
sifi	סיפי
sigourney	סיגורני
sigrid	סיגריד
siguroardottir	סיגורורדוטיר
sihanouk	סיהאנוק
siirt	סירט
silicone	סיליקון
silkwood	סילקווד
silva	סילבא
silverstein	סילברסטאין
silverstone	סילברסטון
silvester	סילבסטר
silvestre	סילביסטר
silviu	סילביו
silwan	סילואן
sima	סימא
simas	סימאס
simbi	סימבי
simeon	סימיאן
simeone	סימיוני
simferopol	סימפירופול
simic	סימיטש
simin	סימין
simoes	סימוז
simon	סאימון
simone	סימון
simonetta	סימוניטא
simonov	סימונוב
simons	סימונז
simovic	סימוביטש
simple	סימפל
simpson	סימפסון
simpsons	סימפסונז
simukonda	סימוקונדא
simunic	סימוניטש
sinai	סאינאי
sinan	סינאן
sinclair	סינקלייר
singh	סינג
sinibaldi	סיניבאלדי
siniora	סניורה
sinn	סין
sionko	סיונקו
siphandon	סיפאנדון
sipos	סיפוס
sira	סירה
sirous	סירוס
sisley	סיסלי
sissoko	סיסוקו
sisto	סיסטו
sisyphus	סיזיפוס
siti	סיטי
sitting	סיטינג
siviglia	סיביליא
sivori	סיבורי
six	סיקס
siyabonga	סייאבונגא
sizemore	סאיזמור
sjaak	סיאק
skacel	סקאסל
skah	סקאח
skalski	סקאלסקי
skarmeta	סקארמיטא
skiles	סקאילז
skoblar	סקובלאר
skopje	סקופיי
skorzeny	סקורזיני
slava	סלאבא
slaven	סלאבין
slavisa	סלאביסא
slavko	סלאבקו
slim	סלים
slimane	סלימאן
sljivo	סליבו
sloan	סלון
slobodan	סלובודאן
slovak	סלובאק
slovenia	סלוביניא
sluiter	סלויטר
smalley	סמולי
smashnova	סמאשנובא
smertin	סמירטין
smetana	סמיטנא
smicer	סמאיסר
smiljanic	סמיליאניטש
smithies	סמיתיז
smits	סמיטס
smolarek	סמולאריק
smolensk	סמולינסק
smolnikov	סמולניקוב
smoot	סמוט
smush	סמאש
sneh	סנה
snir	סניר
snoop	סנופ
snorri	סנורי
snyder	סנאידר
so	סו
socha	סוכא
soddy	סודי
soderberg	סודרבירג
soderbergh	סודרבירג
soderling	סודרלינג
sodium	סודיום
sofer	סופר
sofia	סופיא
sofyan	סופיאן
sohrab	סוהראב
soichiro	סויצ'ירו
sojourner	סוג'ורנר
sokho	סוכו
sokolov	סוקולוב
sokolow	סוקולוב
sol	סול
solana	סולאנא
solano	סולאנו
solari	סולארי
solaris	סולאריס
soldado	סולדאדו
soler	סולר
soleri	סולירי
solhi	סולחי
solodkin	סולודקין
solomin	סולומין
solomon	סולומון
solow	סולו
soltani	סולטאני
solymosi	סולימוסי
som	סום
soma	סומא
somalia	סומאליה
somekh	סומך
somerhalder	סומרהאלדר
sommeil	סומיל
sondergaard	סונדרגארד
song	סונג
songul	סונגול
sonny	סוני
sonu	סונו
sony	סוני
sophia	סופיא
sophocles	סופוקליז
sophus	סופוס
soraia	סוראיא
sorbonne	סורבון
soren	סורין
sorensen	סורינסן
sorin	סורין
sorman	סורמאן
soros	סורוס
sorrentino	סורנטינו
sorrento	סורינטו
soskic	סוסקיטש
sosuke	סוסוקה
sotirios	סוטיריוס
sotiris	סוטיריס
souad	סועאד
souayah	סויאח
soufiane	סופיאן
souk	סוק
souleymane	סולימאן
souleymanou	סוליימאנו
soumbeila	סומביילא
souness	סוניס
sousa	סוזא
southampton	סאותהאמפטון
souza	סוזא
sowe	סו
soweto	סויטו
sox	סוקס
soyer	סויר
soyinka	סוינקא
spacek	ספייסק
spacey	ספייסי
spain	ספיין
spallanzani	ספאלאנזאני
spalletti	ספאליטי
spam	ספאם
spanic	ספאניק
spanish	ספאניש
sparta	ספארטא
spector	ספקטור
speed	ספיד
speer	ספיר
speirs	ספירז
spelling	ספילינג
spen	ספין
spence	ספינס
spencer	ספנסר
sperl	ספארל
sperone	ספירוני
spetsnaz	ספיטסנאז
spiegel	ספיגל
spiegler	ספיגלר
spike	ספאיק
spina	ספינא
spinoza	ספינוזא
spiropoulos	ספירופולוס
spiros	ספירוס
spitzer	ספיצר
sprem	ספרים
springer	ספרינגר
sprinzak	שפרינצק
sputnik	ספוטניק
spycher	ספאיקר
spyri	שפירי
spyridon	ספירידון
squillaci	סקוילאצ'י
srecko	סריצ'קו
srichaphan	סראישאפאן
srinagar	סרינאגאר
sriti	סריטי
srna	סרנא
srpska	סרפסקא
srur	סרור
stacy	סטייסי
stade	סטאד
stahl	סטאל
stalling	סטאלינג
stallone	סטאלון
stalteri	סטאלטירי
stam	סטאם
stambachr	סטאמבאכר
stamile	סטאמאיל
stan	סטאן
stancioiu	סטאנקיו
standfest	סטאנדפיסט
stanishev	סטאנישב
stanislas	סטאנסילאס
stanislav	סטאניסלאב
stanislaw	סטאניסלו
stankovic	סטאנקוביטש
stanley	סטאנלי
stanmore	סטאנמור
stanton	סטאנטון
stapleton	סטייפלטון
starace	סטאראסי
starbucks	סטארבאקס
starck	סטארק
stari	סטארי
stark	סטארק
starkovs	סטראקובס
starr	סטאר
stasi	סטאזי
state	סטייט
staten	סטאטן
statham	סטאתאם
staudinger	שטאודינגר
staunton	סטונטון
stavanger	סטאבאנג'ר
steel	סטיל
steele	סטיל
stefan	סטיפאן
stefanescu	סטיפאניסקו
stefano	סטיפאנו
stefanson	סטפאנסון
steffen	סטיפן
steffi	שטיפי
stefka	סטיפקא
steinbeck	סטיינבק
steiner	סטיاנר
steinitz	סטייניץ
steinmeier	שטאינמאיר
stekelenburg	סטיקלנבירג
stelios	סטיליוס
stella	סטילא
stelmach	סטילמאטש
stendardo	סטינדארדו
stepan	סטיפאן
stepanakert	סטיפאנאקירט
stepanek	סטיפאניק
stephan	סטיפאן
stephane	סטיפאן
stephanie	סטיפאני
stephanopoulos	סטיפאנופולוס
stephen	סטיפן
stephens	סטיפנס
stephenson	סטיפנסן
stephon	סטיפן
sterjovski	סטריובסקי
stern	סטירן
steve	סטיב
steven	סטיבן
stevens	סטיבנס
stevenson	סטיבנסון
stevie	סטיבי
steyr	סטייר
stielike	סטיליקה
stievenard	סטיבינארד
stif	סטיף
stifter	סטיפטר
stiliyan	סטיליאן
still	סטיל
stiller	סטילר
stipe	סטיפ
stirling	סטירלינג
stjepan	סטיפאן
stoch	סטוטש
stockholm	סטוקהולם
stoichita	סטויקיטא
stoichkov	סטויצ'קוב
stojkovic	סטויקוביטש
stoker	סטוקר
stokes	סטוקס
stoltenberg	סטולטנברג
stoltz	סטולץ
stone	סטון
stoor	סטור
stoppard	סטופארד
storari	סטורארי
stowe	סטו
strack	סטראק
stradivarius	סטראדיבאריוס
strait	סטרייט
stranzl	סטראנזל
strasser	סטראסיר
stratford	סטראטפורד
strauss	סטראוס
stravinsky	סטראבינסקי
straw	סטרו
streep	סטריפ
streisand	סטראיסאנד
stresemann	סטריסמאן
strittmatter	סטריטמאטר
stroessner	סטרוסנר
strontium	סטרונטיום
stroustrup	סטרוסטרופ
stuart	סטיוארט
stubbs	סטאבס
student	סטודנט
stupar	סטופאר
sturluson	סטרלסון
sturridge	סטוריג'
sturt	סטורט
stylites	סטאילאיטס
su	סו
suan	סואן
suarez	סואריז
suazo	סואזו
subait	סוביט
subaru	סובארו
suchoparek	סוצ'ופאריק
sucralose	סוקרלוס
sucre	סוקר
sudan	סודאן
sudarsono	סודארסונו
sudbury	סודברי
sudoku	סודוקו
sufyan	סופיאן
sugihara	סוגיהארא
sugita	סוגיטא
sugiyama	סוגייאמא
suha	סוחה
suharto	סוהארטו
suiko	סויקו
suker	סוקר
sukha	סוכא
sukhoi	סוכוי
sukristov	סוקריסטוב
suksomkit	סוקסומקיט
sukur	סוקור
sul	סול
sulaiman	סוליימן
sulakvelidze	סולאקבלידזה
suleiman	סוליימאן
sulejman	סוליימאן
suleyman	סוליימאן
sulim	סולים
suliman	סולימאן
sultan	סולטאן
sumatra	סומטרה
sumer	סומר
summer	סאמר
summerbee	סאמרבי
summers	סאמרז
sumner	סאמנר
sumter	סומטר
sun	סון
sundell	סאנדל
sunil	סוניל
sur	סור
suraski	סוראסקי
suree	סורי
surgut	סורגוט
suriname	סורינאם
surjak	סוריאק
surprise	סירפראיס
surtees	סורטיס
susak	סוסאק
susan	סוזאן
sushi	סושי
susic	סוסיטש
susilo	סוסילו
suskind	סוסקינד
sussmuth	סוסמות
susumu	סוסומו
sutee	סוטי
sutton	סוטון
suu	סו
suurbier	סורבייר
suvari	סובארי
suvrijn	סוברין
suwan	סואן
suweid	סוייד
suzanne	סוזאן
suzuki	סוזוקי
sven	סוון
svensson	סוינסון
sverkos	סבירקוס
sverre	סוירי
svetoslav	סביטוסלאב
sviatoslav	סביאטוסלאב
swaile	סוייל
swank	סואנק
swayze	סוייזי
swaziland	סואזילאנד
sweid	סויד
swindin	סוינדן
swinton	סוינטון
switzerland	סויצרלאנד
syagrius	סיאגריוס
syamsul	סיאמסול
sybille	סיביל
sychev	סיטשב
sydney	סידני
syed	סייד
syktyvkar	סיקטיבקאר
sylla	סילא
sylva	סילבא
sylvain	סילביין
sylvia	סילביא
sylvinho	סילביניו
sylvite	סילביט
syngman	סינגמאן
szarmach	זארמאך
szavay	סאבאי
szeged	זיגיד
szentmihalyi	סזינטמיהאלי
szoke	סזוק
szulik	סזוליק
szymborska	שימבורסקא
t	ט
taarabt	טאראבט
tabarez	טאבארז
tabari	טברי
tabi	טאבי
taborda	טאבורדא
tabucchi	טאבוקי
tacconi	טאקוני
tachiki	טאטשיקי
tadao	טאדאו
taddei	טאדיי
tadeus	טדיוס
tadiran	טאדיראן
tadmor	טדמור
tafer	טאפר
taffarel	טאפאריל
taft	טאפט
taga	טאגא
tagoe	טאגו
tagore	טאגור
taha	טאהא
taher	טאהר
taheyya	טחיה
tahir	טאהיר
tahiti	טאהיטי
taim	טאים
taimanov	טאימאנוב
tainio	טאיניו
taipei	טאיפיי
taisho	טאישו
taisir	טאיסיר
taiwo	טאיוו
tajalli	טג'לי
tajikistan	טאג'יקסטאן
tajura	טאג'ורא
takaaki	תקאקי
takagaki	טאקאגאקי
takagi	טאקאגי
takahara	טאקאהארא
takahashi	טאקאהאשי
takahiro	טאקאהירו
takamori	טאקאמורי
takano	טאקאנו
takanohana	טאקאנוהאנא
takanori	טאקאנורי
takashi	טאקאשי
takatoki	טאקאטוקי
takayama	טאקאיאמא
takayoshi	טאקאיושי
takayuki	טאקאיוקי
takeda	טאקידא
takeo	טאקיו
takeshi	טאקישי
takeuchi	טאקיוצ'י
takfiri	טקפיריה
takis	טאקיס
taksim	טקסים
takumi	טאקומי
takuya	טאקויא
tal	טאל
talabani	טאלבאני
talal	טלאל
talebloo	טאלבלו
talfah	טלפאח
tali	טלי
talib	טאלב
taliban	טאליבאן
talley	טאלי
tallinn	טאלין
talmud	תלמוד
talpiot	תלפיות
tamada	טאמאדא
tamagnini	טאמאגניני
tamar	תמר
tamas	טמאס
tambal	טמבל
tamblyn	טאמבלין
tamboura	טאמבורא
tamer	טאמר
tamil	טאמיל
tamim	תמים
tammet	טאמיט
tamoxifen	טאמוקסיפין
tampa	טאמפא
tampere	טאמפירי
tamra	טאמרא
tanaka	טאנאקא
tanasuwan	טאנאסוואן
tancredo	טאנקרידו
tandon	טאנדון
tanganyika	טנגאניקא
tange	טאנג'ה
tanit	טאניט
tanizaki	טאניזאקי
tanju	טאנג'ו
tankian	טאנקיאן
tannenbaum	טאננבאום
tanta	טנטא
tanya	טאניא
tanzan	טאנזאן
tanzania	טנזאניא
tao	טאו
tara	טארא
tarak	טאראק
taraneh	טראנה
tarantino	טאראנטינו
taranto	טאראנטו
tarawa	טאראוא
tarcisio	טארשיזיו
tare	טארי
tarek	טארק
tareq	טארק
tarif	טריף
tarik	טאריק
tarin	טארין
tariq	טאריק
tarja	טאריא
tarkan	טארקאן
tarlev	טארליב
taro	טארו
tartarus	טארטארוס
tartu	טארטו
tartus	טרטוס
taryn	טארין
tarzan	טרזאן
tashiro	טאשירו
tasmania	טאזמייניא
tassadit	טסעדיט
tassos	טאסוס
tassotti	טאסוטי
tatarstan	טאטארסטאן
tate	טייט
tati	טאטי
tatlin	טאטלין
tatsukichi	טאטסוקיצ'י
tatyana	טאטיאנא
taub	טאוב
taube	טאוב
tauno	טאונו
taut	טאוט
tautou	טאטו
tauziat	טוזיא
tavares	טאבאריס
tawil	טוויל
taye	טאי
tayeb	טייב
taylor	טיילור
tayma	טאימא
tayseer	טאיסיר
tchami	טשאמי
tchangai	טצ'אנגאי
tchato	טשאטו
tchomogo	טשומוגו
tddaiji	טדאיג'י
ted	טד
tedd	טיד
teddy	טדי
teemu	טימו
teerasil	טיראסיל
teerathep	טיראתפ
tefilo	טפילו
tegucigalpa	טיגוסיגאלפא
tehran	טהראן
teimuraz	טאימוראז
tekle	טקלה
teko	טיקו
telemann	טילימאן
temime	טמים
temmu	טמו
temotu	טימוטו
tempelhof	טמפלהוף
tenco	טינקו
tenerife	טנריף
teng	טנג
tengiz	טינגיז
tenji	טינג'י
tennant	טינאנט
tenorio	טינוריו
tenzing	טינסינג
teofilo	טיופילו
teotihuacan	טיוטיהואקאן
terasoma	טיראסומא
terauchi	טיראוצ'י
terence	טירינס
teresa	טיריזא
tereshkova	טרשקובא
teresina	טיריסינא
tereza	טיריזא
terim	טירים
terme	טירמי
terrence	טירינס
terry	טירי
tertullian	טרטליאן
terzanidis	טירזאנידיס
tessho	טישו
tetsu	טטסו
teugels	טיגילס
tevez	טיביז
tex	טיקס
teymourian	טיימוריאן
thabet	תאבט
thabit	תאבט
thai	טאי
thaksin	תאקסין
thalassemia	תלאסימיא
thaler	טאלר
thalia	תאליא
thalmann	תאלמאן
thani	תאני
thant	תאנט
thatta	תאטא
the	תא
theerawesin	תיראווסין
theiler	טילר
thembinkosi	תימבנקוסי
theo	תיו
theodor	תיאודור
theodora	תיודורא
theodorakis	תיודוראקיס
theodoric	תיודוריק
theodosius	תיודוסיוס
theofanis	תיופאניס
theorell	טיורל
theravada	תיראבאדא
therdsak	תרדסאק
theropoda	תירופודא
theseus	תיסיוס
thessaloniki	תיסאלוניקי
theuriau	טוריו
thiago	תיאגו
thiering	תירינג
thierry	טיירי
thijssen	תיסין
thissen	תיסן
thom	טום
thomas	טומאס
thompson	טומסון
thomson	טומסון
thon	תון
thonglao	תונגלאו
thor	תור
thoreau	תורו
thornton	תורנטון
thorst	תורסט
thousand	תוסנד
thrace	תרייס
threonine	תריונין
thucydides	תוקידידיז
thuram	טוראם
thurman	תורמאן
thutmose	טחוטמוס
thwaite	תואיט
thymine	תאימין
thys	תיס
tiago	טיאגו
tiasse	טיאסי
tibbets	טביטס
tiberias	טאיביריאס
tiberius	טאיביריאס
tibet	טיבט
tibi	טיבי
tibor	טיבור
ticleanu	טיקליאנו
tico	טיקו
tie	טאי
tiempo	טיימפו
tierney	טירני
tiersen	טירסן
tigana	טיגאנא
tiger	טאיגר
tijani	טיג'אני
tikopia	טיקופיא
tikrit	טיקריט
tikva	תקוה
tilda	טילדא
tillman	טילמאן
tilman	טילמאן
tim	טים
timbaland	טמבלנד
timberlake	טימברלייק
timbuktu	טימבקטו
timisoara	טימישוארא
timlin	טימלין
timmy	טימי
timo	טימו
timor	טימור
timorim	טימורים
timoshenko	טימושינקו
timothee	טימותי
timothy	טימותי
timur	טימור
tina	טינא
ting	טינג
tinian	טיניאן
tir	טיר
tirana	טיראנא
tiraspol	טיראספול
tirnanic	טירנאניטש
tisdale	טיסדייל
tiselius	טיסיליוס
titano	טיטאנו
tite	טאיט
titicaca	טיטיקאקא
tito	טיטו
titov	טיטוב
titta	טיטא
titus	טאיטוס
tiverton	טיבירטון
tivoli	טיבולי
tlass	טלאס
tobey	טובי
tobias	טובאיאס
tobin	טובין
tobita	טוביטא
todd	טוד
todenhofer	טודנהופר
todor	טודור
todorov	טודורוב
toffler	טופלר
togashi	טוגאשי
togo	טוגו
tohir	טוהיר
tojo	טוג'ו
tokelau	טוקילאו
tokimune	טוקימונה
tokio	טוקיו
tokugawa	טוקוגאוא
tokyo	טוקיו
toldo	טולדו
toledo	טולידו
tolga	טולגא
tolstoy	טולסטוי
tom	טום
tomas	טומאס
tomasi	טומאסי
tomaso	טומאסו
tomasz	טומאס
tomiko	טומיקו
tomislav	טומסלאב
tommaso	טומאסו
tommot	טומוט
tommy	טומי
tomohiro	טומוהירו
tomokazu	טומוקאזו
tomoko	טומוקו
tomoyuki	טומויוקי
tonegawa	טוניגאוא
tonetto	טוניטו
tong	טונג
toni	טוני
tonton	טונטון
tonu	טונו
tony	טוני
toomey	טומי
topal	טופאל
topher	טופר
topi	טופי
topolanek	טופולאניק
torah	תורה
torben	טורבין
torbinski	טורבינסקי
tori	טורי
toriumi	טוריומי
toriyama	טוריאמא
tork	טורק
tornatore	טורנאטורי
toro	טורו
toronto	טורונטו
torosidis	טורוסידיס
torquato	טורקואטו
torre	טורי
torres	טוריס
torsten	טורסטן
tortola	טורטולא
tortosa	טורטוסא
tosh	טוש
toshack	טושאק
toshiba	טושיבא
toshihide	טושיהידה
toshihiko	טושיהיקו
toshiki	טושיקי
toshimichi	טושימיטשי
toshio	טושיו
toshiro	טושירו
toshiyuki	טושיוקי
tosic	טוסיטש
total	טוטאל
totma	טוטמא
toto	טוטו
totoro	טוטורו
totti	טוטי
toufic	טופיק
toujan	טוג'אן
toulalan	טולאלאן
toulouse	טולוז
toumani	טומאני
tounsi	טונסי
touqan	טוקאן
tourani	טוראני
toure	טורה
touro	טורו
tov	טוב
toyoda	טויודא
toyota	טויוטא
toyotomi	טויוטומי
trabelsi	טראבלסי
trabzon	טראבזון
tracy	טרייסי
trafalgar	טראפאלגאר
traian	טראיאן
traianos	טראיאנוס
trail	טרייל
traill	טרייל
tram	טראם
tranquillo	טראנקוילו
transat	טראנסאט
transkei	טראנסקיי
transnistria	טראנסניסטריא
transylvania	טראנסילוואניא
traore	טראורי
traoui	טראוי
trapani	טראפאני
trapattoni	טראפאטוני
trasch	טראש
travers	טראברז
travian	טראביאן
travis	טראביס
treg	טריג
trejo	טריג'ו
trek	טריק
tremoulinas	טרימולינאס
trentino	טרינטינו
trenton	טרינטון
treviso	טריביסו
trevor	טריבור
trezeguet	טריזיגה
trice	טראיס
trier	טריר
trieste	טריסט
trimurti	טרימורטי
trinidad	טרינידאד
triple	טריפל
tripoli	טריפולי
tristan	טריסטאן
tristram	טריסטראם
trivic	טריביטש
trnava	טרנאבא
trochowski	טרוקווסקי
troels	טרולז
troisi	טרויסי
trondheim	טרונדהאים
troost	טרוסט
troshkin	טרושקן
trossero	טרוסירו
trotsky	טרוטסקי
troussier	טרוסיה
troy	טרוי
trujillo	טרוג'ילו
trulli	טרולי
truman	טרומאן
truth	טרות
trygve	טריגבי
tsabet	טסאבט
tsarev	טסאריב
tschumi	צ'ומי
tsepo	ציפו
tserkva	טסירקבא
tshabalala	צ'אבאלאלא
tskhinvali	טסכינבאלי
tsuji	צוג'י
tsunayoshi	טסונאיושי
tsunenaga	צונינאגא
tsutomu	טסוטומו
tsuyoshi	טסויושי
tsymbalar	צימבאלאר
tuapse	טואפסי
tubman	טובמאן
tucci	טוצ'י
tudor	טודור
tudyk	טודיק
tueni	טויני
tufts	טאפטס
tugay	טוגאי
tugce	טוג'י
tugendhat	טוגנדהאט
tukar	טוקאר
tullamore	טולאמור
tullio	טוליו
tumart	טומארט
tumelo	טומילו
tumer	טומר
tuncay	טונקיי
tunis	טוניס
tunisia	טוניסיה
tunney	טוני
tuo	טו
turan	טוראן
turandot	טוראנדוט
turbo	טורבו
turgut	טורגוט
turk	טורק
turki	טורקי
turkish	טורקיש
turkmani	טורקמאני
turkmenistan	טורקמנסיטאן
turlough	טורלו
turnbull	טרנבול
turner	טירנר
turnham	טורנהאם
tursunov	טורסנוב
turteltaub	טירטלטאוב
turunen	טורונין
tushino	טושינו
tusseau	טוסו
tuva	טובא
tuvalu	טובאלו
tuz	טוז
tver	טביר
twain	טויין
twal	טואל
tycho	טיכו
tylenol	טאילינול
tyler	טאילר
tymoschuk	טימושוק
tymoshenko	טימושינקו
tynan	טינאן
tyrol	טירול
tyrosine	טירוסין
tyson	טאיסון
tyumen	טיומין
tziolis	ציוליס
tzipi	ציפי
tzonis	טזוניס
tzorvas	צורוואס
tzrifin	צריפין
tzu	טזו
tzur	צור
tzvetan	צביטאן
ubayy	אובאי
uchida	אוצ'ידא
uganda	אוגאנדא
ugyen	יוגיין
uhrlau	אוהרלאו
ujfalusi	אויפאלוסי
uk	אוק
ulihrach	יוליהראטש
ullman	אולמאן
umar	עומר
umaru	עמארו
umbria	אומבריא
umm	אום
unesco	יוניסקו
unilever	יוניליבר
unit	יוניט
unix	יוניקס
upchurch	אפצ'ירצ'
upton	אפטון
uranus	אוראנוס
urey	יורי
urwah	עורוה
ustase	יוסטאס
ustinov	יוסטינוב
utada	אוטאדא
utah	יוטה
uthman	עותמאן
uyghur	ויגור
uzbekistan	אוזבקיסטאן
uzeyir	עוזייר
vaart	וארט
vaclav	ואצלאב
vadim	ואדים
vagiz	ואגיז
vahid	וחיד
vahidin	ואהידין
vai	ואי
val	ואל
valcareggi	ואלקארידג'י
valdano	ואלדאנו
valdas	ואלדאס
valdeir	ואלדייר
valderrama	ואלדיראמא
valdes	ואלדז
valdez	ואלדיז
valdis	ואלדיס
valdivia	ואלדיביא
vale	וייל
valencia	ואלנסיא
valens	ואלנס
valente	ואלנטי
valentia	ואלינטיא
valentin	عאלנטין
valentina	באלנטינא
valentine	ואלנטין
valentino	ואלנטינו
valera	באלירא
valeri	ואלירי
valerio	ואליריו
valeriy	ואלירי
valern	ואלירון
valery	וואלרי
valke	ואלק
valkyrie	ואלקירי
valladares	ואלאדאריס
valletta	ואליטא
valli	ואלי
valon	ואלון
vanaheimr	ואנאהימר
vance	ואנס
vancouver	ואנקובר
vandendaele	ואנדנדייל
vanderlei	ואנדרלי
vanessa	ואניסא
vanga	ואנגא
vanhanen	ואנהאנין
vanoni	ואנוני
vantaa	ואנטא
vanunu	וענונו
varallo	ואראיו
varga	וארגא
vargas	וארגאס
varlam	וארלאם
varnhagen	וארנהאגן
vartan	וארטאן
vasarely	ואסארלי
vasari	ואסארי
vasco	ואסקו
vashti	ושתי
vasile	ואסילי
vasili	عאסילי
vasilis	ואסיליס
vasily	ואסילי
vassaras	ואסאראס
vassell	ואסיל
vassily	ואסילי
vasyl	ואסיל
vautrot	ואוטרוט
vava	ואוא
vaz	ואז
vaziri	וזירי
vecchio	ויקצ'יו
vedran	ודראן
veii	ויי
veissiere	ויסייר
veissire	וייסיר
vejic	ויג'יטש
vela	וילא
velasquez	וילאסקיז
velazquez	וילאזקיז
veliko	וליקו
velimir	ולימיר
veloso	ולוסו
velzquez	ולאזקיז
venetiaan	ויניטיאן
veneto	וניטו
venezia	ויניזיא
venezuela	ונזוילא
venglos	וונגלוס
venice	וניס
venizelos	וניזילוס
venkov	ונקוב
venter	וינטר
ventimiglia	וינטמיליא
venturi	וינטורי
venus	וינוס
vera	וירא
vercingetorix	ורסינגיטוריקס
vercoutre	ורקוטר
verdasco	ורדאסקו
verde	ורדי
vered	ורד
verheyen	וירהיין
verilog	וירילוג
verkerk	וירקירק
verkhoyansk	וירכויאנסק
verlaine	ורלן
vermaelen	ורמיילן
vermeer	ורמיר
vermelhinho	ורמילהינו
vermont	ורמונט
vern	וירן
verne	וירן
verner	ורנר
vernon	ורנון
veron	וירון
verona	וירונא
veronicas	ורוניקאז
veselin	וסילין
veselinovic	ויסילינוביטש
vesely	ויסלי
vesey	ויסי
vesnin	וסנין
veyron	ויירון
viacheslav	ויאשיסלאב
viacom	ויאקום
viale	ויאלי
vialli	ויאלי
viana	ויאנא
viani	ויאני
vic	ויק
vicelich	ויסליטש
vicente	ויסנטה
vicki	ויקי
vicky	ויקי
victor	ויקטור
victoria	ויקטוריא
victoriano	ויקטוריאנו
vidal	וידאל
vidic	בידיטש
vidinic	וידיניטש
vieira	ויירא
vienna	ויינא
vieri	ויירי
vierne	וירן
viet	וייט
vietnam	וייטנאם
view	ויו
viggo	ויגו
vijay	ויג'יי
viking	ואיקינג
vikram	ויקראם
viktor	ויקטור
vila	וילא
viliam	ויליאם
viljo	ויליו
villa	וילא
villarreal	וילאריאל
villegas	ויליגאס
villette	ויליט
vilnai	וילנאי
vilnius	וילניוס
vince	וינס
vincent	וינסנט
vincente	וינסינט
vincenzo	וינצ'ינזו
vingada	וינגאדא
vink	וינק
vinson	וינסון
vioarsson	ויוארסון
viola	ויולא
violeau	ויולו
viorel	ויוריל
virgil	וירגיל
virginia	וירג'יניא
virginie	וירג'יני
visconti	ויסקונטי
vishneva	וישניבא
vishnu	וישנו
visitor	ויסיטור
vistula	ויסטולא
viswanathan	ויסואנאתאן
vitali	ויטאלי
vitalis	ויטאליס
vitaliy	ויטאלי
vitaly	ויטאלי
vito	ויטו
vitor	ויטור
vitruvius	ויטרוביוס
viv	ויו
vivaldi	ויואלדי
vivien	ויויאן
vivo	ביבו
vizek	ויזיק
vlada	וולאדא
vladic	ולאדיטש
vladica	ולאדיקא
vladikavkaz	ולאדיקאבקאז
vladimir	ולאדימיר
vlado	ולאדו
vlaovic	וולאוויטש
vlasic	ולאסיטש
vlasov	ולאסוב
vlastimil	ולאסטימיל
vlcek	ולצ'ק
vliegen	וליגן
vltava	ולטאבא
vogel	בוגל
vogts	ווגטס
voight	בויט
vojacek	בויאצ'ק
vojislav	וויסלאב
vojta	בויטא
vojtech	בויטיטש
vojvodina	בויבודינא
volandri	בולאנדרי
volcker	וולקר
voldemort	וולדמורט
volkan	ולקאן
voller	בולר
volodymyr	וולודימיר
volta	וולטא
voltaire	וולטייר
volterra	בולטירא
volvo	וולבו
volz	וולץ
vonlanthen	וונלאנתן
voreadis	ווריאדיס
vorilhon	וורילון
voronin	בורונין
vostok	וסטוק
voynov	בוינוב
vreijsen	וריסן
vryzas	וריזאס
vucinic	בוסיניטש
vujadin	בויאדין
vujicic	ביוטיטש
vujovic	בויוביטש
vukojevic	בוקוביטש
vukotic	ווקוטיטש
vyacheslav	ויאצ'יסלאב
vyazma	ויאזמא
vyntra	וינטרא
vyshnevskyi	וישנבסקי
vysotsky	ויסוצקי
vytlacil	ויטלאסיל
wachsman	ואקסמאן
wada	ואדא
waddle	ואדל
wade	וייד
wadie	ודיע
wadih	ואדיח
wagdi	ואגדי
wagner	ואגנר
wakamoto	ואקאמוטו
wakatsuki	ואקאטסוקי
wakim	ואקים
waksman	ואקסמאן
walaza	ואלאזא
walcott	ואלקוט
waldemar	ואלדמאר
waldheim	ואלדהאים
waldo	ואלדו
waleed	וליד
walesa	ואליסא
walid	וליד
walker	ואלקר
wall	וול
wallace	ואלאס
wallach	ואלאך
walle	וולי
wallis	ואליס
walsh	ואלש
walt	ואלט
walter	ואלטר
walters	ואלטרז
walton	ואלטון
walworth	ואלוורת
walzer	ואלצר
wang	ואנג
wangari	ואנגארי
wangchuck	ואנגצ'וק
wanis	ואניס
ward	וורד
warhol	וארהול
wark	וארק
warraq	וראק
warren	וארן
warsaw	וארסו
waseige	ואסיג'
washington	ואשינגטן
wasilewski	ואסילוסקי
wasserman	ואסרמאן
wassily	ואסילי
wat	ואט
wataru	ואטארו
wathiq	ואתיק
watros	ואטרוס
watson	ואטסון
watt	ואט
watteau	ואטו
watts	ואטס
wawrinka	ואורינקא
wawrzyniak	ואורזניאק
waxman	ואקסמאן
wayne	ויין
wazzan	ואזאן
weah	ויא
weaver	ויבר
weaving	ויבינג
weddell	ודל
wegener	ווגנר
wehr	ור
wei	ויי
weian	ויאן
weikart	וייקארט
weil	וייל
weill	ויל
weinek	ויניק
weiner	וינר
weiss	ואיס
weissglass	וייסגלאס
weisz	ואיז
weitz	ויץ
wellens	וילנס
wellhausen	ולהאוזן
welsh	וילש
welter	ולטר
welwyn	וילוין
wendee	ונדי
wendell	וינדל
wendy	ונדי
wenger	וינגר
wenhui	וינהוי
werner	ורנר
wes	וס
wesley	ויסלי
west	ווסט
westenra	וסטנרא
westermann	ויסטרמאן
westinghouse	וסטינגהאוס
westminster	וסטמינסטר
westmoreland	וסטמורלאנד
wexler	וקסלר
wheater	ויטיר
whelan	וילאן
whitaker	ויטאקר
white	ואיט
whitman	ויטמאן
whitney	ויטני
whittle	ויטל
wieghorst	ויהורסט
wiener	וינר
wiertz	וירץ
wiesel	ויסל
wieser	ויזיר
wight	ואיט
wijnstekers	וינסטיקירז
wiki	ויקי
wiland	וילאנד
wilander	וילנדר
wilczek	וילקזק
wilde	ואילד
wilder	ואילדר
wilders	וילדרז
wiles	ואילז
wiley	ואילי
wilhelm	וילהלם
wilhelmshaven	וילהלמסהייבן
wilhelmsson	וילהמסון
wilkie	וילקי
wilkins	וילקינז
wilkinson	וילקנסן
wilkshire	וילקשיר
will	ויל
willard	וילארד
willi	וילי
william	ויליאם
williams	ויליאמס
willis	ויליס
willy	וילי
wilmer	וילמר
wilshere	וילשיר
wilson	וילסון
wilton	וילטון
wiltord	וילטורד
wim	וים
wimmer	וימר
windhoek	וינדהוק
winn	וין
winograd	וינוגראד
winona	וינונא
winothai	וינותאי
winslet	וינסליט
winslow	וינסלו
winstone	וינסטון
wirajuda	ויראיודא
wirth	ורת
wisconsin	ויסקונסן
wiseman	ואיזמאן
wislander	וסלנדר
wislawa	ויסלאוא
wisnieski	ויסניסקי
witold	ויטולד
witschge	ויטסטשג
witt	ויט
witte	ויט
wittgenstein	ויטגינשטאין
wittig	ויטיג
wittmann	ויטמאן
wladyslaw	ואדיסואב
wlodzimierz	ולודזמיזירז
woese	ווס
wohrer	ווהרר
wojciech	וויסיטש
wojcik	וויצק
wole	וול
wolmar	וולמאר
wome	וומי
wonder	וונדר
wong	וונג
wood	ווד
woodcock	וודקוק
wooddin	וודן
woodgate	וודגייט
woodley	וודלי
woodrow	וודרו
woods	וודז
woodville	וודביל
woodward	וודוארד
woody	וודי
woolley	וולי
wordsworth	וורדזוורת
worm	וורם
worthington	ורתינגטן
wouters	ווטרס
wozniacki	בוזניאקי
wozniak	וזניאק
wren	רן
wright	ראיט
wunderlich	וונדרליש
wuthrich	ווטריך
wuttke	ווטקה
wyatt	ואיאט
wynalda	וינאלדא
wyoming	ויומינג
xabi	שאבי
xanthopoulos	קזאנתופולוס
xavier	זייביאר
xiang	קסיאנג
ximena	שימינא
xin	זין
xtra	אקסטרא
xucuru	זוקורו
xun	שון
xuri	קסורי
yaakov	יעקוב
yacef	יאסף
yacine	יאסין
yacob	יעקוב
yade	יאד
yadin	ידין
yafa	יאפא
yaghi	יאגי
yagur	יאגור
yahalom	יהלום
yahav	יאהאב
yahel	יאהיל
yahya	יחיא
yajima	יאג'ימא
yakan	יקן
yakhour	יאכור
yakin	יאקין
yakov	יעקב
yakovlev	יאקובליב
yakubu	יאקובו
yakushima	יאקושימא
yakushin	יאקושין
yakutsk	יאקוטסק
yamagishi	יאמאגישי
yamaguchi	יאמאגוצ'י
yamamoto	יאמאמוטו
yamani	ימאני
yamaoka	יאמאוקא
yamasaki	יאמאסאקי
yamashita	יאמאשיטא
yamazaki	יאמאזאקי
yamba	יאמבא
yamin	ימין
yamoussoukro	יאמוסוקרו
yan	יאן
yanagisawa	יאנאגיסאוא
yanai	ינאי
yang	יאנג
yangon	יאנגון
yann	יאן
yannick	יאניק
yannis	יאניס
yano	יאנו
yao	יאו
yaokun	יאוקון
yaounde	יאונדי
yaping	יאפינג
yaqut	יאקוט
yard	יארד
yardley	יארדלי
yari	יארי
yarkoni	ירקוני
yaron	ירון
yartsev	יארטסיב
yashin	יאשין
yasin	יאסין
yasmin	יאסמין
yassa	יאסא
yasser	יאסר
yassin	יאסין
yassine	יאסין
yasuda	יאסודא
yasuhiro	יאסוהירו
yasuhito	יאסוהיטו
yasumoto	יאסמוטו
yasunari	יאסונארי
yasunori	יאסנורי
yasuo	יאסו
yasuyuki	יאסויוקי
yatom	יתום
yavne	יבנה
yaya	יאיא
yazalde	יאזאלדי
yazd	יאזד
yeager	ייאגר
yedid	ידיד
yefim	יפים
yehud	יהוד
yehuda	יהודא
yekaterinburg	יקאטרינברג
yekini	יקיני
yelchin	ילצ'ין
yelena	ילינא
yeltsin	ילטסין
yemin	ימין
yerevan	יריבאן
yerushalmi	ירושלמי
yeshayahu	ישעיהו
yevgeny	יבגני
yfrah	יפראח
yiannis	יאניס
yitzhar	יצהר
yksel	יקסיל
yoan	יואן
yoann	יואן
yoav	יואב
yobo	יובו
yohan	יוהאן
yoichiro	יויצ'ירו
yoko	יוקו
yokohama	יוקוהאמא
yolande	יולאנד
yom	יום
yomi	יומי
yonai	יונאי
yonatan	יונתן
yoritomo	יוריטומו
yorke	יורק
yorkshire	יורקשיר
yosa	יוסא
yosef	יוסף
yoshihiro	יושיהירו
yoshimoto	יושימוטו
yoshinaka	יושינאקא
yoshino	יושינו
yoshiro	יושירו
yossef	יוסף
yossi	יוסי
yosuke	יוסוקה
youga	יוגא
younes	יונס
young	יונג
younis	יונס
younus	יונוס
yousef	יוסף
youssef	יוסף
yousuf	יוסוף
youzhny	יוז'ני
yo‘ldosh	יולדוש
yuba	יובא
yugoslavia	יוגוסלאביא
yui	יוי
yuichi	יויצ'י
yuji	יוג'י
yukari	יוקארי
yuki	יוקי
yukichi	יוקיצ'י
yukiko	יוקיקו
yukino	יוקינו
yukio	יוקיו
yukiya	יוקיא
yukon	יוקון
yukos	יוקוס
yul	יול
yulianto	יוליאנטו
yumi	יומי
yumiko	יומיקו
yun	יון
yunlong	יונלונג
yunnan	יונאן
yunus	יונוס
yuri	יורי
yuriy	יורי
yuryaku	יוריאקו
yusa	יוסא
yusef	יוסף
yusuf	יוסוף
yuzo	יוזו
yves	איב
yvon	יבון
yvonne	ייבון
zabaleta	זאבאליטא
zac	זאק
zaccardo	זקארדו
zaccarelli	זאקארילי
zaccheroni	זאקירוני
zach	זאק
zachariah	זאכאראיא
zachary	זאקארי
zack	זאק
zafour	זאפור
zagallo	זאגאלו
zaghloul	זגלול
zaha	זהא
zahavi	זהבי
zahir	זאהיר
zahorski	זאהורסקי
zahovic	זאהוביטש
zahra	זהרא
zaid	זאיד
zaidan	זאידן
zaidiyyah	זאידיה
zaimoglu	זאימוגלו
zainab	זיאנב
zairi	זאירי
zajec	זאייטש
zakariya	זקריא
zakariyya	זקריא
zakat	זקאת
zakharov	זאכארוב
zakir	זאקיר
zakopane	זאקופאנא
zakuani	זאקואני
zalayeta	זאלאייטא
zalessky	זאלסקי
zalman	זלמאן
zambelli	זאמבילי
zambezi	זאמביזי
zambo	זאמבו
zambrotta	זאמברוטא
zamfir	זאמפיר
zamora	זאמורא
zamorano	זאמוראנו
zamrak	זמרק
zan	זאן
zana	זאנא
zandi	זאנדי
zang	זאנג
zangwill	זאנגויל
zanidpour	זאינאדפור
zanzibar	זנזיבאר
zapater	זאפאטיר
zapatero	זאפאטירו
zapp	זאפ
zaragoza	זאראגוזא
zarko	זארקו
zarruq	זרוק
zat	זאט
zaur	זאור
zauri	זאורי
zavarov	זאבארוב
zaven	זאבין
zayatte	זאיאטי
zaydun	זיידון
zaytsev	זאיטסיב
zbanic	זבאניטש
zdenek	זדיניק
zealand	זילאנד
zebari	זיבארי
zebec	זיביטש
zeev	זיו
zeezee	זיזי
zeidan	זיידאן
zein	זיין
zeitlin	זאיטלין
zeitoun	זיטון
zeki	זקי
zelenka	זילינקא
zelin	זילין
zeljko	זיליקו
zell	זיל
zeller	זלר
zellweger	זלווגר
zemin	זימין
zenata	זנאטה
zenawi	זינאוי
zenga	זנגא
zengin	זינגן
zenko	זינקו
zennstrom	זינסטרום
zeno	זינו
zerhouni	זרהוני
zerka	זרקא
zermatt	זרמאט
zeroual	זרואל
zerouali	זרואלי
zevi	צבי
zewail	זוייל
zewlakow	זולאקו
zhang	ז'אנג
zhao	ז'או
zhekov	ז'קוב
zheng	ז'נג
zhenyu	ז'יניו
zhi	ז'י
zhirkov	ז'ירקוב
zhou	ז'ו
zhu	ז'ו
zhuk	זהוק
zhvania	ז'באניא
ziani	זיאני
zichron	זכרון
zico	זיקו
zidane	זידאן
ziege	זיגה
ziegler	זיגלר
zimmer	זימר
zimmerman	זימרמאן
zimmermann	זימרמאן
zinn	זין
zino	זינו
zinta	זינטא
zion	זאיון
ziryab	זיריאב
zisis	זיסיס
zitka	זיטקא
zitouni	זייטוני
ziv	זיו
ziyi	זיי
zizka	זיזקא
zlatko	זלאטקו
zoco	זוקו
zoe	זואי
zoellick	זוליק
zoetermeer	זויטרמיר
zoff	זוף
zohar	זוהר
zoi	זוי
zokora	זוקורא
zola	זולא
zoltan	זולטאן
zondervan	זונדרבאן
zong	זונג
zoran	זוראן
zorin	זורין
zoro	זורו
zorro	זורו
zouagi	זואגי
zoubeir	זוביר
zozimo	זוזימו
zreiq	זריק
zuabi	זועבי
zubeidi	זוביידי
zuberbuhler	זוברבוהלר
zubin	זובין
zubizarreta	זוביזאריטא
zubrin	זוברין
zucchero	זוקירו
zuchardt	צוכארט
zucker	זאקר
zuckermann	זאקרמאן
zuckmayer	צוקמאיר
zuhair	זוהיר
zuhr	זוהר
zukerman	זקרמאן
zuma	זומא
zune	זון
zungul	זונגול
zurab	זוראב
zurawski	זוראוסקי
zurer	זורר
zurn	זורן
zvartnots	זבארטנוטס
zverev	זביריב
zvi	זבי
zviad	זביאד
zvonareva	זבונאריבא
zvonimir	זבונימיר
zwartkruis	זוארטקרויס
zweig	צבאיג
zweyer	זוואיר
zyad	זיאד
zyklon	זיקלון
zyryanov	זיריאנוב
đinđic	גינגיטש
đorđevic	דורדיביטש
đuric	דוריטש
ľubomir	לובומיר
ľubos	לובוס
