aabar	ﺍﺏر
aahie	ﺍﻩی
aali	ﺍﻉﻝی
aaliyah	ﺍﻉﻝیﺍﻩ
aaltje	ﺍﻝﺕیﺝﻩ
aamina	ﺍﺍﻡیﻥﺍ
aaron	ﺍرﺩﻥ
aba	ﺍﺏﺍ
abad	ﺍﺏﺍﺩ
abbate	ﺍﺏیﺕ
abbett	ﺍﺏﺕ
abbey	ﺍﺏی
abbot	ﺍﺏﻭﺕ
abbotsmith	ﺍﺏﻭﺕﺱﻡیﺕ
abby	ﺍﺏی
abcher	ﺍﺏچﺭ
abdalrahman	ﺍﺏﺩﻝرﺡﻡﺍﻥ
abdul	ﻉﺏﺩﻝ
abdulaziz	ﻉﺏﺩﺍﻝﻉزیر
abdulrahman	ﻉﺏﺩﺍﻝرﺡﻡﺍﻥ
abe	ﺍﺏﻩ
abel	ﺍﺏیﻝ
abelardo	ﺍﺏﻝﺍﺭﺩﻭ
abele	ﺍﺏﻝﻩ
abell	ﺍﺏﻝ
abend	ﺍﺏﻥﺩ
abera	ﺍﺏرﺍ
abercrombie	ﺍﺏﺭکﺭﻭﻡﺏی
aberg	ﺍﺏﺭگ
aberson	ﺍﺏرﺱﻭﻥ
abery	ﺍﺏری
abhay	ﺍﺏﻩی
abia	ﺍﺏیﺍ
abiad	ﺍﺏیﺍﺩ
abilock	ﺍﺏیﻝﺍک
ablation	ﺍﺏﻝیﺵﻥ
able	ﺍیﺏﻝ
ablett	ﺍﺏﻝﺕ
abley	ﺍﺏﻝی
abner	ﺍﺏﻥﺭ
abou	ﺍﺏﻭ
abraham	ﺍﺏرﺍﻩﺍﻡ
abrahams	ﺍﺏﺭﺍﻩﺍﻡﺯ
abram	ﺍﺏﺭﺍﻡ
abramson	ﺍﺏﺭﺍﻡﺱﻭﻥ
abrupt	ﺍﺏﺭﺍپﺕ
absalom	ﺍﺏﺱﺍﻝﻭﻡ
abshar	ﺍﺏﺵﺍر
abshawe	ﺍﺏﺵیﻭ
abstract	ﺍﺏﺱﺕﺭکﺕ
abtine	ﺍﺏﺕیﻥ
abu	ﺍﺏﻭ
abudhabi	ﺍﺏﺍﺩﻩﺏی
abul	ﺍﺏﻭﻝ
abyan	ﺍﺏیﺍﻥ
academy	ﺍکﺍﺩﻡی
accapadi	ﺍکﺍپﺍﺩی
ace	ﺍیﺱ
acee	ﺍکی
acevedo	ﺍکﻭﺩﻭ
achernar	ﺍچﺭﻥﺍﺭ
achilles	ﺍچیﻝﺱ
ack	ﺍک
ackeret	ﺍکﺭﺕ
ackerman	ﺍکرﻡ
ackles	ﺍکﻝﺱ
ackley	ﺍکﻝی
ackroyd	ﺍکﺭﻭیﺩ
acmena	ﺍکﻡﻥﺍ
acox	ﺍکﺍکﺱ
active	ﺍکﺕیﻭ
acton	ﺍکﺕﻭﻥ
acuna	ﺍکﻭﻥﺍ
acuner	ﺍکﻭﻥﺭ
adab	ﺍﺩﺍﺏ
adalia	ﺍﺩﺍﻝیﺍ
adam	ﺍﺩﺍﻡ
adamberr	ﺍﺩﺍﻡﺏر
adametz	ﺍﺩﺍﻡﺕﺯ
adamo	ﺍﺩﺍﻡﻭ
adamson	ﺍﺩﺍﻡﺱﻭﻥ
adan	ﺍﺩﺍﻥ
adara	ﺍﺩرﺍ
adarsh	ﺍﺩﺍرﺵ
adcock	ﺍﺩکک
addicks	ﺍﺩیکﺱ
addie	ﺍﺩیﻩ
addington	ﺍﺩیﻥگﺕﻭﻥ
addis	ﺍﺩیﺱ
addison	ﺍﺩیﺱﻭﻥ
addkison	ﺍﺩکیﺱﻭﻥ
addy	ﺍﺩی
ade	ﺍﺩﻩ
adel	ﺍﺩﻝ
adela	ﺍﺩﻝﺍ
adelardo	ﺍﺩﻝﺍﺭﺩﻭ
adelheid	ﺍﺏﻝﻩیﺩ
adelson	ﺍﺩﻝﺱﻭﻥ
adgeringelant	ﺍگریﻥگﻝﺍﻥﺕ
adie	ﺍﺩیﻩ
adik	ﺍﺩیک
adil	ﺍﺩیﻝ
adina	ﺍﺩیﻥﺍ
adit	ﺍﺩیﺕ
adkins	ﺍﺩکیﻥﺯ
adler	ﺍﺩﻝﺭ
admiralen	ﺍﺩﻡیﺭﺍﻝﻥ
admiralty	ﺍﺩﻡیرﺍﻝﺕی
adolfsson	ﺍﺩﻭﻝﻑﺱﻭﻥ
adolph	ﺍﺩﻭﻝﻑ
adonis	ﺍﺩﻭﻥیﺱ
ador	ﺍﺩﻭﺭ
adri	ﺍﺩﺭی
adria	ﺍﺩﺭیﺍ
adriaantje	ﺍریﺍﻥﺝﻩ
adriaen	ﺍﺩریﺍﻥ
adriana	ﺍﺩﺭیﺍﻥﺍ
adriance	ﺍﺩریﺍﻥﺱ
adriane	ﺍﺩﺭیﻥ
adriano	ﺍﺩﺭیﻥﻭ
adrianzen	ﺍﺩریﺍﻥﺯﻥ
adrie	ﺍﺩﺭی
adriene	ﺍﺩﺭیﻥی
adrienne	ﺍﺩﺭیﻥی
adsett	ﺍﺩﺕ
adusumalli	ﺍﺩﻭﺱﻭﻡﺍﻝی
aechtie	ﺍچی
aefje	ﺍیﻑ
aeltje	ﺍیﻝﺕﻩ
aernoudt	ﺍرﺕﻭﺕ
aeronaut	ﺍیرﻭﻥﺍﺕ
afa	ﺍﻑﺍ
afif	ﺍﻑیﻑ
afioun	ﺍﻑیﻭﻥ
afou	ﺍﻑﻭ
afra	ﺍﻑرﺍ
aftab	ﺍﻑﺕﺍﺏ
afzal	ﺍﻑزﺍﻝ
agali	ﺍگﺍﻝی
aganovic	ﺍگﻥﻭیک
agarwal	ﺍگﺍرﻭﺍﻝ
agass	ﺍگﺍﺱ
agate	ﺍگﺍﺕی
ageno	ﺍگﻥﻭ
agesa	ﺍگیﺱﺍ
aggelos	ﺍﺝﻝﻭﺱ
agndie	ﺍگﻥﺩی
agon	ﺍگﻭﻥ
agopian	ﺍگپیﺍﻥ
agostinelli	ﺍگﻭﺱﺕیﻥﻝی
agostini	ﺍگﻭﺱﺕیﻥی
agoyo	ﺍگﻭیﻭ
agrawal	ﺍگرﺍﻭﺍﻝ
agrawala	ﺍگﺭﺍﻭﺍﻝﺍ
agsorn	ﺍگﺱﻭﺭﻥ
aguado	ﺍگیﻭﺍﺩﻭ
aguero	ﺍگﻭیﺭﻭ
aguirre	ﺍگﻭییﺭﻩ
agullo	ﺍگﻭﻝﻭ
agutter	ﺍگﺍﺕر
ahern	ﺍﻩﺭﻥ
ahlstrom	ﺍﻝﺱﺕﺭﻭﻡ
aibel	ﺍیﺏﻝ
aida	ﺍیﺩﺍ
aidan	ﺍیﺩﺍﻥ
aiesha	ﺍیﺵﺍ
aija	ﺍیﺝﺍ
aik	ﺍیک
aileen	ﺍیﻝیﻥ
ailsa	ﺍیﻝﺱﺍ
aim	ﺍیﻡ
aiman	ﺍیﻡﺍﻥ
aimee	ﺍیﻡی
ain	ﺍیﻥ
ainissa	ﺍیﻥیﺱﺍ
ainley	ﺍیﻥﻝی
ainsaar	ﺍیﻥﺱﺭ
ainsworth	ﺍیﻥﺱﻭرﺕ
aint	ﺍیﻥﺕ
air	ﺍیﺭ
aird	ﺍیﺭﺩ
airdo	ﺍیﺭﺩﻭ
airlines	ﺍیﺭﻝﺍیﻥﺯ
airoun	ﺍیﺭﻭﻥ
airouni	ﺍیﺭﻭﻥی
airways	ﺍیرﻭیﺯ
airy	ﺍیری
aisenstat	ﺍیﺱﻥﺱﺕﺍﺕ
aisle	ﺍیﺱﻝﻩ
aissa	ﺍیﺱﺍ
aissama	ﺍیﺱﺍﻡﺍ
ait	ﺍیﺕ
aitcho	ﺍیﺕچﻭ
aites	ﺍیﺕﺱ
aitken	ﺍیﺕکﻥ
aitkenhead	ﺍیﺕکﻥﻩﺩ
ajax	ﺍﺝﺍکﺱ
ajay	ﺍﺝﺍی
ajlun	ﺍﺝﻝﺍﻥ
aka	ﺍکﺍ
akademik	ﺍکﺍﺩﻡیک
akar	ﺍکﺍﺭ
akdag	ﺍکﺩﺍگ
akeem	ﺍکیﻡ
akella	ﺍکﻝﺍ
akemi	ﺍکﻡی
akers	ﺍکرز
akersloot	ﺍکرﺱﻝﺍﺕ
akerson	ﺍکرﺱﻭﻥ
akgun	ﺍکگﺍﻥ
aki	ﺍکی
akihiko	ﺍکیﻩیکﻭ
akil	ﺍکیﻝ
akilah	ﺍکیﻝﺍ
akilesh	ﺍکیﻝﺵ
akin	ﺍکیﻥ
akira	ﺍکیرﺍ
akitomo	ﺍکیﺕﻭﻡﻭ
akman	ﺍکﻡﺍﻥ
akrill	ﺍکریﻝ
aksu	ﺍکﺱﻭ
alaaldin	ﺍﻝﺍﻝﺩیﻥ
alagesan	ﺍﻝگﺱﺍﻥ
alain	ﺍﻝیﺍﻥ
alaisdair	ﺍﻝﺍیﺱﺩیﺭ
alamode	ﺍﻝﻡﻭﺩ
alan	ﺍﻝﺍﻥ
alana	ﺍﻝﺍﻥﺍ
alaqabah	ﺍﻝکﺏﺍﻩ
albahah	ﺍﻝﺏﺍﻩﺍﻩ
alber	ﺍﻝﺏﺭ
albert	ﺍﻝﺏرﺕ
albertini	ﺍﻝﺏﺭﺕیﻥی
albertus	ﺍﻝﺏرﺕ
albinger	ﺍﻝﺏیﻥگﺭ
albom	ﺍﻝﺏﻭﻡ
albright	ﺍﻝﺏریﺝ
aldar	ﺍﻝﺩر
aldhafra	ﺍﻝﺡﻑرﺍ
aldine	ﺍﻝﺩیﻥ
aldrich	ﺍﻝﺩﺭیچ
aldridge	ﺍﻝﺩریگ
aldworth	ﺍﻝرﻭﺕ
aleashia	ﺍﻝیﺵیﺍ
alegado	ﺍﻝگﺍﺩﻭ
alelyunas	ﺍﻝیﻝیﻭﻥﺍﺱ
aleph	ﺍﻝﻑ
alesandro	ﺍﻝﺱﻥﺩﺭﻭ
aleser	ﺍﻝیزر
alessandri	ﺍﻝﺱﺍﻥﺩﺭی
alex	ﺍﻝکﺱ
alexander	ﺍﻝکﺱﺍﻥﺩر
alexandros	ﺍﻝکﺱﺍﻥﺩﺭﻭﺯ
alexandrou	ﺍﻝکﺱﺍﻥﺩﺭﻭ
alexey	ﺍﻝکﺱی
alexiou	ﺍﻝکﺱیﻭ
alexis	ﺍﻝکﺱیﺯ
alexy	ﺍﻝکﺱی
alf	ﺍﻝﻑ
alfeld	ﺍﻝﻑﻝﺩ
alfonsina	ﺍﻝﻑﺍﻥﺱیﻥﺍ
alfonso	ﺍﻝﻑﺍﻥﺱﻭ
alford	ﺍﻝﻑﻭﺭﺩ
alfors	ﺍﻝﻑﺭﺱ
alfred	ﺍﻝﻑﺭﺩ
alfredo	ﺍﻝﻑﺭﺩﻭ
algae	ﺍﻝگﺍی
algal	ﺍﻝگﺍﻝ
algie	ﺍﻝگی
alhudud	ﺍﻝﺍﺡﺩﻭﺩ
ali	ﻉﻝی
alia	ﻉﻝیﺍ
alias	ﺍﻝیﺍﺱ
alibey	ﺍﻝیﺏی
alice	ﺍﻝیﺱ
alicia	ﺍﻝیﺱیﺍ
alien	ﺍﻝیﻥ
alim	ﻉﻝیﻡ
alima	ﻉﻝیﻡﺍ
aline	ﺍﻝیﻥ
alington	ﺍﻝیﻥگﺕﻭﻥ
aliphas	ﺍﻝیﻑﺍﺱ
alisa	ﺍﻝیﺯﺍ
alison	ﺍﻝیﺱﻭﻥ
alistair	ﺍﻝیﺱﺕیﺭ
aliyyah	ﺍﻝییﺍﻩ
alkhazna	ﺍﻝﺥزﻥﺍ
all	ﺍﻝ
alla	ﺍﻝﺍ
alladhiqiyah	ﺍﻝﺍﻩﺍیﺩیکیﺍ
allaire	ﺍﻝﺍیﺭﻩ
allard	ﺍﻝﺍﺭﺩ
allaway	ﺍﻝﺍﻭی
allbery	ﺍﻝﺏﺭی
allcock	ﺍﻝکک
allcor	ﺍﻝکر
allden	ﺍﻝﺩﻥ
allee	ﺍﻝی
allegro	ﺍﻝگﺭﻭ
allen	ﺍﻝﻥ
allender	ﺍﻝﻥﺩﺭ
allerton	ﺍﻝرﺕﻥ
alleway	ﺍﻝیﻭی
alley	ﺍﻝی
allibant	ﺍﻝیﺏﺍﻥﺕ
allie	ﺍﻝی
allison	ﺍﻝیﺱﻥ
allitt	ﺍﻝیﺕ
allman	ﺍﻝﻡﺍﻥ
allmond	ﺍﻝﻡﻭﻥﺩ
allnatt	ﺍﻝﺍﻥﺕ
allom	ﺍﻝﻭﻡ
alloway	ﺍﻝﻝﻭﻭی
allowitz	ﺍﻝﻭیﺕﺯ
allport	ﺍﻝپﻭﺭﺕ
allsop	ﺍﻝﺱپ
allsworth	ﺍﻝزﻭرث
allums	ﺍﻝﺍﻡﺯ
allwright	ﺍﻝرﺍیﺕ
allwyn	ﺍﻝﻭیﻥ
allyn	ﺍﻝیﻥ
allyson	ﺍﻝیﺱﻭﻥ
allyz	ﺍﻝیﺯ
almas	ﺍﻝﻡﺍﺱ
almeroth	ﺍﻝﻡﺭﻭﺕ
almgren	ﺍﻝﻡگﺭﻥ
almintaqah	ﺍﻝﻡیﻥﺍکﺍﺡ
almira	ﺍﻝﻡیرﺍ
almirall	ﺍﻝﻡیﺭﺍﻝ
almudena	ﺍﻝﻡﻭﺩیﻥﺍ
almudevar	ﺍﻝﻡﻭﺩیﻭﺍﺭ
alnoor	ﺍﻝﻥﻭﺭ
alok	ﺍﻝﻭک
alpert	ﺍﻝپﺭﺕ
alpha	ﺍﻝﻑﺍ
alphard	ﺍﻝﻑﺍﺭﺩ
alpine	ﺍﻝپﺍیﻥ
alridge	ﺍریﺝ
alsop	ﺍﻝﺱپ
alston	ﺍﻝﺱﺕﻭﻥ
alsworth	ﺍﻝزﻭرﺙ
altair	ﺍﻝطیر
altizer	ﺍﻝﺕیﺯر
altman	ﺍﻝﺕﻡﺍﻥ
alukal	ﺍﻝﻭکﺍﻝ
alva	ﺍﻝﻭﺍ
alvaro	ﺍﻝﻭﺍﺭﻭ
alvarus	ﺍﻝﻭﺍﺭﻭﺱ
alves	ﺍﻝﻭﺯ
alvin	ﺍﻝﻭیﻥ
alwan	ﺍﻝﻭﺍﻥ
alwathba	ﺍﻝﻭطﺏﺍ
alwin	ﺍﻝﻭیﻥ
alwyn	ﺍﻝﻭیﻥ
alya	ﺍﻝیﺍ
alyce	ﺍﻝیﺱ
alyosha	ﺍﻝﻭﺵﺍ
alyssa	ﺍﻝیﺱﺍ
alyx	ﺍﻝیکﺱ
alzena	ﺍﻝزﻥﺍ
ama	ﺍﻡﺍ
amador	ﺍﻡﺍﺩﻭﺭ
amai	ﺍﻡﺍی
amal	ﺍﻉﻡﺍﻝ
amancio	ﺍﻡﺍﻥﺵیﻭ
amand	ﺍﻡﺍﻥﺩ
amani	ﺍﻡﺍﻥی
amano	ﺍﻡﺍﻥﻭ
amara	ﺍﻡﺍﺭﺍ
amaral	ﺍﻡﺍﺭﺍﻝ
amardeo	ﺍﻡﺍﺭﺩیﻭ
amaresh	ﺍﻡﺍرﺵ
amarit	ﺍﻡﺍﺭیﺕ
amarnath	ﺍﻡﺍﺭﻥﺕ
amber	ﺍﻡﺏر
amberle	ﺍﻡﺏﺭﻝی
ambidge	ﺍﻡﺏیﺝ
ambrosius	ﺍﻡﺏرﻭﺱیﻭﺱ
ambush	ﺍﻡﺏﻭﺵ
amedeo	ﺍﻡﺩیﻭ
amelia	ﺍﻡﻝیﺍ
america	ﺍﻡﺭیکﺍ
american	ﺍﻡﺭیکﻥ
amerikan	ﺍﻡﺭیکﻥ
amerman	ﺍﻡﺭﻡﺍﻥ
amerson	ﺍﻡﺭﺱﻭﻥ
amery	ﺍﻡری
amezquita	ﺍﻡیﺯﻭﺕﺍ
ami	ﺍﻡی
amicus	ﺍﻡیکﻭﺱ
amidei	ﺍﻡیﺩی
amidon	ﺍﻡیﺩﻭﻥ
amie	ﺍﻡیﻩ
amihai	ﺍﻡیﻩﺍی
amilcar	ﺍﻡیﻝکﺍر
amin	ﺍﻡیﻥ
amina	ﺍﻡیﻥﺍ
amir	ﺍﻡیﺭ
amira	ﺍﻡیرﺍ
amish	ﺍﻡیﺵ
amit	ﺍﻡیﺕ
amitava	ﺍﻡیﺕﺍﻭﺍ
amlak	ﺍﻡﻝک
ammeter	ﺍﻡیﺕﺭ
amna	ﺍﻡﻥﺍ
amnon	ﺍﻡﻥﻭﻥ
amokrane	ﺍﻡﻭکرﺍﻥ
amoroso	ﺍﻡﻭﺭﻭﺱﻭ
amory	ﺍﻡری
amos	ﺍﻡﻭﺱ
ampon	ﺍﻡپﻥ
ampte	ﺍﻡپﺕ
amran	ﺍﻡرﺍﻥ
amrik	ﺍﻡریک
amritansh	ﺍﻡﺭیﺕﺍﻥﺵ
amsha	ﺍﻡﺵﺍ
amshey	ﺍﻡﺵی
amstadt	ﺍﻡﺱﺕﺍﺕ
amundsen	ﺍﻡﻭﻥﺩﺱﻥ
anab	ﺍﻥﺍﺏ
anakin	ﺍﻥﺍکیﻥ
anand	ﺍﻥﺍﻥﺩ
ananda	ﺍﻥﺍﻥﺩﺍ
anant	ﺍﻥﺍﻥﺕ
anantha	ﺍﻥﺍﻥﺱﺍ
anas	ﺍﻥﺍز
anastacia	ﺍﻥﺍﺱﺕﺍﺱیﺍ
anastas	ﺍﻥﺍﺱﺕﺍﺱ
anathea	ﺍﻥﺍﺕی
anatoly	ﺍﻥﺍﺕﻭﻝی
anawat	ﺍﻥﺍﻭﺍﺕ
anbar	ﺍﻥﺏر
anbu	ﺍﻥﺏﻭ
ancell	ﺍﻥکﻝ
anchi	ﺍﻥچی
anchor	ﺍﻥچﻭﺭ
anchorage	ﺍﻥچﻭﺭﺍگ
anckorn	ﺍﻥکﻭﺭﻥ
ancowitz	ﺍﻥکﻭیﺕﺯ
and	ﺍﻥﺩ
andenes	ﺍﻥﺩﻥﺱ
anderberg	ﺍﻥﺩﺭﺏﺭگ
anderer	ﺍﻥﺩﺭﺭ
andersen	ﺍﻥﺩﺭﺱﻥ
anderson	ﺍﻥﺩرﺱﻭﻥ
andi	ﺍﻥﺩی
andolsen	ﺍﻥﺩﻭﻝﺱﻥ
andr	ﺍﻥﺩﺭ
andra	ﺍﻥﺩﺭﺍ
andrade	ﺍﻥﺩریﺩ
andras	ﺍﻥﺩﺭﺍﺱ
andrea	ﺍﻥﺩﺭیﺍ
andreaea	ﺍﻥﺩﺭییﺍ
andreas	ﺍﻥﺩﺭیﺍﺱ
andreassen	ﺍﻥﺩﺭیﺱﻥ
andreessen	ﺍﻥﺩﺭیﺱﻥ
andrei	ﺍﻥﺩﺭی
andres	ﺍﻥﺩﺭیﺱ
andress	ﺍﻥﺩﺭﺱ
andrew	ﺍﻥﺩﺭﻭ
andrewes	ﺍﻥﺩریﺱ
andrews	ﺍﻥﺩﺭیﻭﺯ
andries	ﺍﻥﺩریﺱ
andris	ﺍﻥﺩﺭیﺱ
andron	ﺍﻥﺩﺭﻭﻥ
andrup	ﺍﻥﺩرﺍپ
andrus	ﺍﻥﺩﺭﻭﺱ
angela	ﺍﻥژﻝﺍ
angeles	ﺍﻥﺝﻝﺱ
angelini	ﺍﻥﺝیﻝیﻥی
angell	ﺍﻥگﻝ
angelo	ﺍﻥﺝﻝﻭ
anghe	ﺍﻥگﻩ
angle	ﺍﻥﺝﻝ
angles	ﺍﻥگﻝﺱ
anglin	ﺍﻥگﻝیﻥ
angulo	ﺍﻥگﻭﻝﻭ
anil	ﺍﻥیﻝ
anilane	ﺍﻥﺍیﻝیﻥ
anisa	ﺍﻥیﺱﺍ
ankeney	ﺍﻥکﻥی
ann	ﺍﻥ
anna	ﺍﻥﺍ
annese	ﺍﻥیﺱﻩ
annett	ﺍﻥﺕ
annetts	ﺍﻥیﺕﺱ
annexstad	ﺍﻥکﺱﺕﺍﺩ
annick	ﺍﻥیک
annius	ﺍﻥیﻭﺱ
anniversary	ﺍﻥیﻭﺭﺱﺭی
anno	ﺍﻥﻭ
anntar	ﺍﻥﺕﺍﺭ
anoop	ﺍﻥﻭپ
anoosh	ﺍﻥﻭﺵ
anscomb	ﺍﻥﺱکﺍﻡﺏ
ansell	ﺍﻥﺱﻝ
anselm	ﺍﻥﺱﻝﻡ
anselmo	ﺍﻥﺱﻝﻡﻭ
anshu	ﺍﻥﺵﻭ
ansley	ﺍﻥﺱﻝی
anson	ﺍﻥﺱﻭﻥ
anspach	ﺍﻥﺱپﺍچ
ansselin	ﺍﻥﺱﻝیﻥ
anssi	ﺍﻥﺱی
antanaitis	ﺍﻥﺕﺍﻥﺍیﺕیﺱ
antaramian	ﺍﻥﺕﺍﺭﺍﻡیﺍﻥ
antarctic	ﺍﻥﺕﺍﺭﺕیک
ante	ﺍﻥﺕﻩ
antenna	ﺍﻥﺕﻥﺍ
antero	ﺍﻥﺕﺭﻭ
anthea	ﺍﻥﺱی
antheunis	ﺍﻥﺕیﻭﻥیﺱ
anthistle	ﺍﻥﺕیﺱﺕﻝ
antho	ﺍﻥﺕﻭ
anthon	ﺍﻥﺕﻭﻥ
anthony	ﺍﻥﺕﻭﻥی
antila	ﺍﻥﺕیﻝﺍ
antipodes	ﺍﻥﺕیپﺩﺱ
antley	ﺍﻥﺕﻝی
antoine	ﺍﻥﺕﻭییﻥﻩ
anton	ﺍﻥﺕﻭﻥ
antone	ﺍﻥﺕﻭﻥ
antoni	ﺍﻥﺕﻭﻥی
antonis	ﺍﻥﺕﻭﻥیﺱ
antonius	ﺍﻥﺕﻭﻥیﺱ
antonoglou	ﺍﻥﺕﻭﻥﻭگﻝﻭ
antonowich	ﺍﻥﺕﻭﻥﻭﻭیچ
antony	ﺍﻥﺕﻭﻥی
antrosio	ﺍﻥﺕﺭﻭﺱیﻭ
antti	ﺍﻥﺕی
anu	ﺍﻥﻭ
anuchin	ﺍﻥﻭچیﻥ
anujit	ﺍﻥﻭﺝیﺕ
anukul	ﺍﻥﻭکﻭﻝ
anup	ﺍﻥﻭپ
anupam	ﺍﻥﻭپﺍﻡ
anurag	ﺍﻥﻭرگ
anusha	ﺍﻥﻭﺵﺍ
anvers	ﺍﻥﻭﺭﺱ
anvil	ﺍﻥﻭیﻝ
anwar	ﺍﻥﺹﺍر
anwer	ﺍﻥﺱر
anzalone	ﺍﻥﺯﺍﻝﻭﻥی
anzlovar	ﺍﻥﺯﻝﻭﺍﺭ
aoglat	ﺍﻭگﻝﺕ
aogori	ﺍﻭگﻭﺭی
aoki	ﺍﻭکی
aoyoun	ﺍﻭیﻭﻥ
apathy	ﺍپﺍﺕی
apel	ﺍپﻝ
apelian	ﺍپﻝیﺍﻥ
apendice	ﺍپﻥﺩیﺱ
aperson	ﺍپﺭﺱﻭﻥ
aphichart	ﺍﻑیچﺍﺭﺕ
aphoriel	ﺍﻑﻭﺭیﻝ
aphrodite	ﺍﻑﺭﺩیﺕ
apletree	ﺍپﻝرﺕری
aplin	ﺍپﻝیﻥ
apodaca	ﺍپﻭﺩﺍکﺍ
apolonio	ﺍپﻭﻝﻭﻥیﻭ
aponte	ﺍپﻭﻥﺕﻩ
apoorva	ﺍپﻭﺭﻭﺍ
appel	ﺍپﻝ
appelberg	ﺍپﻝﺏﺭگ
apple	ﺍپﻝ
applebee	ﺍپﻝیﺏی
appleby	ﺍپﻝیﺏی
appleford	ﺍپﻝیﻑرﺩ
applegate	ﺍپﻝگیﺕ
appleton	ﺍپﻝیﺕﻥ
april	ﺍپﺭیﻝ
apts	ﺍپﺕﺱ
aqil	ﺍکیﻝ
aqila	ﺍکیﻝﺍ
arab	ﻉرﺏ
arantes	ﺍﺭﻥﺕﺱ
arbanas	ﺍﺭﺏﺍﻥﺍﺱ
arber	ﺍرﺏر
arbil	ﺍرﺏیﻝ
arce	ﺍﺭﺱی
arch	ﺍﺭچ
archdale	ﺍرچﺍﻝ
archer	ﺍرچر
archibald	ﺍﺭچیﺏﺍﻝﺩ
ardalich	ﺍﺭﺩﺍﻝیچ
ardis	ﺍﺭﺩیﺱ
ardley	ﺍرﺩﻝی
arend	ﺍﺭﻥﺩ
arendt	ﺍرﻥﺕ
arensburger	ﺍﺭﻥﺱﺏﺭگﺭ
ari	ﺍﺭی
ariaantje	ﺍریﺍﻥﺕ
ariss	ﺍریز
aristotle	ﺍﺭیﺱﺕﻭﺕﻝ
arkell	ﺍرکﻝ
arktiki	ﺍﺭکﺕیکی
arlet	ﺍرﻝﺕ
arlidge	ﺍرﻝیﺝ
arling	ﺍﺭﻝیﻥگ
arm	ﺍﺭﻡ
armato	ﺍﺭﻡﺍﺕﻭ
armitage	ﺍﺭﻡیﺕﺍژ
armitt	ﺍرﻡیﺕ
armontrout	ﺍﺭﻡﻭﻥﺕﺭﻭﺕ
armour	ﺍﺭﻡﻭﺭ
arms	ﺍرﻡﺯ
armstrong	ﺍرﻡﺍﺱﺕرﺍﻥگ
arne	ﺍﺭﻥﻩ
arnett	ﺍرﻥﺕ
arnfield	ﺍﺭﻥﻑیﻝﺩ
arnoldus	ﺍرﻥﻝﺩﻭﺱ
arnot	ﺍرﻥﺍﺕ
aromaa	ﺍﺭﻭﻡﺍ
aronson	ﺍیﺭﻭﻥﺱﻭﻥ
arpin	ﺍﺭپیﻥ
arras	ﺍﺭﺍﺱ
arrifa	ﺍریﻑﺍ
arrin	ﺍریﻥ
arrington	ﺍﺭیﻥگﺕﻥ
arscott	ﺍﺭﺱکﺍﺕ
arsenault	ﺍﺭﺱﻥﺍﻝﺕ
arseneau	ﺍرﺱﻥیﻭ
arsikere	ﺍﺭﺱیکﺭ
art	ﺍﺭﺕ
arter	ﺍرﺕر
arthers	ﺍرﺕرز
arthur	ﺍرﺕر
artiss	ﺍریﺱ
arunachalam	ﺍﺭﻭﻥﺍچﺍﻝﺍﻡ
arunah	ﺍﺭﻭﻥﺍﻩ
arvesen	ﺍﺭﻭﺱﻥ
arviola	ﺍﺭﻭیﻭﻝﺍ
arvola	ﺍﺭﻭﻭﻝﺍ
arwa	ﺍرﻭﺍ
arya	ﺍﺭیﺍ
arzate	ﺍﺭﺯﺍﺕ
asaad	ﺍﺱﺍﺩ
asbell	ﺍﺱﺏﻝ
asbrink	ﺍﺱﺏﺭیﻥک
ascolese	ﺍﺱکﻭﻝیﺯ
asguarian	ﺍﺱگﻭﺭیﺍﻥ
ash	ﺍﺵ
ashby	ﺍﺵﺏی
ashcroft	ﺍﺵکﺭﺍﻑﺕ
ashenden	ﺍﺵﻥﺩﻥ
asherman	ﺍﺵﺭﻡﻥ
ashfield	ﺍﺵﻑیﻝﺩ
ashford	ﺍﺵﻑﺭﺩ
ashley	ﺍﺵﻝی
ashmore	ﺍﺵﻡﻭﺭ
ashok	ﺍﺵﻭک
ashton	ﺍﺵﺕﻭﻥ
ashworth	ﺍﺵﻭﺭث
asif	ﺍﺱیﻑ
asim	ﺍﺙیﻡ
ask	ﺍﺱک
askanas	ﺍﺱکﻥﺱ
aske	ﺍﺱک
askeland	ﺍﺱکﻝﻥﺩ
asma	ﺍﺱﻡﺍ
assakul	ﺍﺱﺍکﻭﻝ
asselin	ﺍﺱﻝیﻥ
asselman	ﺍﺱﻝﻡﻥ
assi	ﺍﺱی
assimilate	ﺍﺱیﻡیﻝیﺕ
asson	ﺍیﺱﻭﻥ
astaire	ﺍﺱﺕﺍیﺭ
astley	ﺍﺱﺕﻝی
astrid	ﺍﺱﺕﺭیﺩ
aswalap	ﺍﺱﻭﺍﻝﺍپ
atallah	ﺍﺕﺍﺍﻝﻝﻩ
atanacio	ﺍﺕﺍﻥﺱیﻭ
ataras	ﺍﺕﺍﺭﺍﺱ
atari	ﺍﺕری
ataullah	ﺍﺕﻭﻝﺍﻩ
atchison	ﺍچیﺱﻭﻥ
atems	ﺍﺕﻡﺯ
atherton	ﺍﺕﺭﺕﻥ
athow	ﺍﺕﻭ
atifa	ﺍﺕیﻑﺍ
atish	ﺍﺕیﺵ
atiya	ﺍﺕییﺍ
atka	ﺍﺕکﺍ
atkins	ﺍﺕکیﻥﺯ
atlanta	ﺍﺕﻝﺍﻥﺕﺍ
atlas	ﺍﺕﻝﺱ
atle	ﺍﺕﻝ
atmosphere	ﺍﺕﻡﺱﻑﺭ
atoji	ﺍﺕﻭﺝی
atom	ﺍﺕﻡ
atoon	ﺍﺕﻭﻥ
atram	ﺍﺕﺭﺍﻡ
atreides	ﺍﺕﺭیﺩﺯ
attia	ﺍﺕیﺍ
attig	ﺍﺕیگ
attilio	ﺍﺕیﻝیﻭ
attilla	ﺍﺕیﻝﺍ
attlee	ﺍﺕﺕﻝی
atul	ﺍﺕﻭﻝ
atwal	ﺍﺕﻭﺍﻝ
atwater	ﺍﺕﻭﺍﺕﺭ
atwood	ﺍﺕﻭﺩ
aubrie	ﺍﻭﺏﺭی
aucellina	ﺍﻭﺱﻝیﻥﺍ
auckland	ﺍکﻝﻥﺩ
audley	ﺍﺩﻝی
audra	ﺍﻭﺩﺭﺍ
audrey	ﺍﻭﺩری
audun	ﺍﻭﺩﻭﻥ
auga	ﺍﻭگﺍ
augen	ﺍﻭﺝﻥ
auger	ﺍگر
augor	ﺍگر
august	ﺍﻭگﻭﺱﺕ
auguste	ﺍﻭگﻭﺱﺕی
augustin	ﺍگﻭﺱﺕیﻥ
augustine	ﺍگﻭﺱﺕیﻥ
augusto	ﺍگﻭﺱﺕﻭ
augustyn	ﺍگﻭﺱﺕیﻥ
auker	ﺍﻭکﺭ
auld	ﺍﻭﻝﺩ
auldridge	ﺍﻝﺩریگ
auley	ﺍﻭﻝی
aurand	ﺍﺭﺍﻥﺩ
aurdalen	ﺍﻭﺭﺩﺍﻝﻥ
aureole	ﺍﻭﺭیﻭﻝی
aurho	ﺍﻭﺭﻩﻭ
auriga	ﺍﻭﺭیگﺍ
aurnupen	ﺍﻭﺭﻥﻭپﻥ
auslander	ﺍﻭﺱﻝﺍﻥﺩﺭ
auslin	ﺍﻭﺱﻝیﻥ
auster	ﺍﻭﺱﺕر
austern	ﺍﺱﺕﺭﻥ
austin	ﺍﺱﺕیﻥ
austkampane	ﺍﻭﺱﺕکﻡپﺍﻥی
austrian	ﺍﺱﺕﺭیﻥ
austvollen	ﺍﻭﺱﺕﻭﻝیﻥ
austvorren	ﺍﻭﺱﺕﻭﺭیﻥ
authur	ﺍﻭﺕﻭر
auyeung	ﺍیﻥگ
aveling	ﺍﻭﻝیﻥگ
averie	ﺍﻭری
averies	ﺍﻭریز
averill	ﺍﻭریﻝ
averis	ﺍﻭریﺱ
aversa	ﺍﻭیﺭﺱﺍ
avery	ﺍﻭری
averye	ﺍﻭری
avian	ﺍﻭیﺍﻥ
aviation	ﺍﻭیﺍﺵﻥ
aviator	ﺍﻭیﺍﺕﻭﺭ
avicenna	ﺍﻭیﺱﻥﺍ
avichay	ﺍﻭیچﺍی
avinash	ﺍﻭیﻥﺍﺵ
avins	ﺍﻭیﻥﺱ
avis	ﺍﻭیﺱ
aviva	ﺍﻭیﻭﺍ
avniel	ﺍﻭﻥیﻝ
avolio	ﺍﻭﻭﻝیﻭ
avra	ﺍﻭرﺍ
avraham	ﺍﻭﺭﺍﻩﺍﻡ
avrum	ﺍﻭﺭﻭﻡ
awadia	ﺍﻭﺍﺩیﺍ
awan	ﺍﻭﺍﻥ
awel	ﺍﻭﻝ
awketts	ﺍکﺕﺱ
awl	ﺍﻭﻝ
awtrey	ﺍﻭﺕﺭی
axe	ﺍکﺱ
axel	ﺍکﺱیﻝ
axelsson	ﺍکﺱﻝﺱﻭﻥ
axford	ﺍکﺱﻑرﺩ
axthelm	ﺍکﺱﺩﻝﻡ
ayah	ﺍیﺍﻩ
ayari	ﺍیﺍری
ayaz	ﺍیﺍﺯ
ayckbourn	ﺍکﺏﻭرﻥ
aycock	ﺍیکﻭک
ayda	ﺍیﺩﺍ
ayen	ﺍیﻥ
ayers	ﺍیرز
ayishah	ﺍییﺵﺍﻩ
ayling	ﺍیﻝیﻥ
aylward	ﺍیﻝﻭﺍﺭﺩ
ayman	ﺍیﻡﺍﻥ
ayn	ﺍیﻥ
ayson	ﺍیﺱﻭﻥ
ayush	ﺍیﻭﺵ
ayuso	ﺍیﻭﺱﻭ
azad	ﺍﺯﺍﺩ
azalea	ﺍزﺍﻝی
azhar	ﺍزﻩر
azimuth	ﺍﺯیﻡﻭﺕ
aziz	ﻉﺯیﺯ
azlan	ﺍﺯﻝﻥ
aztec	ﺍﺯﺕک
azure	ﺍﺯﻭﺭ
baabar	ﺏﺍﺍﺏﺍر
baback	ﺏﺍﺏک
babak	ﺏﺍﺏک
babar	ﺏﺍﺏﺍﺭ
babel	ﺏﺍﺏﻝ
babikow	ﺏﺍﺏیکﻭ
babil	ﺏﺍﺏیﻝ
babis	ﺏﺍﺏیﺱ
babitz	ﺏﺍﺏیﺕﺯ
babordsranten	ﺏﺍﺏﻭرﺩﺱرﺍﻥﺕﻥ
babs	ﺏﺍﺏﺱ
babu	ﺏﺍﺏﻭ
baburao	ﺏﺍﺏﻭﺭﺍﻭ
babushkin	ﺏﺍﺏﻭﺵکیﻥ
baby	ﺏیﺏی
bacar	ﺏکر
baccus	ﺏﺍکﻭﺱ
bachand	ﺏﺍچﺍﻥﺩ
bacharach	ﺏﺍچﺍﺭﺍچ
bachelor	ﺏچﻝر
bachus	ﺏﺍچﺍﺱ
back	ﺏک
backas	ﺏﺍکﺍﺱ
backdoor	ﺏکﺩﻭﺭ
backer	ﺏکﺭ
backhurst	ﺏکﻩﻭﺭﺱﺕ
backman	ﺏکﻡﻥ
backof	ﺏکﻭﻑ
backway	ﺏکﻭی
bacon	ﺏیکﻭﻥ
badcock	ﺏﺍﺩکک
badeloch	ﺏﺍﺩﻝﻭچ
baden	ﺏﺍﺩیﻥ
bader	ﺏیﺩر
baderman	ﺏﺍﺩﺭﻡﻥ
badger	ﺏﺍﺝر
badian	ﺏﺩیﻥ
badir	ﺏﺩیﺭ
badr	ﺏﺩﺭ
badrak	ﺏﺩﺭک
badrick	ﺏﺍﺩریک
badry	ﺏﺩﺭی
baefje	ﺏیﺝ
baertie	ﺏرﺕی
baffle	ﺏﺍﻑﻝ
baggarly	ﺏﺍگﺍﺭﻝی
bagger	ﺏگﺭ
baghdad	ﺏﻍﺩﺍﺩ
bagley	ﺏگﻝی
bagnall	ﺏگﻥﺍﻝ
bagnold	ﺏگﻥﻭﻝﺩ
bagshawe	ﺏﺍگﺵﺍﻭ
baguley	ﺏﺍگﻭﻝی
bagwill	ﺏگﻭیﻝ
bahamonde	ﺏﻩﺍﻡﻥﺩ
bai	ﺏﺍی
bailey	ﺏیﻝی
bailin	ﺏﺍیﻝیﻥ
baillie	ﺏﺍیﻝی
baillieu	ﺏﺍیﻝیﻭ
bain	ﺏیﻥ
baines	ﺏیﻥﺯ
bainmedart	ﺏیﻥﻡﺩﺍﺭﺕ
bains	ﺏیﻥﺯ
bair	ﺏﺍیر
bajic	ﺏﺍﺝیک
bajwa	ﺏﺍﺝﻭﺍ
bakaya	ﺏﺍکﺍیﺍ
baken	ﺏیکﻥ
bakeneset	ﺏیکﻥﺱﺕ
baker	ﺏکﺭ
bakewell	ﺏیکﻭﻝ
bakhoum	ﺏﺍخﻭﻡ
bakkum	ﺏکﺍﻡ
bakos	ﺏﺍکﻭﺱ
bakshi	ﺏکﺵی
bakun	ﺏﺍکﺍﻥ
bakutis	ﺏﺍکﻭﺕیﺱ
balarie	ﺏﺍﻝﺍﺭی
balash	ﺏﺍﻝﺍﺵ
balaye	ﺏﻝﺍیی
balbir	ﺏﺍﻝﺏیﺭ
balchen	ﺏﺍﻝچﻥ
balchunas	ﺏﺍﻝچﻭﻥﺍﺱ
bald	ﺏﺍﻝﺩ
baldington	ﺏﺍﺩیﻥگﺕﻥ
baldred	ﺏﺍﻝﺩﺭﺩ
baldur	ﺏﺍﻝﺩﻭﺭ
baldwin	ﺏﺍﺩﻭیﻥ
bale	ﺏﺍﻝ
baleine	ﺏﺍﻝیﻥ
balendra	ﺏﺍﻝﻥﺩﺭﺍ
balfanz	ﺏﺍﻝﻑﻥﺯ
balham	ﺏﺍﻝﻩﺍﻡ
bali	ﺏﺍﻝی
baliga	ﺏﺍﻝیگﺍ
balike	ﺏﺍﻝیک
balish	ﺏﺍﻝیﺵ
balit	ﺏﺍﻝیﺕ
ball	ﺏﺍﻝ
ballantine	ﺏﺍﻝﺍﻥﺕیﻥ
ballard	ﺏﺍﻝﺍرﺩ
ballast	ﺏﺍﻝﺍﺱﺕ
ballenden	ﺏﺍﻝﺍﻥﺩﻥ
ballentine	ﺏﺍﻝﻥﺕیﻥ
balleny	ﺏﺍﻝﻥی
ballim	ﺏﺍﻝیﻡ
bally	ﺏﺍﻝی
balma	ﺏﺍﻝﻡﺍ
balog	ﺏﺍﻝﻭگ
balogh	ﺏﺍﻝﻭگ
balqa	ﺏﺍﻝکﺍ
balsam	ﺏﺍﻝﺱﺍﻡ
balsley	ﺏﺍﻝﺱﻝی
balson	ﺏﺍﻝﺱﻭﻥ
baltais	ﺏﺍﻝﺕﺍیﺱ
baltaxe	ﺏﺍﻝﺕﺍکﺱ
balter	ﺏﺍﻝﺕر
balthazar	ﺏﺍﻝﺕﺍزﺍر
baltje	ﺏﺍﻝﺕ
baltzell	ﺏﺍﻝﺕﺯﻝ
balu	ﺏﺍﻝﻭ
bamnolker	ﺏﺍﻡﻥﻭﻝکر
bamse	ﺏﺍﻡﺱی
banan	ﺏﻥﺍﻥ
bancroft	ﺏﺍﻥکﺭﺍﻑﺕ
banda	ﺏﺍﻥﺩﺍ
bandali	ﺏﻥﺩﻝی
banded	ﺏﺍﻥﺩﺩ
banderob	ﺏﻥﺩﺭﻭﺏ
bandi	ﺏﺍﻥﺩی
bandireddi	ﺏﺍﻥﺩیﺭﺩی
bandstone	ﺏﻥﺩﺍﺱﺕﻭﻥ
bandung	ﺏﻥﺩﺍﻥگ
bandy	ﺏﻥﺩی
bang	ﺏﻥگ
banik	ﺏﻥیک
bank	ﺏﺍﻥک
banker	ﺏﻥکﺭ
banks	ﺏﺍﻥکﺱ
bankwalla	ﺏﺍﻥکﻭﺍﻝﺍ
banna	ﺏﺍﻥﺍ
banton	ﺏﺍﻥﺕﻭﻥ
bao	ﺏﺍﻭ
baptist	ﺏﺍپﺕیﺱﺕ
baptista	ﺏﺍپﺕیﺱﺕﺍ
baqir	ﺏکیر
bar	ﺏﺍﺭ
barakah	ﺏرکﺍ
barakam	ﺏﺍرﺍکﺍﻡ
barakat	ﺏرکﺍﺕ
baral	ﺏﺍﺭﺍﻝ
barash	ﺏﺍﺭﺵ
barb	ﺏﺍﺭﺏ
barbagallo	ﺏﺍﺭﺏﺍگﺍﻝﻭ
barbara	ﺏﺍرﺏﺍرﺍ
barbas	ﺏﺍﺭﺏﺍﺱ
barber	ﺏﺍﺭﺏﺭ
barbour	ﺏﺍﺭﺏﻭﺭ
barclay	ﺏﺍرکﻝی
barcroft	ﺏﺍﺭکﺭﺍﻑﺕ
barculo	ﺏﺍرکﺍﻝﻭ
barcus	ﺏﺍﺭکﻭﺱ
bard	ﺏﺍﺭﺩ
bardell	ﺏﺍﺭﺩﻝ
bare	ﺏیﺭ
bareback	ﺏیﺭﺏک
barela	ﺏیﺭﻝﺍ
barenbrug	ﺏﺍرﻥﺏرﻭگ
barend	ﺏﺍﺭﻥﺩ
barfield	ﺏﺍرﻑیﻝﺩ
barford	ﺏرﻑﻭرﺩ
bargh	ﺏﺭﻕ
bargiel	ﺏﺍﺭﺝیﻝ
bari	ﺏﺍﺭی
bariaux	ﺏﺍﺭیﺍکﺱ
barich	ﺏیﺭیچ
barilari	ﺏﺍریﻝﺍری
bark	ﺏﺍﺭک
barkai	ﺏﺍﺭکﺍی
barkell	ﺏﺍﺭکﻝ
barker	ﺏﺍﺭکﺭ
barkley	ﺏﺍﺭکﻝی
barkov	ﺏﺍرکﻑ
barksdale	ﺏﺍﺭکﺱﺩیﻝی
barksfield	ﺏرکﺱﻑیﻝﺩ
barkus	ﺏرکﺱ
barlas	ﺏﺍﺭﻝﺍﺱ
barlow	ﺏرﻝﻭ
barman	ﺏﺍﺭﻡﻥ
barn	ﺏﺍﺭﻥ
barnaby	ﺏﺍﺭﻥﺍﺏی
barnard	ﺏرﻥﺍرﺩ
barnas	ﺏﺍﺭﻥﺍﺱ
barne	ﺏﺍﺭﻥ
barnett	ﺏﺍﺭﻥﺕ
barnewall	ﺏرﻥﻭﺍﻝ
barney	ﺏﺍﺭﻥی
barnhart	ﺏﺭﻥﻩﺍﺭﺕ
barnshaw	ﺏرﺵﺍﻭ
barnum	ﺏﺍﺭﻥﺍﻡ
barnwell	ﺏﺭﻥﻭﻝ
baron	ﺏﺍﺭﻥ
barone	ﺏﺍﺭﻭﻥ
baroness	ﺏﺍﺭﻭﻥﺱ
baronia	ﺏﺍﺭﻭﻥیﺍ
baronick	ﺏﺍﺭﻥیک
barraby	ﺏﺭﺍﺏی
barracouta	ﺏﺍﺭﺍکﻭﺕﺍ
barratt	ﺏرﺍﺕ
barrel	ﺏﺍﺭﻝ
barren	ﺏﺍﺭﻥ
barrera	ﺏﺍررﺍ
barrero	ﺏﺍﺭﺭﻭ
barrese	ﺏﺍرﺱ
barrey	ﺏﺍﺭی
barrie	ﺏﺍﺭی
barrier	ﺏﺭیﺭ
barringer	ﺏﺍﺭیﻥگﺭ
barrington	ﺏریﻥگﺕﻥ
barris	ﺏﺍریﺱ
barron	ﺏﺍرﻭﻥ
barroso	ﺏﺍﺭﺍﺱﻭ
barroux	ﺏﺍﺭﻭکﺱ
barrow	ﺏﺭﻭ
barsai	ﺏﺍﺭﺱی
barsse	ﺏﺍﺭﺱﻩ
bart	ﺏﺍرﺕ
bartelle	ﺏﺍﺭﺕﻝ
bartelmus	ﺏﺍرﺕﻝﻡﺍﺱ
bartelt	ﺏﺍﺭﺕﻝﺕ
barter	ﺏﺍرﺕر
barth	ﺏﺍﺭث
barthe	ﺏﺍﺭﺕی
barthel	ﺏﺍرﺕﻝ
bartholin	ﺏﺍﺭﺕﻝیﻥ
bartholomeus	ﺏﺍرﺕﻩﻭﻝﻭﻡیﻭﺱ
bartle	ﺏﺍﺭﺕﻝ
bartlett	ﺏرﺍﺕﻝﺕ
bartley	ﺏﺍﺭﺕﻝی
bartok	ﺏﺍﺭﺕک
bartolini	ﺏﺍﺭﺕﻭﻝیﻥی
barton	ﺏﺍﺭﺕﻥ
bartonico	ﺏﺍﺭﺕﻭﻥیکﻭ
bartrum	ﺏﺍرﺕرﻭﻡ
bartz	ﺏﺍﺭﺕﺯ
barua	ﺏﺍﺭﻭﺍ
baruch	ﺏﺍﺭﻭچ
barve	ﺏﺍرﻭی
barvels	ﺏﺍرﻭﻝﺱ
bary	ﺏری
bas	ﺏﺍﺱ
basaran	ﺏﺍﺱﺍرﺍﻥ
basbolken	ﺏﺍﺱﺏﻝکﻥ
basecamp	ﺏیﺱکﻡپ
basem	ﺏیﺱﻡ
basha	ﺏﺍﺵﺍ
basher	ﺏﺍﺵﺭ
bashford	ﺏﺍﺵﻑﻭرﺩ
basilica	ﺏﺍﺱیﻝیکﺍ
basilisk	ﺏﺍﺱیﻝیﺱک
basilius	ﺏﺍﺱیﻝیﻭﺱ
basim	ﺏﺱیﻡ
basir	ﺏﺱیر
basira	ﺏﺱیرﺍ
basit	ﺏﺱیط
baskar	ﺏﺍﺱکﺍﺭ
baskerville	ﺏﺍﺱکﺭﻭیﻝ
baskett	ﺏﺱکﺕ
baskette	ﺏﺱکﺕ
baskin	ﺏﺍﺱکیﻥ
basler	ﺏﺍﺱﻝﺭ
basrah	ﺏﺱرﺍ
basse	ﺏیﺱﻩ
bassel	ﺏیﺱﻝ
bassem	ﺏﺱیﻡ
bassett	ﺏﺍﺱﺕ
bassle	ﺏﺍﺱﻝ
basso	ﺏﺍﺱﻭ
basson	ﺏﺍﺱﻥ
bastard	ﺏﺍﺱﺕﺍﺭﺩ
basterfield	ﺏﺍﺱﺕﺭﻑیﻝﺩ
bastien	ﺏﺍﺱﺕیﻥ
bastion	ﺏﺍﺱﺕیﻥ
basu	ﺏﺍﺱﻭ
bat	ﺏﺍﺕ
bataille	ﺏﺍﺕیﻝ
batel	ﺏﺍﺕﻝ
bateman	ﺏیﺕﻡﻥ
bates	ﺏیﺕز
bathurst	ﺏﺍﺕﺭﺱﺕ
batish	ﺏﺍﺕیﺵ
batra	ﺏﺍﺕﺭﺍ
battah	ﺏﺕﺍﻩ
battan	ﺏﺍﺕﺍﻥ
battey	ﺏﺍﺕی
battle	ﺏﺍﺕﻝ
battlements	ﺏﺍﺕﻝﻡﻥﺕﺱ
batu	ﺏیﺕﻭ
baucom	ﺏﺍکﻭﻡ
baudin	ﺏﺍﻭﺩیﻥ
baudissin	ﺏﺍﻭﺩیﺱیﻥ
baudouin	ﺏﺍﻭﺩﻭییﻥ
bauer	ﺏﺍیر
bauffin	ﺏیﻭﻑیﻥ
baugham	ﺏیﻭگﺍﻡ
baughman	ﺏﺍﻭگﻡﻥ
baukus	ﺏﺍﻭکﻭﺱ
baulch	ﺏﺍﻭﻝچ
baumann	ﺏﺍﻭﻡﻥ
baumberger	ﺏﺍﻡﺏﺭگﺭ
baumer	ﺏﺍﻭﻡر
baumgartner	ﺏﺍﻭﻡگﺍﺭﺕﻥﺭ
baupres	ﺏﺍﻭپﺭﺱ
bawa	ﺏﺍﻭﺍ
bawcom	ﺏﺍﻭکﺍﻡ
bawden	ﺏﺍﻭﺩﻥ
baxter	ﺏﺍکﺱﺕﺭ
bay	ﺏی
bayard	ﺏﺍیﺍﺭﺩ
bayda	ﺏیﺩﺍ
bayern	ﺏﺍیﺭﻥ
bayers	ﺏیﺭﺯ
bayly	ﺏﺍیﻝی
bayse	ﺏیﺯ
bayt	ﺏﺍیﺕ
bazeley	ﺏزﻝی
bazett	ﺏﺍﺯﺕ
bazooka	ﺏﺍﺯﻭکﺍ
bazyar	ﺏﺍﺯیﺍر
bazzano	ﺏﺍﺯﺍﻥﻭ
bdale	ﺏﺩﺍﻝ
bdira	ﺏﺩیﺭﺍ
beach	ﺏیچ
beacham	ﺏیچﺍﻡ
beaches	ﺏیچﺯ
beachley	ﺏیچﻝی
beadles	ﺏیﺩﻝﺯ
beagle	ﺏیگﻝ
beaglehole	ﺏیگﻝﻩﻝ
beakley	ﺏیکﻝی
beale	ﺏیﻝ
beals	ﺏیﻝﺯ
bean	ﺏیﻥ
beane	ﺏیﻥﻩ
beanie	ﺏیﻥی
bear	ﺏیﺭ
bearcat	ﺏﺭکﺍﺕ
beard	ﺏیﺭﺩ
bearden	ﺏیﺭﺩﻥ
beardmore	ﺏیﺭﺩﻡﺭ
beardsley	ﺏﺭﺩﺱﻝی
bearing	ﺏیﺭیﻥگ
bearman	ﺏیﺭﻡﻥ
beartie	ﺏرﺕی
beasley	ﺏیﺱﻝی
beate	ﺏیﺕ
beaton	ﺏیﺕﻥ
beatrice	ﺏیرﺕریک
beattie	ﺏیﺕی
beau	ﺏیﻭ
beauchamp	ﺏیچﻡپ
beaudoin	ﺏیﻭﺩﻭیﻥ
beaufays	ﺏیﻭﻑیﺯ
beaulieu	ﺏیﻭﻝی
beaumont	ﺏیﻭﻡﻥﺕ
beaver	ﺏیﻭﺭ
beavers	ﺏیﻭﺭﺯ
beavis	ﺏیﺍﻭیﺱ
bechard	ﺏیکﺍﺭﺩ
bechaz	ﺏچﺍﺯ
beck	ﺏک
becker	ﺏکﺭ
beckers	ﺏکرﺯ
beckett	ﺏکﺕ
becki	ﺏکی
beckingsale	ﺏکیﻥگﺱیﻝ
beckman	ﺏکﻡﻥ
beckmeyer	ﺏکﻡیﺭ
beckwith	ﺏکﻭیﺕ
beda	ﺏیﺩﺍ
beddow	ﺏیﺩﻭ
bedell	ﺏﺩﻝ
bedichek	ﺏﺩیچک
bednar	ﺏﺩﻥﺍﺭ
bednarz	ﺏﺩﻥﺍﺭﺯ
bee	ﺏی
beeby	ﺏیﺏی
beedle	ﺏیﺩﻝ
beehive	ﺏیﻩیﻭ
beeler	ﺏیﻝیﺭ
beelzibub	ﺏیﻝﺯیﺏﺍﺏ
beer	ﺏیﺭ
beers	ﺏیرﺯ
beet	ﺏیﺕ
beethoven	ﺏﺕﻩﻭﻥ
beguelin	ﺏیگﻭﻝیﻥ
beh	ﺏﻩ
behara	ﺏﻩﺍﺭﺍ
behcet	ﺏﻩﺱﺕ
behm	ﺏﻩﻡ
behnam	ﺏﻩﻥﺍﻡ
behrens	ﺏﻩرﻥﺯ
beighton	ﺏیﺕﻥ
beirut	ﺏیرﻭﺕ
bekis	ﺏکیﺱ
bekki	ﺏکی
bela	ﺏﻝﺍ
belani	ﺏﻝﺍﻥی
belding	ﺏﻝﺩیﻥگ
belenky	ﺏﻝﻥکی
belk	ﺏﻝک
bell	ﺏﻝ
bellamy	ﺏﻝﺍﻡی
bello	ﺏﻝﻭ
bellomy	ﺏﻝﺍﻡی
beltrao	ﺏﻝﺕﺭﺍﻭ
bemina	ﺏﻡیﻥﺍ
ben	ﺏﻥ
benamar	ﺏﻥﺍﻡﺍﺭ
benari	ﺏﻥﺍﺭی
benavides	ﺏﻥﺍﻭﺍیﺩﺯ
benaya	ﺏﻥﺍیﺍ
bendek	ﺏﻥﺩک
bender	ﺏﻥﺩﺭ
bene	ﺏﻥﻩ
benet	ﺏﻥﺕ
beng	ﺏﻥگ
benge	ﺏﻥگ
benger	ﺏﻥگﺭ
bengt	ﺏﻥگﺕ
beniamin	ﺏﻥیﺍﻡیﻥ
benigno	ﺏﻥیگﻥﻭ
benjamins	ﺏﻥﺝﺍﻡیﻥﺯ
benjiman	ﺏﻥﺝیﻡﺍﻥ
benka	ﺏﻥکﺍ
benker	ﺏﻥکﺭ
benko	ﺏﻥکﻭ
bennet	ﺏﻥﺕ
bennie	ﺏﻥی
bennion	ﺏﻥیﻭﻥ
benno	ﺏﻥﻭ
benny	ﺏﻥی
benoit	ﺏﻥﻭیﺕ
bense	ﺏﻥﺱ
bensen	ﺏﻥﺱﻥ
benson	ﺏﻥﺱﻥ
benten	ﺏﻥﺕﻥ
bentley	ﺏﻥﺕﻝی
benton	ﺏﻥﺕﻥ
bentow	ﺏﻥﺕﻭ
bentz	ﺏﻥﺕﺯ
benz	ﺏﻥﺯ
benzene	ﺏﻥﺯﻥ
berardi	ﺏﺭﺍﺭﺩی
bercovich	ﺏﺭکﻭﻭیچ
berend	ﺏﺭﻥﺩ
berends	ﺏﺭﻥﺩﺱ
beresford	ﺏﺭﺱﻑﻭﺭﺩ
beresh	ﺏﺭﺵ
bereza	ﺏﺭیﺯﺍ
berg	ﺏﺭگ
bergan	ﺏرگﺍﻥ
bergel	ﺏﺭگﻝ
bergen	ﺏرگﻥ
bergeot	ﺏﺭگیﻭﺕ
berger	ﺏﺭگﺭ
berglund	ﺏﺭگﻝﺍﻥﺩ
bergmann	ﺏرگﻡﺍﻥ
berilla	ﺏﺭیﻝﺍ
berin	ﺏﺭیﻥ
beris	ﺏﺭیﺱ
berislav	ﺏﺭﺍیﺱﻝﺍﻭ
berk	ﺏﺭک
berkema	ﺏﺭکﻡﺍ
berkemeier	ﺏﺭکﻡیﺭ
berkey	ﺏﺭکی
berkley	ﺏﺭکﻝی
berkling	ﺏﺭکﻝیﻥگ
berlin	ﺏﺭﻝیﻥ
berlingeri	ﺏرﻝیﻥگری
berlocher	ﺏﺭﻝﺍچﺭ
berman	ﺏﺭﻡﻥ
bermel	ﺏﺭﻡﻝ
bermes	ﺏﺭﻡﺱ
bernadus	ﺏﺭﻥﺍﺩﻭﺱ
bernal	ﺏﺭﻥﺍﻝ
bernard	ﺏﺭﻥﺍﺭﺩ
bernardi	ﺏﺭﻥﺍﺭﺩی
bernardin	ﺏﺭﻥﺍﺭﺩیﻥ
bernardo	ﺏﺭﻥﺍﺭﺩﻭ
bernards	ﺏﺭﻥﺍﺭﺩﺯ
bernatz	ﺏرﻥﺍﺕﺯ
bernd	ﺏﺭﻥﺩ
bernhard	ﺏﺭﻥﻩﺍﺭﺩ
bernhardt	ﺏﺭﻥﻩﺍﺭﺕ
bernher	ﺏﺭﻥﻩﺭ
bernie	ﺏﺭﻥی
bernier	ﺏﺭﻥیﺭ
berno	ﺏﺭﻥﻭ
bernt	ﺏﺭﻥﺕ
berry	ﺏﺭی
berster	ﺏﺭﺱﺕﺭ
bert	ﺏرﺕ
bertil	ﺏرﺕیﻝ
berton	ﺏﺭﺕﻭﻥ
bertram	ﺏرﺕرﺍﻡ
bertrand	ﺏﺭﺕﺭﺍﻥﺩ
beryl	ﺏﺭیﻝ
beryman	ﺏریﻡﻥ
besam	ﺏﺱﺍﻡ
besancon	ﺏﺱﺍﻥکﻭﻥ
besko	ﺏﺱکﻭ
best	ﺏﺱﺕ
beth	ﺏﺕ
bethan	ﺏﺕﺍﻥ
bethancourt	ﺏیﺕﺍﻥکﺭﺕ
bethel	ﺏﺕﻝ
beti	ﺏﺕی
betsworth	ﺏﺕﺱﻭرث
betsy	ﺏﺕﺱی
bettina	ﺏﺕیﻥﺍ
bettio	ﺏﺕییﻭ
betts	ﺏﺕﺯ
betty	ﺏﺕی
betz	ﺏﺕﺯ
betza	ﺏﺕﺯﺍ
beuken	ﺏﻭکﻥ
beulah	ﺏیﻭﻝﺍ
beusee	ﺏیﻭﺱﻩ
beutel	ﺏیﻭﺕﻝ
beutler	ﺏﻭﺕﻝﺭ
beutling	ﺏیﺍﺕﻝیﻥگ
bev	ﺏﻭ
bevan	ﺏیﻭﺍﻥ
beveridge	ﺏﻭﺭیﺝ
beverly	ﺏیﻭﺭﻝی
bevis	ﺏﻭیﺱ
bewick	ﺏیﻭیک
bex	ﺏکﺱ
beyhan	ﺏیﻩﺍﻥ
beyl	ﺏیﻝ
bezdek	ﺏیﺯﺩک
bian	ﺏیﺍﻥ
bible	ﺏیﺏﻝ
bich	ﺏیچ
bick	ﺏیک
bickerstaffe	ﺏیکرﺍﺱﺕیﻑ
bickerton	ﺏیکﺭﺕﻥ
bidmead	ﺏیﺩﻡیﺩ
bidwell	ﺏیﺩﻭﻝ
bielecki	ﺏیﻝکی
bieler	ﺏیﻝﺭ
bielska	ﺏیﻝﺱکﺍ
bienfang	ﺏیﻥﻑﻥگ
bierl	ﺏﺍیرﻝ
bierling	ﺏﺭﻝیﻥگ
biess	ﺏیﺱ
biff	ﺏیﻑ
bifrost	ﺏیﻑﺭﺍﺱﺕ
big	ﺏیگ
bigelow	ﺏیگﻝﻭ
bigend	ﺏیگﻥﺩ
bigenwald	ﺏیگﻥﻭﺍﻝﺩ
biggar	ﺏیگﺍﺭ
biggs	ﺏیگﺯ
bight	ﺏﺍیﺕ
bigo	ﺏیگﻭ
bigourdan	ﺏیگﻭﺭﺩﺍﻥ
bijal	ﺏیﺝﺍﻝ
bik	ﺏیک
bilal	ﺏیﻝﺍﻝ
bilhar	ﺏیﻝﻩﺍﺭ
billany	ﺏیﻝﺍﻥی
billings	ﺏیﻝیﻥگﺯ
billingsley	ﺏیﻝیﻥگﺍﺱﻝﺍی
billington	ذیﻝیﻥگﺕﻥ
billo	ﺏیﻝﻭ
bills	ﺏیﻝﺯ
billy	ﺏیﻝی
billycock	ﺏیﻝیکﻭک
bilson	ﺏیﻝﺱﻭﻥ
bin	ﺏیﻥ
binay	ﺏیﻥی
bindemann	ﺏیﻥﺩﻡﻥ
bines	ﺏیﻥﺱ
bing	ﺏیﻥگ
binion	ﺏیﻥییﻭﻥ
binn	ﺏیﻥ
binner	ﺏیﻥﺭ
binnie	ﺏیﻥی
binns	ﺏیﻥﺯ
binod	ﺏیﻥﻭﺩ
binu	ﺏیﻥﺍ
biocca	ﺏیﻭکﺍ
biocroft	ﺏیﻭکﺭﺍﻑﺕ
biol	ﺏییﻭﻝ
bionic	ﺏییﻭﻥیک
bipin	ﺏیپیﻥ
bippert	ﺏﺍیپﺭﺕ
birch	ﺏیﺭچ
birdsong	ﺏﺭﺩﺱﺍﻥگ
birenboim	ﺏیﺭﻥﺏﻭیﻡ
birge	ﺏیﺭگ
birgel	ﺏیﺭگﻝ
birk	ﺏیﺭک
birkett	ﺏیرکﺕ
birrell	ﺏیﺭﻝ
bishko	ﺏیﺵکﻭ
bismarck	ﺏیﺱﻡﺍﺭک
bissau	ﺏیﺱﺍیﻭ
bisset	ﺏیﺱﺕ
bissett	ﺏیﺱﺕ
bistak	ﺏیﺯﺕﺍک
biswanath	ﺏیﺯﻭﺍﻥﺍﺕ
biswas	ﺏیﺯﻭﺍﺱ
bittard	ﺏیﺕﺍﺭﺩ
bitz	ﺏیﺕﺯ
bixler	ﺏیکﺱﻝﺭ
bizer	ﺏیﺯﺭ
blachford	ﺏﻝﺍچﻑﻭﺭﺩ
black	ﺏﻝک
blackley	ﺏﻝکﻝی
blackman	ﺏﻝکﻡﻥ
blacksher	ﺏﻝکﺵیﺭ
blackwell	ﺏﻝکﻭﻝ
blade	ﺏﻝیﺩ
blaha	ﺏﻝﺍﻩﺍ
blaik	ﺏﻝیک
blain	ﺏﻝیﻥ
blaine	ﺏﻝیﻥ
blakeman	ﺏﻝکﻡﻥ
blakemore	ﺏﻝکﻡﻭر
blal	ﺏﻝﺍﻝ
blalock	ﺏﻝﺍﻝﺍک
blanchard	ﺏﻝﺍﻥچﺍﺭﺩ
blanche	ﺏﻝﺍﻥچﻩ
blanchet	ﺏﻝﺍﻥچﺕ
blane	ﺏﻝیﻥ
blank	ﺏﻝﻥک
blanstan	ﺏﻝﺍﻥﺱﺕﺍﻥ
blas	ﺏﻝﺱ
blasi	ﺏﻝﺍﺱی
blasius	ﺏﻝﺍﺱیﻭﺱ
blask	ﺏﻝﺍﺱک
blatt	ﺏﻝﺕ
blatta	ﺏﻝیﺕﺍ
blattberg	ﺏﻝﺕﺏﺭگ
blatter	ﺏﻝﺍﺕر
blavatnik	ﺏﻝﺍﻭﺍﺩﻥیک
blaz	ﺏﻝﺍﺯ
blaze	ﺏﻝیﺯ
blazek	ﺏﻝﺍﺯک
blazquez	ﺏﻝﺍﺯکییﻭﺯ
bleier	ﺏﻝیﺭ
blencowe	ﺏﻝیﻥکﻭ
blinco	ﺏﻝیﻥکﻭ
bliss	ﺏﻝیﺱ
blitz	ﺏﻝیﺕﺯ
blitzer	ﺏﻝیﺕﺯﺭ
bliznakov	ﺏﻝیﺯﻥﺍکﻭﻑ
bloch	ﺏﻝﺍچ
block	ﺏﻝﺍک
blokland	ﺏﻝکﻝﻥﺩ
blom	ﺏﻝﺍﻡ
bloomberg	ﺏﻝﻭﻡﺏﺭگ
blorenge	ﺏﻝﻭﺭﻥﺝ
bloxom	ﺏﻝکﺱﻭﻡ
blue	ﺏﻝﻭ
bluff	ﺏﻝﺍﻑ
bluffs	ﺏﻝﺍﻑﺱ
blum	ﺏﻝﺍﻡ
blumcke	ﺏﻝﺍﻡکﻩ
blumen	ﺏﻝﻭﻡﻥ
blumenthal	ﺏﻝﻭﻡﻥﺕﺍﻝ
blumer	ﺏﻝﻭﻡر
blunsdon	ﺏﻝﺍﺱﺩﻥ
blystone	ﺏﻝیﺱﺕﻭﻥ
blyth	ﺏﻝﺍیﺕ
blyweiss	ﺏﻝیﻭیﺱ
boak	ﺏﻭک
boat	ﺏﻭﺕ
boaz	ﺏﻭﺯ
bob	ﺏﺍﺏ
bobak	ﺏﻭﺏﺍک
bobbi	ﺏﺍﺏی
bobbie	ﺏﺍﺏی
bobbish	ﺏﻭﺏیﺵ
bobbitt	ﺏﺏیﺕ
bobby	ﺏﺍﺏی
bobe	ﺏﺍﺏ
bobo	ﺏﺍﺏﻭ
bocci	ﺏﻭﺱی
bockoven	ﺏﻭکﻭﻥ
bocock	ﺏکﻭک
bocska	ﺏﺍکﺱکﺍ
bode	ﺏﻭﺩ
boden	ﺏﻭﺩﻥ
bodenmiller	ﺏﻭﺩﻥﻡیﻝﺭ
bodla	ﺏﻭﺩﻝﺍ
bodman	ﺏﺍﺩﻡﻥ
bodnar	ﺏﻭﺩﻥﺍر
bodo	ﺏﻭﺩﻭ
bodony	ﺏﺍﺩﻭﻥی
bogaard	ﺏﻭگﺍﺭﺩ
bogdan	ﺏﺍگﺩﻥ
bogdon	ﺏﺍگﺩﺍﻥ
bogstad	ﺏﻭگﺱﺕﺍﺩ
boisseau	ﺏﻭیﺱیﻭ
boisvieux	ﺏﻭیﺱﻭیکﺱ
boisy	ﺏﻭیﺯی
boivin	ﺏﻭیﻭﻥ
boker	ﺏﻭکﺭ
bol	ﺏﺍﻝ
bolden	ﺏﻝﺩﻥ
boldt	ﺏﻭﻝﺩﺕ
boldwijn	ﺏﻝﺩﻭییﻥ
bolecek	ﺏﺍﻝﺱک
bolef	ﺏﻭﻝﻑ
bolen	ﺏﻭﻝﻥ
bolinder	ﺏﺍﻝﺍﻥﺩﺭ
bolla	ﺏﻭﻝﺍ
bolson	ﺏﺍﻝﺱﻭﻥ
bolstad	ﺏﻭﻝﺱﺕﺍﺩ
bolz	ﺏﻭﻝﺯ
boman	ﺏﻭﻡﺍﻥ
bomberger	ﺏﻭﻡﺏﺭگﺭ
bombet	ﺏﻡﺏﺕ
bomhard	ﺏﻭﻡﻩﺍﺭﺩ
bommen	ﺏﺍﻡﻥ
bon	ﺏﺍﻥ
bonacci	ﺏﻥﺍکﺱی
bonander	ﺏﻭﻥﺍﻥﺩﺭ
bonar	ﺏﻭﻥﺍﺭ
bonavoglia	ﺏﻭﻥﺍﻭگﻝیﺍ
bond	ﺏﺍﻥﺩ
bongard	ﺏﻭﻥگﺍﺭﺩ
bongarts	ﺏﺍﻥگﺍﺭﺕﺯ
bonifaas	ﺏﻥیﻑﺍﺱ
bonifacius	ﺏﻥیﻑﺍﺱیﻭﺱ
bonin	ﺏﻥیﻥ
bonita	ﺏﺍﻥیﺕﺍ
bonito	ﺏﺍﻥیﺕﻭ
bonitz	ﺏﻭﻥیﺕﺯ
bonnell	ﺏﺍﻥﻝ
bonner	ﺏﺍﻥﺭ
bonney	ﺏﺍﻥی
bonni	ﺏﺍﻥی
bonnie	ﺏﻭﻥی
bonomo	ﺏﻭﻥﻭﻡﻭ
bononno	ﺏﻭﻥﻭﻥﻭ
bonura	ﺏﺍﻥیﻭﺭﺍ
booby	ﺏﻭﺏی
booey	ﺏﻭﺍی
booher	ﺏﻭﻩﺭ
book	ﺏﻭک
booker	ﺏﻭکر
bool	ﺏﻭﻝ
boon	ﺏﻭﻥ
boonstra	ﺏﻭﻥﺱﺕﺭﺍ
boop	ﺏﻭپ
boora	ﺏﻭﺭﺍ
boose	ﺏﻭﺱ
boot	ﺏﻭﺕ
bootsie	ﺏﻭﺕﺱیﻩ
bop	ﺏﺍپ
bora	ﺏﻭرﺍ
borchert	ﺏﻭﺭچﺭﺕ
borcic	ﺏﻭﺭﺱیک
borden	ﺏﺭﺩﻥ
border	ﺏﻭﺭﺩﺭ
borecki	ﺏﻭﺭکی
borel	ﺏﻭﺭﻝ
borgailo	ﺏﺭگﺍیﻝﻭ
borge	ﺏﻭﺭگﺍ
borgeson	ﺏﺭگﺱﻭﻥ
borione	ﺏﻭﺭیﻭﻥ
boris	ﺏﻭﺭیﺱ
borislav	ﺏﻭریﺱﻝﻭ
boritz	ﺏﻭﺭیﺕﺯ
borland	ﺏﺭﻝﻥﺩ
borm	ﺏﻭﺭﻡ
bormann	ﺏﺭﻡﻥ
bormel	ﺏﻭﺭﻡﻝ
boroson	ﺏﻭرﻭﺱﻥ
borrell	ﺏﻭﺭﻝ
borriello	ﺏﻭﺭیﻝﻝﻭ
borries	ﺏﻭﺭیﺯ
borris	ﺏﻭﺭیﺱ
borrs	ﺏﻭرﺯ
borst	ﺏﻭﺭﺱﺕ
borud	ﺏﻭﺭﺍﺩ
bosak	ﺏﺱﺍک
boschga	ﺏﻭچگﺍ
boshuysen	ﺏﻭﺱﻭیﺱﻥ
bosnia	ﺏﻭﺱﻥی
bossart	ﺏﻭﺱﺍﺭﺕ
bosscha	ﺏﺍﺱﺵﺍ
bosson	ﺏﻭﺱﻭﻥ
bossuyt	ﺏﺍﺱیﺕ
bost	ﺏﻭﺱﺕ
bostak	ﺏﻭﺱﺕﺍک
bostic	ﺏﺍﺱﺕیک
boston	ﺏﻭﺱﺕﻭﻥ
bostrom	ﺏﻭﺱﺕﺭﺍﻡ
bostwick	ﺏﻭﺱﺕیک
boswall	ﺏﺍﺱﻭﺍﻝ
boswell	ﺏﺱﻭﻝ
bot	ﺏﺍﺕ
botari	ﺏﻭﺕﺍﺭی
botez	ﺏﻭﺕﺯ
bottema	ﺏﺕﻡﺍ
bottfeld	ﺏﺍﺕﻑﻝﺩ
botting	ﺏﺍﺕیﻥگ
bottomley	ﺏﺍﺕﻡﻝی
bouali	ﺏﻭﺍﻝی
bouas	ﺏﻭﺍﺱ
boucher	ﺏﺍچﺭ
boudreau	ﺏﻭﺩﺭﻭ
boukhny	ﺏﻭخﻥی
boulis	ﺏﻭﻝیﺯ
boulton	ﺏﻭﻝﺕﻥ
boum	ﺏﻭﻡ
bouneth	ﺏﻭﻥﺕ
bounty	ﺏﺍﻥﺕی
bourcier	ﺏﻭﺭﺱیﺭ
bourgea	ﺏﻭﺭﺝیﺍ
bourgeois	ﺏﻭﺭگیﻭیﺱ
bourland	ﺏﻭرﻝﻥﺩ
bourlon	ﺏﻭﺭﻝﻥ
bouron	ﺏﻭرﻥ
bourque	ﺏﻭﺭگﻭ
bourrie	ﺏﻭریﻩ
bouton	ﺏﻭﺕﻭﻥ
boutte	ﺏﻭﺕ
bouwer	ﺏﻭﺭ
bouwers	ﺏﻭﺭﺯ
bouzid	ﺏﻭﺯیﺩ
bow	ﺏﻭ
bowcott	ﺏﻭکﺍﺕ
bowden	ﺏﺍﻭﺩﻥ
bowen	ﺏﻭﻥ
bowery	ﺏﺍﻭﺭی
bowes	ﺏﻭﺯ
bowie	ﺏﻭی
bowl	ﺏﻭﻝ
bowling	ﺏﻭﻝیﻥگ
bowman	ﺏﻭﻡﻥ
bowyer	ﺏﻭیﺭ
box	ﺏﺍکﺱ
boyd	ﺏﻭیﺩ
boyer	ﺏﺍیﺭ
boyes	ﺏﻭیﺱ
boyko	ﺏﻭیکﻭ
boylan	ﺏﻭیﻝﻥ
boyle	ﺏﻭیﻝ
bozeman	ﺏﻭﺯﻡﺍﻥ
bozhidar	ﺏﻭژیﺩﺍﺭ
bozuwa	ﺏﺯﻭﺍ
brabant	ﺏﺭﺍﺏﺍﻥﺕ
brace	ﺏریﺱ
bracher	ﺏرﺍچر
brachman	ﺏﺭﺍچﻡﻥ
brackney	ﺏﺭﺍکﻥی
brad	ﺏﺭیﺩ
bradbury	ﺏرﺩﺏری
bradely	ﺏﺭﺩﻝی
braden	ﺏﺭﺩﻥ
bradford	ﺏﺭﺩﻑﻭﺭﺩ
bradish	ﺏﺭﺍﺩیﺵ
bradlee	ﺏرﺩﻝی
bradley	ﺏﺭﺍﺩﻝی
bradshaw	ﺏﺭﺍﺩﺵﺍﻭ
brady	ﺏﺭیﺩی
braendle	ﺏﺭﺍﻥﺩﻝ
brafford	ﺏﺭﺍﻑﻭﺭﺩ
bragdon	ﺏﺭگﺩﺍﻥ
braggins	ﺏرﺍگیﻥﺯ
brain	ﺏﺭیﻥ
braithwaite	ﺏﺭﺍیﺕﻭیﺕ
brake	ﺏﺭک
bram	ﺏﺭﺍﻡ
branch	ﺏﺭﻥچ
branchaud	ﺏﺭﻥچﺍﻭﺩ
brand	ﺏﺭﻥﺩ
brandau	ﺏرﺍﻥﺩﺍﻭ
brandeis	ﺏﺭﻥﺩیﺱ
brandel	ﺏﺭﻥﺩﻝ
brandelle	ﺏﺭﻥﺩﻝ
branden	ﺏﺭﻥﺩﻥ
brandt	ﺏﺭﺍﻥﺕ
brannen	ﺏﺭﺍﻥﻥ
branscombe	ﺏﺭﺍﻥﺱکﻭﻡﺏ
branshaw	ﺏﺭﺍﻥﺵﺍﻭ
brant	ﺏﺭﺍﻥﺕ
brar	ﺏﺭﺍﺭ
brashears	ﺏﺭﺍﺵیﺭﺯ
brashers	ﺏﺭﺍﺵﺭﺯ
brasseaux	ﺏرﺍﺱیﻭکﺱ
brat	ﺏﺭﺍﺕ
brater	ﺏﺭﺍﺕﺭ
bratina	ﺏﺭﺍﺕیﻥﺍ
bratlie	ﺏﺭیﺕﻝی
bratu	ﺏرﺍﺕﻭ
bratulic	ﺏرﺍﺕﻭﻝیک
braughton	ﺏﺭﺍﻭﺕﻭﻥ
braun	ﺏﺭﺍیﻭﻥ
braunhut	ﺏﺭﻭﺍﻥﻩﺍﺕ
braunwalder	ﺏﺭﻭﻥﻭﺍﻝﺩﺭ
braverman	ﺏﺭیﻭﺭﻡﻥ
bravo	ﺏﺭﺍﻭﻭ
brawn	ﺏﺭﺍﻭﻥ
bray	ﺏﺭی
brazelton	ﺏﺭﺍﺯﻝﺕﻥ
brazier	ﺏریزیر
bream	ﺏﺭیﻡ
breanndan	ﺏﺭیﻥﺩﺍﻥ
breaud	ﺏﺭﻭﺩ
brecher	ﺏﺭچﺭ
brechtie	ﺏرچﺕی
breck	ﺏﺭک
bree	ﺏﺭی
breed	ﺏﺭیﺩ
breen	ﺏریﻥ
bregitta	ریگیﺕﺍ
breitling	ﺏﺭیﺕﻝیﻥگ
brejcha	ﺏﺭچﺍ
bremmer	ﺏرﻡر
brenchley	ﺏﺭﻥچﻝی
brendler	ﺏﺭﻥﺩﻝﺭ
brendon	ﺏﺭﻥﺩﻭﻥ
brennan	ﺏﺭﻥﺍﻥ
brenner	ﺏﺭﻥﺭ
brent	ﺏﺭﻥﺕ
bresee	ﺏﺭﺱی
breslau	ﺏﺭﺱﻝﺍﻭ
bresler	ﺏﺭﺱﻝﺭ
bressman	ﺏﺭﺱﻡﻥ
breuer	ﺏﺭﻭیﺭ
brevik	ﺏﺭﻭیک
brewin	ﺏﺭیﻭیﻥ
brewster	ﺏﺭﻭﺱﺕﺭ
breyer	ﺏﺭیﺭ
brian	ﺏﺭیﺍﻥ
briand	ﺏﺭیﺍﻥ
briber	ﺏﺭیﺏﺭ
brice	ﺏﺭﺍیﺱ
briceno	ﺏﺭیﺱﻥﻭ
bridger	ﺏﺭیﺝﺭ
bridges	ﺏﺭیﺝﺯ
bridgman	ﺏﺭیﺝﻡﻥ
bridwell	ﺏﺭیﺩﻭﻝ
brie	ﺏﺭﺍی
brien	ﺏﺭﺍیﻥ
brier	ﺏﺭﺍیﺭ
briganti	ﺏیﺭیگﺍﻥﺕی
bright	ﺏﺭﺍیﺕ
brighton	ﺏﺭﺍیﺕﻭﻥ
brij	ﺏﺭیﺝ
brillant	ﺏریﻝﻥﺕ
brimmer	ﺏﺭیﻡﺭ
brimstone	ﺏﺭیﻡﺱﺕﻭﻥ
brind	ﺏﺭیﻥﺩ
brindle	ﺏﺭیﻥﺩﻝ
bringardner	ﺏﺭیﻥگﺍﺭﺩﻥﺭ
brink	ﺏﺭیﻥک
brinker	ﺏﺭیﻥکﺭ
brinkerhoff	ﺏریﻥکرﻩﺍﻑ
brinkler	ﺏﺭﺍیﻥکﻝﺭ
brinkley	ﺏریﻥکﻝی
brinkman	ﺏﺭیﻥکﻡﻥ
brinsley	ﺏریﻥﺱﻝی
brinson	ﺏﺭیﻥﺱﻥ
brion	ﺏرﺍیﻥ
brisbane	ﺏﺭیﺱﺏیﻥ
brisco	ﺏﺭیﺱکﻭ
brisinda	ﺏﺭیﺱیﻥﺩﺍ
bristly	ﺏریﺱﺕﻝی
bristol	ﺏﺭیﺱﺕﻭﻝ
brita	ﺏﺭیﺕﺍ
british	ﺏﺭیﺕیﺵ
briton	ﺏرﺍیﺕﻭﻥ
britt	ﺏﺭیﺕ
britten	ﺏﺭﺍیﺕﻥ
broadcast	ﺏرﻭﺩکﺱﺕ
broadhurst	ﺏﺭﻭﺩﻩﺍﺱﺕ
brock	ﺏﺭﺍک
brockley	ﺏﺭﺍکﻝی
brod	ﺏﺭﺩ
broda	ﺏﺭﻭﺩﺍ
broder	ﺏﺭﻭﺩﺭ
brodrene	ﺏرﺍﺩرﻥ
brodsky	ﺏرﺩﺱکی
brogger	ﺏﺭﺍﺝﺭ
brohl	ﺏﺭﻭﻩﻝ
brokaw	ﺏﺭﻭکﺍﻭ
broken	ﺏﺭﻭکﻥ
bromage	ﺏﺭﻭﻡیﺝ
bromberg	ﺏﺭﻭﻡﺏﺭگ
bromberger	ﺏﺭﻭﻡﺏﺭگﺭ
bromery	ﺏﺭﻭﻡﺭی
bron	ﺏﺭﺍﻥ
bronis	ﺏرﺍﻥیﺱ
brooke	ﺏﺭﻭک
brookwell	ﺏﺭﻭکﻭﻝ
brotherton	ﺏرﺍﺩرﺕﻥ
brotman	ﺏﺭﻭﺕﻡﻥ
broucek	ﺏرﻭکک
broude	ﺏﺭﺍﺩ
broughton	ﺏرﺍﻭﺕﻭﻥ
broun	ﺏﺭﺍﻥ
brousseau	ﺏﺭﻭﺱیﺍﻭ
brouwer	ﺏرﻭﻭر
browarek	ﺏﺭﻭﺍﺭک
brown	ﺏﺭﺍﻭﻥ
browner	ﺏﺭﺍﻭﻥﺭ
brownfield	ﺏﺭﺍﻭﻥﻑیﻝﺩ
browning	ﺏﺭﺍﻭﻥیﻥگ
brownlee	ﺏﺭﺍﻭﻥﻝی
broz	ﺏﺭﻭﺯ
brubaek	ﺏرﺍﺏﺍک
brubaker	ﺏرﻭﺏیکر
bruce	ﺏﺭﻭﺱ
bruciamonti	ﺏﺭﺍﺱیﺍﻡﻭﻥﺕی
brueckner	ﺏﺭﻭکﻥﺭ
bruening	ﺏﺭﻭیﻥیﻥگ
bruines	ﺏﺭﻭیﻥﺱ
brumbaugh	ﺏﺭﺍﻡﺏﺍﻭ
brumfield	ﺏﺭﻭﻡﻑیﻝﺩ
brumm	ﺏﺭﺍﻡ
brummer	ﺏﺭﺍﻡﺭ
bruneau	ﺏﺭﻭﻥییﻭ
brunelle	ﺏﺭﻭﻥﻝ
bruner	ﺏﺭﻭﻥﺭ
bruning	ﺏﺭﻥیﻥگ
brunswick	ﺏﺭﺍﻥﺱﻭیک
brunt	ﺏﺭﺍﻥﺕ
brunwin	ﺏﺭﻭﻥﻭییﻥ
brutlag	ﺏرﺍﺕﻝگ
bruty	ﺏﺭﻭﺕی
brutzman	ﺏﺭﻭﺕﺯﻡﻥ
bruyn	ﺏﺭﻭیﻥ
bruzzone	ﺏﺭﺍﺯﻭﻥ
bryan	ﺏﺭیﺍﻥ
bryant	ﺏﺭیﺍﻥﺕ
bryce	ﺏﺭیﺱ
bryde	ﺏﺭﺍیﺩ
bryguy	ﺏﺭیگﻭی
bryn	ﺏﺭیﻥ
bryony	ﺏﺭیﻭﻥی
bryson	ﺏﺭﺍیﺱﻭﻥ
buay	ﺏﻭﺍی
buback	ﺏﻭﺏک
bubb	ﺏﺍﺏ
bubble	ﺏﺍﺏﻝ
buberel	ﺏﺍﺏیﺭﻝ
bucci	ﺏﻭﺱی
buceck	ﺏﻭﺱک
buchalter	ﺏﺍچﺍﻝﺕﺭ
bucher	ﺏﻭچر
buck	ﺏﺍک
buckeye	ﺏﻭکی
buckland	ﺏﻭکﻝﻥﺩ
buckle	ﺏﻭکﻝ
buckles	ﺏﺍکﻝﺯ
buckley	ﺏﺍکﻝی
buckman	ﺏﺍکﻡﺍﻥ
buckner	ﺏﺍکﻥﺭ
buckser	ﺏﺍکﺱﺭ
bud	ﺏﺍﺩ
buda	ﺏﻭﺩﺍ
budd	ﺏﺍﺩ
budds	ﺏﺍﺩﺯ
buddy	ﺏﺍﺩی
budi	ﺏﻭﺩی
budig	ﺏﺍﺩیگ
budnick	ﺏﺍﺩﻥیک
budziak	ﺏﺍﺩﺯیﺍک
buff	ﺏﺍﻑ
buffalo	ﺏﻭﻑﺍﻝﻭ
buffinger	ﺏﻭﻑیﻥگﺭ
buffy	ﺏﺍﻑی
bug	ﺏﺍگ
bugay	ﺏﺍگﺍی
buggelli	ﺏﺍگﻝی
bugos	ﺏﻭگﺱ
bugs	ﺏﺍگﺯ
buhl	ﺏﻭﻩﻝ
bui	ﺏﻭی
buice	ﺏﻭییﺱ
bulcke	ﺏﺍﻝک
bulent	ﺏﻭﻝﻥﺕ
bulkowski	ﺏﺍﻝکﻭﺱکی
bulla	ﺏﻭﻝﺍ
bullard	ﺏﻭﻝﺍﺭﺩ
bulldozer	ﺏﻭﻝﺩﺯﺭ
buller	ﺏﻭﻝﺭ
bulloch	ﺏﻭﻝﻭچ
bullock	ﺏﺍﻝﺍک
bulow	ﺏﻭﻝﻭ
bulsara	ﺏﺍﻝﺱﺍﺭﺍ
bulsari	ﺏﺍﻝﺱﺭی
bulus	ﺏﻝﺍﺱ
bum	ﺏﻭﻡ
bumgardner	ﺏﻭﻡگﺍﺭﺩﻥﺭ
bumsoo	ﺏﺍﻡﺱﻭ
bunge	ﺏﺍﻥگ
bungers	ﺏﺍﻥگﺭﺯ
bunkahle	ﺏﺍﻥکﺍﻝ
bunkley	ﺏﺍﻥکﻝی
bunn	ﺏﺍﻥ
bunny	ﺏﺍﻥی
bunten	ﺏﻭﻥﺕﻥ
bunting	ﺏﺍﻥﺕیﻥگ
burak	ﺏﺍرک
buraschi	ﺏﻭﺭﺍﺱچی
burba	ﺏﺭﺏﺍ
burch	ﺏرچ
burda	ﺏﻭرﺩﺍ
burden	ﺏﺭﺩﻥ
burdick	ﺏﺍﺭﺩیک
burditt	ﺏﺭﺩیﺕ
burfitt	ﺏﺍﺭﻑیﺕ
burgaard	ﺏﺭگﺍﺭﺩ
burge	ﺏﺭگ
burghard	ﺏﺍﺭﻕﺍﺭﺩ
burghart	ﺏﻭرگﺍرﺕ
burj	ﺏﺭﺝ
burkhard	ﺏﺭخﺍﺭﺩ
burl	ﺏﺭﻝ
burleigh	ﺏﺭﻝی
burleson	ﺏﺭﻝﺱﻭﻥ
burling	ﺏﺭﻝیﻥگ
burmester	ﺏﺍرﻡﺱﺕر
burn	ﺏﺍرﻥ
burnett	ﺏرﻥﺕ
burnette	ﺏﺭﻥﺕ
burney	ﺏﺭﻥی
burns	ﺏﺭﻥﺯ
burr	ﺏﺭ
burrell	ﺏﺍﺭﻝ
burrill	ﺏﻭﺭیﻝ
burris	ﺏﺍﺭیﺱ
burrows	ﺏﺍﺭﻭﺯ
bursell	ﺏﻭﺭﺱﻝ
burshteyn	ﺏﺍﺭﺵﺕیﻥ
burson	ﺏﺭﺱﻭﻥ
burt	ﺏﺭﺕ
burts	ﺏﺭﺕﺱ
bury	ﺏﺭی
busa	ﺏﻭﺱﺍ
busarow	ﺏﻭﺱﺍﺭﻭ
busby	ﺏﺍﺱﺏی
busch	ﺏﻭﺵ
buschusa	ﺏﺍﺱچﺍﺱﺍ
busenbark	ﺏﻭﺱﻥﺏﺍرک
bush	ﺏﻭﺵ
bushnell	ﺏﻭﺵﻥﻝ
bushore	ﺏﻭﺵﻭﺭ
bustamante	ﺏﻭﺱﺕﺍﻡﻥﺕ
buster	ﺏﺍﺱﺕﺭ
bustillos	ﺏﺍﺱﺕیﻝﻭﺱ
butaysh	ﺏﻭﺕﺍیﺵ
butch	ﺏﺍچ
butcher	ﺏﻭﺕچﺭ
butenko	ﺏﻭﺕﻥکﻭ
butler	ﺏﺍﺕﻝﺭ
butte	ﺏﻭﺕ
butterfield	ﺏﺍﺕﺭﻑیﻝﺩ
butterworth	ﺏﺍﺕﺭﻭﺭث
buttnut	ﺏﺍﺕﻥﺍﺕ
button	ﺏﺍﺕﻥ
buttress	ﺏﺍﺕﺭﺯ
buttresses	ﺏﺍﺕﺭﺱﺱ
buttuls	ﺏﺍﺕﺍﻝﺱ
buxey	ﺏﻭکﺱی
buzbee	ﺏﺍﺯﺏی
buzby	ﺏﺍﺯﺏی
buze	ﺏیﻭﺯ
buzzi	ﺏﺍﺯی
byers	ﺏﺍیرﺯ
byfield	ﺏﺍیﻑیﻝﺩ
bygden	ﺏﺍیﺩﻥ
byler	ﺏیﻝﺭ
byles	ﺏیﻝﺱ
bynon	ﺏﺍیﻥﻭﻥ
bypass	ﺏﺍیپﺱ
byra	ﺏیﺭﺍ
byrd	ﺏیﺭﺩ
byrne	ﺏیﺭﻥﻩ
byrnes	ﺏیﺭﻥﺱ
byron	ﺏیﺭﻥ
bysouth	ﺏﺍیﺱﻭﺕ
bystander	ﺏیﺱﺕﺍﻥﺩﺭ
byung	ﺏیﺍﻥگ
byungse	ﺏیﻭﻥگﺱ
byungtae	ﺏیﺍﻥگﺕﺍی
cabaniss	کﺏﺍﻥیﺱ
cable	کیﺏﻝ
cabre	کیﺏﺭ
cacace	ﺱﺍﺱﺍکی
cacciola	کﺍکیﻭﻝﺍ
cacho	کﺍچﻭ
cactus	کﺍکﺕﻭﺱ
cadaver	کﺩﺍﻭﺭ
cadle	کﺩﻝ
cadmus	کﺍﺩﻡﻭﺱ
caesar	کیﺱر
caffrey	کﺍﻑﺭی
cagle	کﺍگﻝ
cahill	کﺍﻩیﻝ
cahoon	کﺍﻩﻭﻥ
caillet	کیﻝﺕ
cain	کیﻥ
caine	کﺍیﻥی
caird	کﺍیﺭﺩ
cakebread	کیکﺏریﺩ
cala	کﺍﻝﺍ
calahan	کﺍﻝﺍﻩﺍﻥ
calbridge	کﺍﻝﺏﺭیﺝ
calderon	کﺍﻝﺩرﻭﻥ
caldwell	کﺍﻝﺩﻭﻝ
caliaro	کﺍﻝیﺍﺭﻭ
calinisan	کﺍﻝیﻥﺱﺍﻥ
calius	کﺍﻝییﻭﺱ
calkins	کﺍﻝکیﻥﺯ
call	کﺍﻝ
callanan	کﺍﻝﺍﻥﺍﻥ
callaway	کﺍﻝﺍﻭﺍی
callebaut	کﺍﻝﺏﺍﻭﺕ
called	کﻝﺩ
calow	کﺍﻝﻭ
calsyn	کﺍﻝﺱیﻥ
calvert	کﺍﻝﻭﺭﺕ
calvin	کﺍﻝﻭیﻥ
camama	کﺍﻡﺍﻡﺍ
camerer	کﺍﻡرر
cameron	کﺍﻡﺭﻭﻥ
cameros	کﺍﻡﺭﻭﺱ
camfield	کﻡﻑیﻝﺩ
campagna	کﺍﻡپﺍگﻥﺍ
campbell	کﺍﻡپﺏﻝ
campey	کﻡپی
campillo	کﺍﻡپیﻝﻭ
campobello	کﻡپﻭﺏﻝﻭ
campos	کﺍﻡپﻭﺱ
camsfield	کﺍﻡزﻑیﻝﺩ
canale	کﺍﻥﺍﻝ
candau	کﺍﻥﺩﺍیﻭ
candy	کﻥﺩی
canfield	کﺍﻥﻑیﻝﺩ
caniano	کﺍﻥیﺍﻥﻭ
canis	کﺍﻥیﺱ
canning	کﺍﻥیﻥگ
cannon	کﺍﻥﻥ
cano	کﺍﻥﻭ
canon	کﺍﻥﻥ
cantara	کﺍﻥﺕرﺍ
cantrell	کﺍﻥﺕﺭﻝ
canyon	کﺍﻥیﻭﻥ
cao	کﺍﻭ
cap	کپ
cape	کیپ
capistran	کپیﺱﺕﺭﺍﻥ
caprette	کپﺭﺕ
capstick	کپﺱﺕیک
caraher	کﺍﺭﺍﻩﺭ
carangelo	کﺍﺭﺍﻥﺝﻝﻭ
carbone	کﺍﺭﺏﻥ
carbonell	کﺭﺏﻭﻥیﻝ
carbonneau	کﺍﺭﺏﻭﻥیﺍ
cardenas	کﺍﺭﺩﻥﺍﺱ
cardinali	کﺍﺭﺩیﻥﺍﻝی
cargill	کﺍﺭگیﻝ
carhart	کﺍﺭﻩﺍﺭﺕ
cariaga	کﺍﺭیﺍگﺍ
carina	کﺍﺭﻥیﺍ
carl	کﺍﺭﻝ
carleton	کﺍرﻝﺕﻭﻥ
carley	کرﻝی
carlile	کﺍﺭﻝﺍیﻝ
carlin	کﺍﺭﻝیﻥ
carlos	کﺍﺭﻝﺱ
carlson	کﺍﺭﻝﺱﻭﻥ
carlton	کﺍﺭﻝﺕﻭﻥ
carmichael	کﺍﺭﻡیچﺍیﻝ
carmody	کﺍﺭﻡﻭﺩی
carmona	کﺍﺭﻡﻭﻥﺍ
carnelian	کﺍﺭﻥﻝیﺍﻥ
carnell	کﺭﻥﻝ
carnerie	کﺍﺭﻥﺭی
carnes	کﺍﺭﻥﺯ
carney	کﺍﺭﻥی
carnie	کﺍﺭﻥی
carol	کﺭﻭﻝ
carosso	کﺍﺭﻭﺱﻭ
carr	کﺍﺭ
carragher	کﺍﺭﺍگﺭ
carrara	کﺍﺭﺍﺭﺍ
carreira	کﺍﺭیﺭﺍ
carrier	کﺭیﺭ
carrillo	کﺍﺭیﻝﻭ
carrots	کﺍرﻭﺕﺱ
carskadon	کﺍﺭﺱکﺍﺩﻭﻥ
carson	کﺍﺭﺱﻭﻥ
carstens	کﺍﺭﺱﺕﻥﺯ
carstensen	کﺍﺭﺱﺕﻥﺱﻥ
cartaxo	ﺱﺍﺭﺕﺍکﺱﻭ
carter	کﺍﺭﺕﺭ
carterette	کﺍرﺕریﺕ
cartwright	کﺍرﺕرﺍیﺕ
caruso	کﺍﺭﻭﺱﻭ
carvajal	کﺍﺭﻭﺍﺝﺍﻝ
carvalho	کﺍرﻭﺍﻝﻩﻭ
carvallo	کﺍﺭﻭﺍﻝﻭ
carver	کﺍﺭﻭﺭ
cary	کﺭی
casanova	کﺍﺱﺍﻥﻭﻭﺍ
cascio	کﺍﺱیﻭ
case	کیﺱ
casertino	کﺍﺱﺭﺕیﻥﻭ
casey	کیﺱی
casley	کﺱﻝی
cason	کیﺱﻭﻥ
casper	کﺍﺱپر
casriel	کﺍﺱﺭیﻝ
cass	کﺍﺱ
cassara	کﺍﺱﺍﺭﺍ
cassel	کﺱﻝ
casselman	کﺍﺱﻝﻡﻥ
cassidy	کیﺱیﺩی
cassinelli	کﺍﺱیﻥﻝی
castellot	کﺱﺕﻝﻭﺕ
caster	کﺱﺕﺭ
castergine	کﺍﺱﺕﺭگیﻥ
casti	کﺍﺱﺕی
castilla	کﺱﺕیﻝﺍ
castner	کﺱﺕﻥﺭ
catalano	کﺍﺕﺍﻝﺍﻥﻭ
caterina	کﺍﺕﺭیﻥﺍ
catharyn	کﺍﺕریﻥ
cathcart	کﺍﺕکﺍﺭﺕ
catherine	کﺍﺕﺭیﻥ
catlett	کﺕﻝﺕ
cato	کیﺕﻭ
catsimatides	کﺕﺱیﻡﺍﺕیﺩﺱ
cau	کﺍﻭ
cauchon	کﺍچﻭﻥ
caudill	کﺍﻭﺩیﻝ
cauldwell	کﺍﻝﺩﻭﻝ
cauligi	کﺍﻝیگی
cave	کیﻭ
caveman	کیﻭﻡﻥ
cavers	کﺍﻭﺭﺯ
cawley	کﺍﻭﻝی
cawston	کﺍﻭﺱﺕﻥ
cazier	کﺍﺯیﺭ
cecil	ﺱﺱیﻝ
cedelle	کﺩﻝ
cederholm	ﺱﺩﺭﻩﻝﻡ
celarier	ﺱﻝﺍﺭیﺭ
celetje	ﺱیﻝیﺕ
celic	کﻝﺍیک
cemal	کﻡﺍﻝ
cena	ﺱیﻥﺍ
cengeloglu	ﺱﻥگﻝﻭگﻝﻭ
cengiz	ﺱگیﺯ
cera	کﺭﺍ
cerasuolo	ﺱﺭﺍﺱﻭﻝ
cernese	کﺭﻥیﺯ
cerveny	کﺭﻭﻥی
cessaro	ﺱﺯﺍﺭﻭ
cetia	ﺱیﺕیﺍ
chaara	چﺍرﺍ
chabun	چﺍﺏﻭﻥ
chad	چﺍﺩ
chafir	کﺍﻑیر
chaiken	چﺍیکﻥ
chalk	چﺍﻝک
chalker	چﺍﻝکﺭ
chamberlain	چﺍﻡﺏﺭﻝﺍیﻥ
chambers	چﻡﺏﺭﺯ
champak	چﺍﻡپک
champlin	چﺍﻡپﻝیﻥ
chancellor	چﻥﺱﻝﻭﺭ
chand	چﺍﻥﺩ
chander	چﺍﻥﺩﺭ
chandler	چﻥﺩﻝﺭ
chandonia	چﺍﻥﺩﻭﻥیﺍ
chandross	چﻥﺩرﺱ
chaney	چﺍﻥی
channel	کﺍﻥﺍﻝ
chantler	چﺍﻥﺕﻝﺭ
chao	چﺍﻭ
chaos	کیﻭﺱ
chapela	چﺍپﻝﺍ
chapman	چﺍپﻡﻥ
char	چﺍر
chard	چﺍﺭﺩ
charles	چﺍﺭﻝﺯ
charley	چﺍﺭﻝی
charlie	چﺍﺭﻝی
charlotte	چﺍرﻝﻭﺕ
charlton	چﺍرﺕﻭﻥ
charly	چﺍرﻝی
charng	چﺍﺭﻥگ
charpentier	کﺍﺭپﻥﺕیﺭ
charrick	چﺍﺭیک
charrois	کﺭﻭیﺱ
chartier	کﺍﺭﺕیﺭ
chas	چﺍﺵ
chasms	چﺍﺱﻡﺯ
chastain	چﺍﺱﺕیﻥ
chata	چﺕﺍ
chatane	چﺍﺕﺍﻥی
chatski	چﺍﺕﺱکی
chauhan	چﺍﻭﻩﺍﻥ
chauncy	چﺍﻥﺱی
chaurie	چﺍﻭﺭی
chauveau	چﺍﻭﻭیﻭ
chauvin	چﺍﻭﻭیﻥ
chavez	چﺍﻭﺯ
chawla	چﺍﻭﻝﺍ
chayes	چﺍیﺯ
chaz	چﺍﺯ
che	چﻩ
cheal	چیﺍ
cheap	چیپ
cheapman	چیپﻡﻥ
checkered	چکﺭﺩ
checkoway	چکﻭﻭی
chedley	چﺩﻝی
chee	چی
cheeky	چیکی
cheenu	چیﻥﻭ
cheesman	چیﺱﻡﻥ
cheetham	چیﺕﺍﻡ
cheiltje	چیﺕ
chek	چک
chelian	چﻝییﺍﻥ
chelius	چﻝیﻭﺱ
chellaton	چﻝﺍﺕﻭﻥ
chely	چﻝی
chembezi	چﻡﺏﺯی
chemello	کﻡﻝﻝﻭ
chemist	ﺵﻡیﺱﺕ
chen	چﻥ
chenader	چﻥﺍﺩﺭ
cheney	چﻥی
chengyan	چﻥگیﺍﻥ
chenteh	چﻥﺕﻩ
cher	چﺭ
cherag	چﺭﺍگ
cherbel	چﺭﺏﻝ
cherepy	چﺭپی
cherie	چﺭی
cherkasy	چرکﺍﺱی
chern	چﺭﻥ
cherrie	چﺭی
cherry	چری
cherubini	چﺭﻭﺏیﻥی
cheryl	چﺭیﻝ
ches	چﺱ
chesbro	چﺱﺏﺭﻭ
chesny	چﺱﻥی
chester	چﺱﺕﺭ
chesterman	چﺱﺕریﻡﻥ
chet	چیﺕ
chetal	چﺕﺍﻝ
chetan	چیﺕﺍﻥ
chetwin	چیﺕﻭیﻥ
chevalier	چﻭﺍﻝﺭ
chevron	چﻭﺭﻥ
chew	چیﻭ
chi	چی
chia	چیﺍ
chiaki	چیﺍکی
chiang	چیﺍﻥگ
chiasson	کیﺍﺱﻭﻥ
chiausa	چیﺍﻭﺱﺍ
chicago	ﺵیکﺍگﻭ
chichester	چیچﺱﺕﺭ
chick	چیک
chicken	چیکﻥ
chickery	چیکﺭی
chickon	چیکﻥ
chico	چیکﻭ
chief	چیﻑ
chiem	چیﻡ
chien	چیﻥ
chiesa	چیﺯﺍ
chiew	چیﻭ
chik	چیک
child	چﺍیﻝﺩ
childe	چیﻝﺩﻩ
childs	چیﻝﺩﺯ
chillingworth	چیﻝیﻥگﻭرﺕ
chilly	چیﻝی
chinen	چیﻥﻥ
ching	چیﻥگ
chinook	چیﻥﻭک
chiou	چیﻭ
chip	چیپ
chipp	چیپ
chirag	چیﺭﺍک
chisel	چیﺱﻝ
chishtie	چیﺵﺕی
chism	چیﺱﻡ
chistopher	کیﺱﺕﻭﻑﺭ
chito	چیﺕﻭ
chitrady	چیﺕﺭﺩی
chitre	چیﺕﺭ
chitta	چیﺕﺍ
chittick	چیﺕیک
chivers	چیﻭﺭﺱ
chizu	چیﺯﻭ
chizuru	چیﺯﻭﺭﻭ
cho	چﻭ
choi	چﻭی
chokri	چﻭکﺭی
chokshi	چﻭکﺵی
cholet	چﺍﻝﺕ
cholette	ﺵﻭﻝﺕ
choma	چﻭﻡﺍ
chong	چﺍﻥگ
choo	چﻭ
choon	چﻭﻥ
choong	چﻭﻥگ
chopde	چپﺩی
chopin	چﺍپیﻥ
chopra	چﺍپﺭﺍ
chott	ﺵﻭﺕ
chou	چﻭ
choua	چﻭﺍ
choudhary	چﻭﺩﻩﺍﺭی
chow	چﻭ
choy	چﻭی
choyce	چﻭیﺱ
chrescyntie	چریﺱکیﻥﺕی
chris	کﺭیﺱ
christ	چریﺱﺕ
christa	کﺭیﺱﺕﺍ
christal	کﺭیﺱﺕﺍﻝ
christall	چریﺱﺕﺍﻝ
christandl	کﺭیﺱﺕﻥﺩﻝ
christele	کﺭیﺱﺕﻝ
christen	کﺭیﺱﺕﻥ
christer	کﺭیﺱﺕﺭ
christiaen	چریﺱﺕیﻥ
christian	کﺭیﺱﺕیﺍﻥ
christiana	کﺭیﺱﺕیﺍﻥﺍ
christiansen	کﺭیﺱﺕیﺍﻥﺱﻥ
christie	کﺭیﺱﺕی
christine	کﺭیﺱﺕیﻥ
christmann	کﺭیﺱﺕﻡﻥ
christoffel	چریﺱﺕﻑﻝ
christoph	کریﺱﺕﻭﻑ
christophe	کﺭیﺱﺕﻭﻑ
christopherson	کﺭیﺱﺕﻭﻑﺭﺱﻭﻥ
christos	کریﺱﺕﻭﺱ
christy	کﺭیﺱﺕی
christyntie	چریﺱﺕیﻥﺕی
chritton	کﺭیﺕﻭﻥ
chrome	چﺭﻭﻡ
chudov	چﻭﺩﻭ
chul	چﻭﻝ
chumbley	چﺍﻡﺏﻝی
chumpia	چﺍﻡپیﺍ
chung	چﺍﻥگ
chunping	چﻭﻥپیگ
chunyan	چﻭﻥیﺍﻥ
chuq	چﻭگ
church	چﺭچ
churchill	چﺭچیﻝ
chusak	چﻭﺱﺍک
chwolka	چﻭﻝکﺍ
cia	ﺱیﺍ
cichero	کیچﺭﻭ
cinq	ﺱیﻥک
cionca	ﺱیﻭﻥکﺍ
cirilo	ﺱیﺭیﻝﻭ
cirques	ﺱیﺭکﻭیﺱ
cisneros	کیﺱﻥﺭﻭﺱ
citizen	ﺱیﺕیﺯﻥ
cittlau	ﺱیﺕﻝﺍیﻭ
claborn	کﻝﺏﻭﺭﻥ
clabourne	کﻝﺍﺏﻭﺭﻥ
claertie	کﺍﻝرﺕی
claesje	کﺍﻝﺱگﻩ
claeson	کﻝﺍیﺱﻭﻥ
clamen	کﻝﺍﻡﻥ
clancey	کﻝﺍﻥﺱی
clanfield	کﻝﺍﻥﻑیﻝﺩ
clanton	کﻝﺍﻥﺕﻭﻥ
clapin	کﻝﺍپیﻥ
clapp	کﻝﺍپ
clare	کﻝیﺭ
clark	کﻝﺍﺭک
clarke	کﻝﺍﺭک
claros	کﻝﺭﻭﺱ
clast	کﻝﺱﺕ
claudia	کﻝﺍﻭﺩیﺍ
clausing	کﻝﺍﺯیﻥگ
claussen	کﻝﻭﺱﻥ
clayson	کﻝﺍیﺱﻭﻥ
clayton	کﻝیﺕﻭﻥ
cleavey	کﻝیﻭی
cleek	کﻝیک
cleeland	کﻝیﻝﻥﺩ
cleere	کﻝیﺭ
cleeve	کﻝیﻭ
clegg	کﻝگ
clemens	کﻝﻡﻥﺯ
clever	کﻝﻭﺭ
clewley	کﻝﻭﻝی
cliff	کﻝیﻑ
clifford	کﻝیﻑﺭﺩ
cliffs	کﻝیﻑﺯ
clift	کﻝیﻑﺕ
clifton	کﻝیﻑﺕﻭﻥ
clonfero	کﻝﻭﻥﻑﺭﻭ
cloos	کﻝﻭﺱ
clorox	کﻝﺍﺭﻭکﺱ
clough	کﻝﺍﻑ
clout	کﻝﺍﻭﺕ
club	کﻝﻭﺏ
clumpner	کﻝﻭﻡپﻥﺭ
coast	کﻭﺱﺕ
coates	کﻭﺕﺱ
coats	کﻭﺕﺱ
cobabe	کﻭﺏیﺏ
cobb	کﺍﺏ
cobo	کﻭﺏﻭ
cochran	کﻭچﺭﺍﻥ
cochrane	کﺍچﺭﺍﻥ
cockburn	کﻭکﺏﺭﻥ
cockerill	کﺍکریﻝ
cockfield	کﻭکﻑیﻝﺩ
cockroft	کﺍکﺭﺍﻑﺕ
code	کﺩ
cody	کﻭﺩی
coen	کﻭﻥ
coenraad	کﻥرﺍﺩ
coenraadt	کﻥرﺍﺕ
coenradus	کﻥرﺍﺩﻭﺱ
coenraedt	کﻥرﺍﺩ
coesmans	کزﻡﻥز
coevering	کﻭﺍﻭﺭیﻥگ
coeyman	کﻭییﻡﺍﻥ
coffin	کﺍﻑیﻥ
cogburn	کﺍگﺏﻭﺭﻥ
coghlan	کﻭگﻝﺍﻥ
cogswell	کﺍگﺱﻭﻝ
cohan	کﻭﻩﺍﻥ
cohen	کﻭﻩﻥ
coil	کﻭیﻝ
coisman	کﻭیﺱﻡﺍﻥ
col	کﻝ
colbert	کﻝﺏرﺕ
colbey	کﻝﺏی
colburn	کﻝﺏﺭﻥ
colclasure	کﺍﻝکﻝﺍﺱﻭﺭ
coldewey	کﻝﺩﻭی
cole	کﻝ
coleno	کﻭﻝﻥﻭ
colety	کﻭﻝﺕی
colfelt	کﻝﻑﻝﺕ
colleran	کﻭﻝرﺍﻥ
collett	کﺍﻝﺕ
collette	کﻝﺕ
colletti	کﻭﻝﺕی
collie	کﺍﻝی
collier	کﻭﻝیﺭ
collinet	کﺍﻝیﻥﺕ
collingwood	کﻭﻝیﻥگﻭﻭﺩ
collins	کﺍﻝیﻥﺯ
colon	کﻭﻝﻥ
colonello	کﺍﻝﻭﻥﻝﻭ
colten	کﻝﺕﻥ
colton	کﺍﻝﺕﻭﻥ
colwell	کﻭﻝﻭﻝ
combee	کﺍﻡﺏیی
combites	کﺍﻡﺏیﺕﺯ
compton	کﺍﻡپﺕﻭﻥ
computer	کﺍﻡپیﻭﺕﺭ
comstock	کﺍﻡﺱﺕﺍک
comte	کﻭﻡﺕ
conboy	کﺍﻥﺏﻭی
conconi	کﺍﻥکﻥﺕ
condelli	کﺍﻥﺩﻝی
cone	کﺍﻥ
cong	کﺍﻥگ
conger	کﺍﻥگﺭ
conley	کﺍﻥﻝی
conlon	کﺍﻥﻝﻥ
connell	کﻭﻥﻝ
connelly	کﺍﻥﻝی
connery	کﺍﻥﺭی
connolly	کﻭﻥﻭﻝی
connor	کﺍﻥﺭ
conover	کﻭﻥﻭﻭﺭ
conraud	کﻭﻥﺭﺍﺩ
conroy	کﺍﻥﺭﻭی
constabaris	کﺍﻥﺱﺕﺍﺏﺍﺭیﺱ
constant	کﺍﻥﺱﺕﻥﺕ
conte	کﺍﻥﺕﻩ
contractor	کﺍﻥﺕﺭﺍکﺕﻭﺭ
convery	کﺍﻥﻭﺭی
conway	کﺍﻥﻭی
conyers	کﻥیﺭﺯ
conyne	کﻭﻥﺍیﻥ
cook	کﻭک
cooke	کﻭک
cookson	کﻭکﺱﻭﻥ
cooley	کﻭﻝی
coolidge	کﻭﻝیﺝ
coomber	کﻭﻡﺏﺭ
coombs	کﻭﻡﺏﺯ
cooney	کﻭﻥی
cooper	کﻭپر
cooperman	کﻭپرﻡﻥ
coopersmith	کﻭپﺭﺍﺱﻡیﺕ
cootjans	کﻭﺕﺝﺍﻥﺯ
copeland	کﻭپﻝﻥﺩ
copella	کﻭپﻝﺍ
coplen	کﻭپﻝﻥ
coppeans	کﻭپﻥﺯ
coppedge	کﻭپﺝ
coppejans	کﻭپﺝﺍﻥﺯ
coppola	کﻭپﻝﺍ
copps	کﺍپﺱ
coram	کﻭﺭﺍﻡ
corbelli	کﺭﺏﻝی
corbet	کﻭرﺏﺕ
corbett	کﻭﺭﺏﺕ
corbin	کﻭﺭﺏیﻥ
corcoran	کﺍﺭکﺍﺭﻥ
cordes	کﻭﺭﺩﺯ
cordrey	کﺭﺩﺭی
cordy	کﺭﺩی
corelis	کﻭرﻝیﺯ
coren	کﻭﺭﻥ
corey	کﻭﺭی
cork	کﻭرک
corke	کﻭرک
corl	کﻭﺭﻝ
corley	کﺭﻝی
cornelius	کرﻥﻝیﻭﺱ
corneliusen	کﻭﺭﻥﻝیﻭﺱﻥ
cornellis	کرﻥﻝیﺱ
corner	کﻭرﻥر
cornette	کﻭﺭﻥﺕ
cornish	کرﻥیﺵ
cornuelle	کﻭﺭﻥیﻭﻝ
cornwall	کﻭﺭﻥﻭﺍﻝ
cornwell	کﺭﻥﻭﻝ
coronella	کﻭﺭﻭﻥﻝﺍ
corre	کﻭﺭ
correia	کﻭﺭیﺍ
corrie	کﺍریﻩ
corrigan	کﻭﺭیگﺍﻥ
corsello	کﻭﺭﺱﻝﻭ
cort	کﻭﺭﺕ
cortell	کﻭﺭﺕﻝ
cortez	کﻭﺭﺕﺯ
corwin	کﺭﻭیﻥ
coryell	کﻭﺭیﻝ
corzine	کﻭﺭﺯﺍیﻥ
cosell	کﺍﺱﻝ
cosgriff	کﺍﺯگﺭیﻑ
cosgrove	کﺍﺱگﺭﻭﻩ
cosmas	کﻭﺱﻡﺍﺱ
costa	کﺍﺱﺕﺍ
costanza	کﻭﺱﺕﺍﻥﺯﺍ
costello	کﺍﺱﺕﻝﻭ
costner	کﺍﺱﺕﻥﺭ
cote	کﻭﺕ
cotlar	کﺕﻝﺍﺭ
cotroneo	کﻭﺕﺭﻭﻥیﻭ
cotta	کﻭﺕﺍ
cottle	کﺍﺕﻝ
couch	کﻭچ
coulson	کﺍﻝﺱﻭﻥ
counsell	کﺍﻥﺱﻝ
county	کﺍﻥﺕی
courcelle	کﻭﺭﺱﻝ
courcoul	کﻭﺭکﻭﻝ
cournede	کﻭﺭﻥﺩ
courtlandt	کرﺕﻝﻥﺩ
courtney	کﻭرﺕﻥی
courtois	کﺍﺭﺕﻭیﺯ
coury	کﻭﺭی
cousins	کﺍﺯیﻥﺯ
couzin	کﻭﺯیﻥ
cove	کﺍﻭ
cover	کﺍﻭر
covert	کﺍﻭﺭﺕ
cowe	کﻭﻭ
cowen	کﻭیﻥ
cowie	کﻭی
cowley	کﺍﻭﻝی
cowling	کﺍﻭﻝیﻥگ
cox	کﺍکﺱ
coxhead	کﺍکﺱﻩﺩ
coy	کﻭی
coyle	کﻭیﻝ
coyne	کﻭیﻥ
cozens	کﺍزﻥز
cozzi	کﻭﺯی
crabtree	کﺭﺏﺕﺭی
cracraft	کﺭکﺭﺍﻑﺕ
craddock	کرﺍﺩﺍک
craft	کﺭﻑﺕ
crafton	کﺭﻑﺕﻭﻥ
crags	کرگﺯ
craick	کﺭیک
craig	کﺭگ
crain	کﺭیﻥ
cramer	کﺭﺍﻡﺭ
crandlemire	کﺭﺍﻥﺩﻝﻡیﺭ
cranford	کﺭﻥﻑﺭﺩ
cranswick	کرﺍﻥزﻭیک
crapse	کﺭپﺱ
crase	کﺭیﺱ
crater	کﺭیﺕﺭ
craven	کﺭیﻭﻥ
crawford	کﺭﺍﻭﻑﻭﺭﺩ
crawley	کﺭﺍﻭﻝی
creasey	کﺭیﺱی
creasy	کﺭیﺱی
creath	کﺭیث
creech	کریچ
creek	کﺭیک
creider	کﺭیﺩﺭ
crepeau	کﺭیپیﻭ
cress	کﺭﺱ
crest	کﺭیﺱﺕ
crevasse	کﺭیﻭﺍﺱ
crevasses	کﺭیﻭﺍﺱﺯ
crews	کﺭﻭﺯ
crichton	کﺭیﺵﺕﻭﻥ
cricket	کﺭیکﺕ
crider	کﺭﺍیﺩﺭ
cringle	کﺭیﻥگﻝ
crisp	کﺭیﺱپ
crispen	کﺭیﺱپﻥ
criswell	کﺭﺍیﺱﻭﻝ
critchfield	کریچﻑیﻝﺩ
croall	کﺭﻭﺍﻝ
crockart	کﺭﺍکﺍﺭﺕ
crockett	کﺭﺍکﺕ
crockford	کرﺍکﻑرﺩ
croll	کﺭﻭﻝ
crom	کﺭﻭﻡ
crommett	کرﺍﻡﺕ
crosby	کﺭﺍﺱﺏی
cross	کﺭﺍﺱ
crossen	کرﺍﺱﻥ
croteau	کﺭﻭﺕیﻭ
crouchley	کﺭﺍچﻝی
croughton	کﺭﺍﻕﺕﻭﻥ
croume	کرﻭﻡ
crouse	کﺭﻭﺱ
crow	کﺭﻭ
crowcroft	کﺭکﺭﺍﻑﺕ
crowe	کﺭﻭ
crowell	کﺭﺍﻭﻝ
crown	کﺭﺍﻭﻥ
crowson	کﺭﺍﻭﺱﻭﻥ
croxton	کرﺍکﺱﺕﻥ
croyle	کﺭﻭیﻝ
crumhorn	کﺭﺍﻡﻩﻭﺭﻥ
crumpler	کﺭﺍﻡپﻝﺭ
crutcher	کﺭﺍچﺭ
crutchley	کﺭﺍچﻝی
cruz	کﺭﻭﺯ
crystal	کﺭیﺱﺕﺍﻝ
csaba	ﺱیﺱﺍﺏﺍ
cubitt	کیﻭﺏیﺕ
cuenca	کﻭﻥکﺍ
culbertson	کﺍﻝﺏرﺕﺱﻭﻥ
culhane	کﺍﻝﻩیﻥ
culloch	چﻭﻝچ
cully	کﻭﻝی
culpin	کﺍﻝپیﻥ
culver	کﺍﻝﻭﺭ
cumming	کﺍﻡیﻥگ
cuneyt	کﺍﻥیﺕ
cunitz	کﺍﻥیﺕﺯ
cunningham	کﺍﻥیﻥگﻩﺍﻡ
cuong	کیﻭﻥگ
cupples	کﻭپﻝﺱ
curley	کﻭﺭﻝی
curran	کﻭﺭﺍﻥ
currier	کﺍریر
curry	کﺍﺭی
curson	کﺭﺱﻥ
curtain	کﺭﺕیﻥ
curtis	کﺍﺭﺕیﺱ
curtner	کﺍﺭﺕﻥﺭ
curylo	کﺍﺭیﻝﻭ
cusack	کﻭﺱﺍک
cushing	کﺍﺵیﻥگ
cushman	کﺍﺵﻡﻥ
cusick	کیﻭﺱیک
cutchie	کﺍچی
cutie	کﻭﺕی
cutitta	کﻭﺕیﺕﺍ
cutter	کﺍﺕﺭ
cutting	کﺍﺕیﻥگ
cybanski	چیﺏﺍﻥﺱکی
cybermage	ﺱﺍیﺏﺭﻡیﺝ
cyberwulf	ﺱﺍیﺏرﻭﻝﻑ
cyclones	ﺱیﺱﻝﻭﻥﺯ
cyliax	ﺱیﻝیﺍکﺱ
cynthia	ﺱیﻥﺕیﺍ
cyril	کیﺭیﻝ
cyrus	ﺱیﺭﻭﺱ
czifra	زیﻑر
daatje	ﺩیﺕﺝی
dabin	ﺩﺍﺏیﻥ
dac	ﺩﺍک
daco	ﺩﺍکﻭ
dada	ﺩﺍﺩﺍ
dady	ﺩﺩی
dael	ﺩیﻝ
dag	ﺩﺍگ
dagan	ﺩﺍگﺍﻥ
dagley	ﺩگﻝی
dagnall	ﺩﺍگﻥﺍﻝ
dahar	ﺩﺍﻩﺍﺭ
dahl	ﺩﺍﻝ
dahr	ﺩﻩر
dahuk	ﺩﺍﻩﺍک
dailene	ﺩﺍیﻝیﻥﻩ
dailey	ﺩیﻝی
daimler	ﺩیﻡﻝر
dakin	ﺩیکیﻥ
dal	ﺩﺍﻝ
dalager	ﺩﺍﻝﺍﺝﺭ
dalal	ﺩﻝﺍﻝ
dale	ﺩیﻝ
daley	ﺩﺍﻝی
dalie	ﺩﻝی
dallaire	ﺩﺍﻝﺍیﺭ
dallan	ﺩﺍﻝﺍﻥ
dallas	ﺩﺍﻝﺍﺱ
dalmia	ﺩﺍﻝﻡییﺍ
dalrymple	ﺩﺍﻝﺭیﻡپﻝ
dalton	ﺩﺍﻝﺕﻥ
daly	ﺩیﻝی
damaris	ﺩﺍﻡﺍریﺱ
dame	ﺩیﻡ
damian	ﺩﺍﻡیﺍﻥ
damiano	ﺩﺍﻡیﺍﻥﻭ
damien	ﺩﺍﻡیﻥ
damion	ﺩﺍﻡیﻭﻥ
damon	ﺩیﻡﻥ
dan	ﺩﺍﻥ
dana	ﺩﺍﻥﺍ
danald	ﺩﺍﻥﺍﻝﺩ
dancer	ﺩﻥﺱر
dancing	ﺩﺍﻥﺱیﻥگ
danco	ﺩﺍﻥکﻭ
dancy	ﺩﺍﻥﺱی
dandelion	ﺩﺍﻥﺩﻝیﻭﻥ
dandler	ﺩﻥﺩﻝﺭ
dandridge	ﺩﻥریﺝ
dane	ﺩیﻥ
danekind	ﺩﻥکیﻥﺩ
danenbarger	ﺩﺍﻥﻥﺏﺍﺭگﺭ
dang	ﺩﺍﻥگ
dangel	ﺩﺍﻥﺝﻝ
dani	ﺩﺍﻥی
daniel	ﺩﺍﻥیﻝ
daniell	ﺩﺍﻥیﻝ
danielle	ﺩﺍﻥیﻝ
daniels	ﺩﺍﻥییﻝﺱ
danielson	ﺩﺍﻥیﻝﺱﻭﻥ
danih	ﺩﻥیﻩ
danis	ﺩﺍﻥیﺱ
danko	ﺩﺍﻥکﻭ
danon	ﺩﺍﻥﻭﻥ
danz	ﺩﺍﻥﺯ
darby	ﺩﺍﺭﺏی
dare	ﺩیﺭ
darlington	ﺩﺍﺭﻝیﻥگﺕﻥ
darmadi	ﺩﺭﻡﺩی
darnell	ﺩﺍﺭﻥﻝ
darrell	ﺩﺍﺭﻝ
darrow	ﺩﺍﺭﻭ
dart	ﺩﺍﺭﺕ
daryl	ﺩﺍﺭیﻝ
das	ﺩﺍﺱ
dash	ﺩﺍﺵ
daswani	ﺩﺍﺱﻭﺍﻥی
datri	ﺩﺍﺕﺭی
datz	ﺩﺕﺱ
dauber	ﺩﺍﻭﺏﺭ
daud	ﺩﺍیﻭﺩ
daugherty	ﺩﺍگﺭﺕی
daulton	ﺩﺍﻝﺕﻭﻥ
daum	ﺩﻭﻡ
dauria	ﺩﺍیﻭﺭیﺍ
dauwen	ﺩﺍیﻭﻭﻥ
dave	ﺩیﻭ
davenport	ﺩﺍﻭﻥپﺭﺕ
daverin	ﺩﺍﻭﺭیﻥ
david	ﺩیﻭیﺩ
davide	ﺩیﻭیﺩ
davidian	ﺩیﻭیﺩیﺍﻥ
davidson	ﺩیﻭیﺩﺱﻭﻥ
davie	ﺩیﻭی
davies	ﺩیﻭیﺯ
davison	ﺩیﻭیﺱﻥ
dawes	ﺩﺍﻭﺱ
dawkins	ﺩﺍکیﻥز
dawn	ﺩﺍﻥ
dawning	ﺩﺍﻭﻥیﻥگ
dawson	ﺩﺍﺱﻥ
day	ﺩی
dazsi	ﺩﺍﺯﺱی
deadfield	ﺩﺩﻑیﻝﺩ
dealy	ﺩیﻝی
dean	ﺩیﻥ
deane	ﺩیﻥ
deaner	ﺩیﻥﺭ
dear	ﺩیﺭ
deatherage	ﺩﺕﺭیﺝ
deaton	ﺩیﺕﻥ
deaven	ﺩیﻭﻥ
debathe	ﺩیﺏیﺕ
debathonia	ﺩیﺏﺍﺕﻭﻥیﺍ
debow	ﺩیﺏﻭ
decker	ﺩکﺭ
declerck	ﺩکﻝﺭک
declue	ﺩکﻝﻭ
deconinck	ﺩیکﺍﻥیﻥک
decouty	ﺩیکﺍﻭﺕی
dedes	ﺩیﺩﺱ
dedrick	ﺩﺩﺭیک
deeming	ﺩیﻡیﻥگ
deen	ﺩیﻥ
dees	ﺩیﺱ
deetz	ﺩیﺕﺯ
defroy	ﺩﻑﺭﻭی
degan	ﺩیگﺍﻥ
degen	ﺩیگﺍﻥ
degerlund	ﺩگﺭﻝﻭﻥﺩ
degotardi	ﺩگﻭﺕﺍﺭﺩی
degraff	ﺩگرﺍﻑ
deguzman	ﺩیگﺍﺯﻡﻥ
dehner	ﺩﻩﻥﺭ
dei	ﺩی
deibele	ﺩیﺏﻝ
deibler	ﺩﺏﻝﺭ
deighton	ﺩیﻕﺕﻥ
deininger	ﺩیﻥیﻥگﺭ
deisley	ﺩیﺱﻝی
dekel	ﺩیکﻝ
del	ﺩﻝ
delaere	ﺩیﻝﺍیﺭ
delaney	ﺩیﻝﻥی
delciampo	ﺩﻝﺱیﻡپﻭ
deleeuw	ﺩیﻝیﻭ
delemen	ﺩﻝیﻡیﻥ
delikatny	ﺩﻝیکﺍﺕﻥی
delisio	ﺩﻝیﺱیﻭ
dellinger	ﺩیﻝیﻥگﺭ
dellmann	ﺩﻝﻡﺍﻥ
deloris	ﺩﻝﻭﺭیﺯ
delorme	ﺩﻝﻭرﻡﻩ
delouise	ﺩﻝﻭیﺱ
deloura	ﺩﻝﻭﺭﺍ
delrio	ﺩﻝﺭیﻭ
deltuvia	ﺩﻝﺕﻭﻭیﺍ
dema	ﺩیﻡﺍ
demar	ﺩﻡﺍر
demarest	ﺩیﻡﺍﺭﺱﺕ
demark	ﺩیﻡﺍرک
demars	ﺩیﻡﺍﺭﺱ
dematteis	ﺩیﻡﺍﺕیﺱ
demers	ﺩیﻡﺭﺱ
demetrio	ﺩیﻡیﺕﺭیﻭ
demetriou	ﺩیﻡیﺕﺭیﻭ
demke	ﺩﻡکﻩ
demler	ﺩﻡﻝﺭ
demmon	ﺩﻡﻥ
demon	ﺩﻡﻥ
demorest	ﺩﻡﻭرﺱﺕ
demos	ﺩﻡﻭﺱ
dempster	ﺩﻡپﺱﺕﺭ
demuth	ﺩیﻡﺍﺕ
den	ﺩﻥ
denebeim	ﺩیﻥﺏیﻡ
denham	ﺩﻥﻩﺍﻡ
denis	ﺩﻥیﺱ
denkewalter	ﺩﻥکﻭﺍﻝﺕﺭ
denley	ﺩﻥﻝی
denman	ﺩﻥﻡﻥ
dennee	ﺩﻥی
dennell	ﺩیﻥﻝ
denney	ﺩﻥی
denning	ﺩﻥیﻥگ
dennison	ﺩﻥیﺱﻭﻥ
deno	ﺩﻥﻭ
dent	ﺩﻥﺕ
denux	ﺩﻥﻭکﺱ
denyer	ﺩﻥیﺭ
deo	ﺩیﻭ
deol	ﺩیﻭﻝ
depalm	ﺩﻭپﺍﻝﻡ
depaola	ﺩیپﺍیﻭﻝﺍ
depietro	ﺩپیﺕرﻭ
deporter	ﺩیپﺭﺕﺭ
depressive	ﺩیپﺭﺱیﻭ
derby	ﺩﺭﺏی
derienze	ﺩﺭیﻥﺯ
dermott	ﺩﺭﻡﻭﺕ
derrick	ﺩریک
derro	ﺩﺭﻭ
dervenis	ﺩﺭﻭﻥیﺱ
des	ﺩﺯ
desai	ﺩیﺱﺍی
desalvo	ﺩﺱﺍﻝﻭﻭ
desanto	ﺩیﺱﺍﻥﺕﻭ
desgagne	ﺩﺯگﺍگﻥﻩ
desmet	ﺩﺱﻡیﺕ
desmond	ﺩیﺱﻡﻭﻥﺩ
desnoyers	ﺩﺱﻥﻭیﺭﺯ
despopoulos	ﺩیﺱپﺍپیﻭﻝﻭﺱ
desprez	ﺩﺱپرﺯ
desrosiers	ﺩﺱﺭﺍﺯیﺭﺱ
detheridge	ﺩیﺕریﺝ
detlefs	ﺩﺕﻝﻑﺱ
detours	ﺩیﺕﻭﺭﺯ
dettman	ﺩﺕﻡﻥ
detweiler	ﺩﺕﻭیﻝﺭ
devanathan	ﺩیﻭﺍﻥﺍﺕﺍﻥ
devarque	ﺩﺍﻭﺍﺭک
deven	ﺩیﻭﻥ
devender	ﺩﻭیﻥﺩﺭ
devereaux	ﺩﻭﺭﺍﻭکﺱ
deviney	ﺩﻭیﻥی
devisser	ﺩیزر
devito	ﺩﻭیﺕﻭ
devlin	ﺩﺍﻭﻝیﻥ
devries	ﺩیریز
dewan	ﺩیﻭﺍﻥ
dewar	ﺩیﻭﺍﺭ
deweerd	ﺩﻭیرﺩ
dewey	ﺩیﻭی
dewitt	ﺩیﻭیﺕ
dexter	ﺩکﺱﺕﺭ
dezio	ﺩﺯیﻭ
dhiqar	ﺝیکﻭﺍر
diaa	ﺩیﺍ
diab	ﺩیﺍﺏ
diamand	ﺩیﺍﻡﻥﺩ
diamantaras	ﺩیﺍﻡﺍﻥﺕﺍﺭﺍﺱ
diamond	ﺩیﺍﻡﻭﻥﺩ
diana	ﺩیﺍﻥﺍ
diane	ﺩیﺍﻥ
diaz	ﺩیﺍﺯ
dib	ﺩیﺏ
dibble	ﺩﺍیﺏﻝ
dick	ﺩیک
dicke	ﺩیکﻩ
dickens	ﺩیکﻥﺯ
dickerson	ﺩیکﺭﺱﻥ
dickert	ﺩﺍیکﺭﺕ
dickey	ﺩیکی
dickinson	ﺩیکیﻥﺱﻭﻥ
dickman	ﺩیکﻡﻥ
dickow	ﺩیکﻭ
dicky	ﺩیکی
dico	ﺩیکﻭ
die	ﺩﺍی
diederichs	ﺩیﺩیﺭیچﺱ
diedrich	ﺩیﺩﺭیخ
dieglman	ﺩیگﻝﻡﻥ
diego	ﺩیگﻭ
dieleman	ﺩیﻝﻡﺍﻥ
dientje	ﺩیﻥﺕ
dierderick	ﺩیرﺩرک
dierk	ﺩیﺭک
diers	ﺩیﺭﺱ
dieter	ﺩیﺕر
diether	ﺩیﺕﺭ
dietmar	ﺩیﺕﻡﺍﺭ
dievertje	ﺩیرﻭرﺕﺝ
diewertje	ﺩیﻭرﺕ
dighe	ﺩیگﻩ
dighera	ﺩیگﻩﺭﺍ
dike	ﺩﺍیک
dikstra	ﺩیکﺱﺕﺭﺍ
dilan	ﺩیﻝﺍﻥ
dileep	ﺩیﻝیپ
dilemma	ﺩیﻝﻡﺍ
dilip	ﺩیﻝیپ
dill	ﺩیﻝ
dillon	ﺩیﻝﻥ
dillworth	ﺩیﻝﻭﺭث
dilma	ﺩیﻝﻡﺍ
dima	ﺩیﻡﺍ
dimarogonas	ﺩیﻡﺍرﻭگﻥﺍﺱ
dimaryp	ﺩیﻡﺍﺭیپ
dimashq	ﺩیﻡﺍﺵ
dimitri	ﺩیﻡیﺕﺭی
dimitrios	ﺩیﻡیﺕﺭیﻭﺱ
dimitriou	ﺩیﻡیﺕریﻭ
dimitris	ﺩیﻡیﺕﺭیﺱ
dimitry	ﺩیﻡیﺕﺭی
dimock	ﺩیﻡﻭک
din	ﺩیﻥ
dina	ﺩیﻥﺍ
dinah	ﺩیﻥﺍ
dineen	ﺩیﻥﻥ
dinerstein	ﺩیﻥﺭﺍﺱﺕیﻥ
dinesh	ﺩیﻥﺵ
dinghy	ﺩیﻥگی
dingle	ﺩیﻥگﻝ
dingsor	ﺩیﻥگﺱﻭﺭ
dingyi	ﺩیﻥگی
dini	ﺩیﻥی
dinkar	ﺩیﻥکﺍﺭ
dinler	ﺩیﻥﻝﺭ
dinn	ﺩیﻥ
dinno	ﺩیﻥﻭ
dinse	ﺩیﻥﺱ
dinsmoor	ﺩیﻥﺱﻡﻭﺭ
dint	ﺩیﻥﺕ
dinucci	ﺩیﻥﺍکی
diogenes	ﺩیﻭگﻥﺱ
diomedea	ﺩیﺍﻡﺩی
dione	ﺩﺍیﺍﻥ
dionida	ﺩیﻭﻥیﺩﺍ
dionisios	ﺩﺍیﺍﻥیﺱیﺱ
dionne	ﺩیﻭﻥﻩ
dionysia	ﺩﺍیﺍﻥیﺱیﺍ
dipak	ﺩیپﺍک
dipaolo	ﺩیپﺍیﻭﻝﻭ
dipboye	ﺩیپﺏﻭی
dipietro	ﺩیپیﺕﺭﻭ
diplock	ﺩیپﻝﺍک
director	ﺩﺍیﺭکﺕﻭﺭ
dirk	ﺩرک
dirkje	ﺩریک
dirks	ﺩیﺭکﺱ
dirocco	ﺩیﺭﻭکﻭ
dirran	ﺩیرﺍﻥ
dirtbag	ﺩرﺕﺏگ
discher	ﺩیﺱچﺭ
disegi	ﺩیﺱگی
dishaw	ﺩیﺵﺍﻭ
dismal	ﺩیﺱﻡﺍﻝ
disney	ﺩیﺯﻥی
distel	ﺩیﺱﺕﻝ
ditutala	ﺩیﺕﻭﺕﺍﻝﺍ
divakaruni	ﺩیﻭﺍکﺍﺭﻭﻥی
diver	ﺩیﻭﺭ
divertje	ﺩیﻭرﺕ
divide	ﺩیﻭﺍیﺩ
divine	ﺩیﻭﺍیﻥ
divis	ﺩیﻭیﺱ
divya	ﺩیﻭیﺍ
diwana	ﺩیﻭﺍﻥﺍ
dix	ﺩیکﺱ
dixey	ﺩیکﺱی
dixie	ﺩیکﺱﺍی
dixon	ﺩیکﺱﻥ
dixson	ﺩیکﺱﻭﻥ
diya	ﺩیﺍ
diyala	ﺩییﺍﻝﺍ
dizon	ﺩیﺯﻭﻥ
djamila	ﺝﻡیﻝﺍ
doake	ﺩﻭک
doan	ﺩﻭﻥ
dobbins	ﺩﺍﺏیﻥﺯ
dobbratz	ﺩﻭﺏﺭﺍﺕﺯ
dobbs	ﺩﺍﺏﺱ
dobrikin	ﺩﻭﺏﺭیکیﻥ
dobson	ﺩﺍﺏﺱﻭﻥ
dobyns	ﺩﺍﺏیﻥﺯ
dockhorn	ﺩﺍکﻩﻭﺭﻥ
dodamani	ﺩﻭﺩﺍﻡﺍﻥی
dodd	ﺩﺍﺩ
doddek	ﺩﺍﺩک
dodds	ﺩﺍﺩﺱ
dodell	ﺩﻭﺩﻝ
dodge	ﺩﺍﺝ
dodgen	ﺩﺍگﻥ
dodier	ﺩﺍﺩیﺭ
dodson	ﺩﺍﺩﺱﻥ
dog	ﺩﺍگ
dogan	ﺩﻭگﺍﻥ
doggo	ﺩﺍﺩﻭ
dogrusoz	ﺩﻭگرﻭﺱﺯ
dogs	ﺩﺍگﺯ
dogwatch	ﺩﺍگﻭﺍچ
doherty	ﺩﺍﻩﺭﺕی
dohn	ﺩﺍﻥ
doi	ﺩﻭی
doiron	ﺩﻭیﺭﻥ
dokkene	ﺩﺍکﻥ
dolbear	ﺩﺍﻝﺏیﺭ
dole	ﺩﻭﻝ
doleh	ﺩﻝﻩ
dolese	ﺩﺍﻝﺱ
dolin	ﺩﻭﻝیﻥ
dolinar	ﺩﺍﻝیﻥﺍﺭ
dollens	ﺩﺍﻝﻥﺯ
dollin	ﺩﺍﻝیﻥ
dolly	ﺩﺍﻝی
dolman	ﺩﺍﻝﻡﻥ
dolmas	ﺩﺍﻝﻡﺱ
dolores	ﺩﺍﻝﺭﺱ
dolyniuk	ﺩﻭﻝیﻥییﻭک
domba	ﺩﻭﻡﺏﺍ
dome	ﺩﻭﻡ
domen	ﺩﻭﻡﻥ
domenico	ﺩﻭﻡﻥیکﻭ
domeyko	ﺩﻭﻡیکﻭ
domingo	ﺩﻭﻡیﻥگﻭ
domingues	ﺩﺍﻡیﻥگﺱ
dominic	ﺩﻭﻡیﻥیک
dominick	ﺩﻭﻡیﻥیک
dominicus	ﺩﺍﻡیﻥیکﺍﺱ
dominik	ﺩﻭﻡیﻥیک
dominion	ﺩﻭﻡیﻥیﻥ
dominy	ﺩﺍﻡیﻥی
don	ﺩﺍﻥ
dona	ﺩﻭﻥﺍ
donachie	ﺩﻭﻥﺍچی
donaghy	ﺩﻥﺍﻕی
donahue	ﺩﻭﻥﺍﻩﻭ
donald	ﺩﻥﺍﻝﺩ
donati	ﺩﻭﻥﺍﺕی
donetsk	ﺩﻭﻥﺕﺱک
dong	ﺩﺍﻥگ
dongchul	ﺩﺍﻥگچﻭﻝ
dongha	ﺩﻥگﺍ
dongil	ﺩﺍﻥﺝیﻝ
dongjin	ﺩﺍﻥگﺝیﻥ
dongtai	ﺩﺍﻥگﺕﺍی
dongwei	ﺩﺍﻥگﻭی
dongyu	ﺩﺍﻥگیﻭ
doninck	ﺩﺍﻥیﻥک
donini	ﺩﻭﻥیﻥی
donn	ﺩﺍﻥ
donnelly	ﺩﺍﻥﻝی
donner	ﺩﺍﻥﺭ
donny	ﺩﺍﻥی
donohue	ﺩﺍﻥﻭﻩﻭ
donovan	ﺩﺍﻥﺍﻭﺍﻥ
dooley	ﺩﺍﻝی
doolin	ﺩﻭﻝیﻥ
dooris	ﺩﻭﺭیﺱ
doortje	ﺩرﺕﻩ
doppelt	ﺩﻭپﻝﺕ
doppler	ﺩﻭپﻝﺭ
dora	ﺩﻭﺭﺍ
doran	ﺩﻭﺭﺍﻥ
dorathee	ﺩرﺍﺕی
dorazio	ﺩﻭﺭﺍﺯیﻭ
dorchuck	ﺩﻭﺭچﺍک
dordal	ﺩﻭﺭﺩﺍﻝ
dorel	ﺩﻭﺭﻝ
doren	ﺩﻭﺭﻥ
dorfman	ﺩﻭﺭﻑﻡﺍﻥ
dorian	ﺩﻭﺭیﺍﻥ
dorie	ﺩﻭﺭی
dorin	ﺩﻭریﻥ
dorinda	ﺩﻭﺭیﻥﺩﺍ
doris	ﺩﻭﺭیﺱ
dork	ﺩﻭرک
dorken	ﺩﻭﺭکﻥ
dorma	ﺩﻭﺭﻡﺍ
dorn	ﺩﻭﺭﻥ
doron	ﺩﺍﺭﻭﻥ
dorothy	ﺩﻭﺭﻭﺕی
dorrer	ﺩﻭرر
dortchen	ﺩرﺕچﻥ
dorthy	ﺩﻭﺭثی
dorward	ﺩﻭﺭﻭﺍﺭﺩ
dorwin	ﺩﻭﺭﻭیﻥ
dory	ﺩﻭﺭی
doseok	ﺩﺍﺱیﻭک
doskow	ﺩﺍﺱکﻭ
doss	ﺩﺍﺱ
dossett	ﺩﺍﺱﺕ
dossing	ﺩﺍﺱیﻥگ
dostalik	ﺩﻭﺱﺕﺍﻝیک
dotson	ﺩﺍﺕﺱﻭﻥ
dotten	ﺩﺍﺕﻥ
dottie	ﺩﺍﺕی
dou	ﺩﻭ
douanier	ﺩﻭﺍﻥیﺭ
doucas	ﺩﺍکﺍﺱ
douglas	ﺩﺍگﻝﺍﺱ
douglass	ﺩﺍگﻝﺍﺱ
douhour	ﺩﻭﻩﻭﺭ
doulas	ﺩﺍﻝﺍﺱ
doumakes	ﺩﻭﻡیکﺯ
doupnik	ﺩﺍپﻥیک
dout	ﺩﺍﻭﺕ
douwe	ﺩﻭﻭ
dov	ﺩﺍﻭ
dovell	ﺩﻭﻭﻝ
dovers	ﺩﺍﻭﺭﺱ
dow	ﺩﺍﻭ
dowaliby	ﺩﻭﺍﻝیﺏﺍی
dowd	ﺩﻭﺩ
dowler	ﺩﻭﻝﺭ
dowling	ﺩﺍﻝیﻥگ
down	ﺩﺍﻭﻥ
downes	ﺩﻭﻥﺱ
downey	ﺩﺍﻭﻥی
downs	ﺩﺍﻭﻥﺯ
dowswell	ﺩﺍﻭﺱﻭﻝ
dox	ﺩﺍکﺱ
doyal	ﺩﻭیﺍﻝ
doyle	ﺩﻭیﻝ
dozier	ﺩﻭﺯییﺭ
drader	ﺩﺭﺍﺩﺭ
dragan	ﺩﺭﺍگﺍﻥ
dragomir	ﺩﺭگﻭﻡیﺭ
dragon	ﺩﺭگﻭﻥ
dragons	ﺩﺭگﻭﻥﺱ
dragos	ﺩﺭﺍگﻭﺯ
draine	ﺩﺭﺍیﻥﻩ
drake	ﺩﺭیک
dralle	ﺩﺭﺍﻝ
dramatis	ﺩﺭﺍﻡﺍﺕیﺱ
draper	ﺩﺭﺍپﺭ
dratman	ﺩﺭﺍﺕﻡﻥ
dream	ﺩﺭیﻡ
dreams	ﺩﺭیﻡﺯ
dreary	ﺩﺭیﺭی
drebes	ﺩﺭﺏﺱ
dreher	ﺩﺭیﻩﺭ
dreier	ﺩﺭیﺭ
drennen	ﺩﺭﻥﻥ
drenter	ﺩﺭﻥﺕﺭ
dressner	ﺩﺭﺱﻥﺭ
drew	ﺩﺭیﻭ
drewe	ﺩﺭیﻭ
drewery	ﺩﺭﻭﺭی
drewett	ﺩریﻭﺕ
drexel	ﺩﺭکﺱﻝ
drexler	ﺩﺭکﺱﻝﺭ
dreyer	ﺩﺭﺍیﺭ
dreyfus	ﺩﺭیﻑﻭﺱ
dridge	ﺩﺭیﺩﺝی
drikha	ﺩﺭیخﺍ
drinks	ﺩﺭیﻥکﺱ
drinkwater	ﺩﺭیﻥکﻭﺍﺕﺭ
driscoll	ﺩﺭیﺱکﻭﻝ
driskill	ﺩﺭیﺱکیﻝ
drnek	ﺩﺭﻥک
drodge	ﺩﺭﺍﺝ
drolet	ﺩﺭﺍﻝﺕ
droomer	ﺩﺭﻭﻡﺭ
drop	ﺩﺭﺍپ
drosehn	ﺩﺭﻭﺯﻥ
droste	ﺩﺭﺍﺱﺕ
drout	ﺩﺭﻭﺕ
drover	ﺩﺭﺍﻭﺭ
drown	ﺩﺭﺍﻭﻥ
druding	ﺩﺭﻭﺩیﻥگ
drudis	ﺩﺭﻭﺩیﺱ
druger	ﺩﺭﺍگﺭ
drukier	ﺩﺭﺍکیﺭ
drukman	ﺩﺭﺍکﻡﻥ
drum	ﺩﺭﺍﻡ
drune	ﺩﺭﻭﻥی
drury	ﺩرﺍری
drying	ﺩﺭیﻥگ
dua	ﺩیﻭﺍ
duan	ﺩﻭﺍﻥ
duane	ﺩﻭﺍیﻥ
duarte	ﺩﻭﺍﺭﺕﻩ
dubach	ﺩﺍﺏﺍچ
dubay	ﺩﻭﺏﺍی
dubear	ﺩﻭﺏیﺭ
dubeau	ﺩﻭﺏیﻭ
dubey	ﺩﻭﺏی
dubiel	ﺩﺍﺏیﻝ
dubinsky	ﺩﺍﺏیﻥﺱکی
dubose	ﺩﺍﺏﻭﺱ
dubris	ﺩﻭﺏﺭیﺯ
dubuc	ﺩﺍﺏﺍﺱ
duc	ﺩﺍک
ducharme	ﺩﻭچﺍﺭﻡ
duchaylard	ﺩﻭچﺍیﻝﺍﺭﺩ
duck	ﺩﺍک
duckering	ﺩﺍکﺭیﻥگ
duckman	ﺩﺍکﻡﻥ
duclaux	ﺩﺍکﻝﺍکﺱ
ducloz	ﺩﺍکﻝﻭﺯ
ducu	ﺩﺍکﺍ
dudgeon	ﺩﺍﺝیﻭﻥ
dudley	ﺩﺍﺩﻝی
dueber	ﺩﻭﺍﺏﺭ
dueck	ﺩﻭﺍک
duemler	ﺩﺍﻡﻝﺭ
duening	ﺩﻭیﻥیﻥگ
duerr	ﺩﻭیﺭ
duff	ﺩﺍﻑ
dufour	ﺩﻭﻑﻭﺭ
dug	ﺩﺍگ
dugan	ﺩﺍگﺍﻥ
dugger	ﺩﺍگﺭ
duha	ﺩیﻭﻩﺍ
duhamel	ﺩﺍﻩﺍﻡﻝ
duhon	ﺩﺍﻩﻥ
duhur	ﺩﺍﻩﻭر
duickinck	ﺩﻭچیﻥچ
duk	ﺩﺍک
duke	ﺩﺍک
dukes	ﺩﻭکﺱ
dulberger	ﺩﺍﻝﺏﺭگﺭ
dulfer	ﺩﺍﻝﻑﺭ
dumbbell	ﺩﺍﻡﺏﻝ
dumitru	ﺩﺍﻡیﺕﺭﻭ
dumont	ﺩﻭﻡﻭﻥﺕ
dumontet	ﺩﺍﻡﻭﻥﺕﺕ
dumpleton	ﺩﺍﻡپﻝﺕﻭﻥ
dun	ﺩﺍﻥ
dunae	ﺩﻭﻥﺍی
duncan	ﺩﺍﻥکﺍﻥ
dundas	ﺩﺍﻥﺩﺍﺱ
dundee	ﺩﺍﻥﺩی
dunedin	ﺩﺍﻥیﺩیﻥ
dunford	ﺩﺍﻥﻑﺭﺩ
dung	ﺩﺍﻥگ
dungeon	ﺩﺍﻥگیﻭﻥ
dunham	ﺩﺍﻥﻩﺍﻡ
dunki	ﺩﺍﻥکی
dunlap	ﺩﺍﻥﻝﻭپ
dunn	ﺩﺍﻥ
dunne	ﺩﺍﻥﻩ
dunphy	ﺩﺍﻥﻑی
dunsmore	ﺩﺍﻥﺱﻡﻭﺭ
dunstan	ﺩﺍﻥﺱﺕﺍﻥ
dunster	ﺩﺍﻥﺱﺕﺭ
dunten	ﺩﺍﻥﺕﻥ
duorah	ﺩﻭﺭﺍﻩ
duparc	ﺩﺍپﺭک
duperre	ﺩﺍپﺭﺭی
dupliactor	ﺩﻭپﻝیکﺕﻭﺭ
duprie	ﺩﻭپﺭی
dupuis	ﺩﻭپیﻭیﺱ
dupuy	ﺩﺍپﺍی
durand	ﺩﻭﺭﺍﻥﺩ
durham	ﺩﺍﺭﻩﺍﻡ
durkee	ﺩﺍﺭکی
duross	ﺩﻭﺭﺍﺱ
durr	ﺩﺍﺭ
durrance	ﺩﻭﺭﺭﺍﻥﺱ
durrand	ﺩﺍرﺍﻥگ
durupt	ﺩﻭﺭﺍپﺕ
dusek	ﺩﺍﺱک
dusen	ﺩﻭﺱﻥ
dusky	ﺩﻭﺱکی
dusty	ﺩﻭﺱﺕی
duthoit	ﺩﺍﺕﻭیﺕ
dutta	ﺩﻭﺕﺍ
dutton	ﺩﺍﺕﻭﻥ
duval	ﺩﺍﻭﻝ
duvivier	ﺩﻭیﻭیﺭ
duy	ﺩﺍی
duyckinck	ﺩﺍیچیﻥچ
duzat	ﺩﻭﺯﺍﺕ
dwain	ﺩﺍیﻥ
dwaine	ﺩﺍیﻥ
dwight	ﺩﺍیﺕ
dworkin	ﺩﻭﺭکیﻥ
dyballa	ﺩﺍیﺏﺍﻝﺍ
dyer	ﺩﺍیﺭ
dyet	ﺩﺍیﺕ
dykes	ﺩﺍکﺯ
dykins	ﺩیکیﻥز
dylan	ﺩیﻝﻥ
dyment	ﺩﺍیﻡﻥﺕ
dymond	ﺩﺍیﻡﻭﻥﺩ
dyna	ﺩیﻥﺍ
dynamite	ﺩیﻥﺍﻡیﺕ
dyson	ﺩیﺱﻭﻥ
eachus	ﺍیچﺍﺱ
eadie	ﺍﺩی
eady	ﺍیﺩی
eagle	ﺍگﻝ
eaglestone	ﺍگﻝﺱﺕﻭﻥ
eales	ﺍیﻝﺯ
eamon	ﺍیﻡﻭﻥ
eannarino	ﺍیﻥﺍﺭیﻥﻭ
earl	ﺍیﺭﻝ
earle	ﺍﺭﻝ
earley	ﺍﺭﻝی
early	ﺍیﺭﻝی
earnest	ﺍیﺭﻥﺱﺕ
earp	ﺍیﺭپ
eason	ﺍیﺱﺍﻥ
eassa	ﺍیﺱﺍ
eastburn	ﺍیﺱﺕﺏﺭﻥ
easter	ﺍیﺱﺕﺭ
easterbrook	ﺍیﺱﺕﺭﺏﺭﻭک
eastick	ﺍیﺱﺕیک
eastlake	ﺍﺱﺕﻝیک
eastland	ﺍیﺱﺕﻝﻥﺩ
eastman	ﺍیﺱﺕﻡﻥ
eastway	ﺍیﺱﺕﻭی
eastwood	ﺍیﺱﺕﻭﻭﺩ
eater	ﺍیﺕﺭ
ebach	ﺍیﺏﺍچ
ebbert	ﺍﺏﺭﺕ
ebdon	ﺍﺏﺩﻭﻥ
ebe	ﺍﺏی
eberbach	ﺍﺏﺭﺏﺍچ
eberle	ﺍﺏﺭﻝی
eberly	ﺍﺏﺭﻝی
eberts	ﺍﺏﺭﺕﺯ
ebina	ﺍﺏیﻥﺍ
eboreime	ﺍﺏﻭﺭیﻡﻩ
ebrahim	ﺍﺏرﺍﻩیﻡ
ebright	ﺍﺏﺭﺍیﺕ
ech	ﺍچ
eck	ﺍک
eckam	ﺍیکﺍﻡ
ecker	ﺍکﺭ
eckersand	ﺍکﺭﺱﺍﻥﺩ
eckert	ﺍکﺭﺕ
eckman	ﺍکﻡﻥ
eckstein	ﺍکﺱﺕیﻥ
eckton	ﺍکﺕﻭﻥ
edara	ﺍﺩﺍﺭﺍ
eddy	ﺍﺩی
edelman	ﺍﺩﻝﻡﻥ
edelson	ﺍﺩﻝﺱﻭﻥ
edenborough	ﺍیﺩﻥﺏﻭرگ
edgar	ﺍﺩگﺍر
edgington	ﺍﺩگیﻥگﺕﻭﻥ
edmiston	ﺍﺩﻡیﺱﺕﻭﻥ
edmonds	ﺍﺩﻡﻭﻥز
edsall	ﺍﺩﺱﺍﻝ
eduwart	ﺍﺩﻭﺍرﺕ
edward	ﺍﺩﻭﺍﺭﺩ
edwards	ﺍﺩﻭﺍرﺩز
edwardsson	ﺍﺩﻭﺍﺭﺩﺱﻥ
eeltje	ﺍیﻝﺕﺝ
egan	ﺍیگﺍﻥ
eggeman	ﺍگﻡﻥ
eggert	ﺍیگﺭﺕ
eggington	ﺍﺝیﻥگﺕﻭﻥ
egli	ﺍیگﻝی
egmose	ﺍگﻡﻭﺯ
egnor	ﺍیگﻥﻭر
eidam	ﺍیﺩﻡﻥ
eidsson	ﺍﺩﺱﻭﻥ
eidswick	ﺍﺩﺱﻭیک
eileen	ﺍیﻝیﻥ
einstein	ﺍﻥیﺵﺕیﻥ
eirik	ﺍیﺭیک
eisele	ﺍیﺯﻝ
eisert	ﺍیﺱﺭﺕ
eisner	ﺍﺵﻥﺭ
ekberg	ﺍکﺏﺭگ
ekerslato	ﺍکرﺱﺕﻭ
eklund	ﺍکﻝﺍﻥﺩ
ekman	ﺍکﻡﺍﻥ
ekmundensis	ﺍکﻡﺍﻥﺩﺱیﺱ
ekstrand	ﺍکﺱﺕﺭﻥﺩ
elangco	ﺍﻝﺍﻥگکﻭ
eldin	ﺍﻝﺩیﻥ
eldridge	ﺍﻝﺩﺭیﺝ
elena	ﺍﻝﻥﺍ
elf	ﺍﻝﻑ
elfering	ﺍﻝﻑﺭیﻥگ
elfner	ﺍﻝﻑﻥﺭ
eliason	ﺍﻝیﺍﺱﻭﻥ
elie	ﺍﻝی
eliot	ﺍیﻝﻭﺕ
elison	ﺍﻝیﺱﻭﻥ
elizabeth	ﺍﻝیزﺍﺏﺕ
elkan	ﺍﻝکﺍﻥ
elke	ﺍﻝک
elkin	ﺍﻝکیﻥ
elkington	ﺍﻝکیﻥگﺕﻥ
elkinton	ﺍﻝکیﻥﺕﻥ
ellam	ﺍﻝﺍﻡ
ellefsen	ﺍﻝﻑﺱﻥ
ellegaard	ﺍﻝگﺍﺭﺩ
ellen	ﺍﻝﻥ
eller	ﺍﻝر
ellerbeck	ﺍﻝﺭﺏک
ellert	ﺍﻝرﺕ
ellery	ﺍﻝﺭی
elletson	ﺍﻝﺕﺱﻭﻥ
ellinger	ﺍﻝیﻥگﺭ
elliot	ﺍﻝیﻭﺕ
elliott	ﺍیﻝﻭیﺕ
ellipsoid	ﺍﻝیپﺱﻭیﺩ
ellison	ﺍﻝیﺱﻭﻥ
elliston	ﺍﻝیﺱﺕﻭﻥ
ellsweig	ﺍﻝﺱﻭیگ
ellwood	ﺍﻝﻭﻭﺩ
elman	ﺍﻝﻡﻥ
elmar	ﺍﻝﻡﺍﺭ
elmer	ﺍﻝﻡر
elmers	ﺍﻝﻡﺭﺱ
elmo	ﺍﻝﻡﻭ
elmoman	ﺍﻝﻡﻭﻡﺍﻥ
elmore	ﺍﻝﻡﻭﺭ
elmquist	ﺍﻝﻡکﻭﺍﺱﺕ
elof	ﺍﻝﻭﻑ
eloy	ﺍﻝﻭی
elroy	ﺍﻝﺭﻭی
elsberry	ﺍﻝﺱﺏﺭی
elsje	ﺍﻝﺝﻩ
elsner	ﺍﻝﺱﻥﺭ
elson	ﺍﻝﺱﻭﻥ
eltanin	ﺍﻝﺕﺍﻥیﻥ
elvers	ﺍﻝﻭﺭﺱ
elwin	ﺍﻝﻭیﻥ
elwood	ﺍﻝﻭﻭﺩ
elwyn	ﺍﻝﻭیﻥ
ely	ﺍﻝی
elyse	ﺍﻝیﺱ
elz	ﺍﻝﺯ
elza	ﺍﻝﺯﺍ
emad	ﻉﻡﺍﺩ
emanuele	ﺍﻡﺍﻥﻭیﻝﻩ
emarit	ﺍﻡﺍریﺕ
embar	ﺍﻡﺏﺍﺭ
embassy	ﺍﻡﺏﺍﺱی
emberley	ﺍﻡﺏﺭﻝی
emberling	ﺍﻡﺏﺭﻝیﻥگ
emel	ﺍیﻡﻝ
emerging	ﺍﻡﺭﺝیﻥگ
emerson	ﺍیﻡرﺱﻭﻥ
emilie	ﺍﻡیﻝی
emilio	ﺍﻡیﻝییﻭ
emily	ﺍﻡیﻝی
emit	ﺍﻡیﺕ
emlen	ﺍﻡﻝﻥ
emm	ﺍﻡ
emma	ﺍﻡﺍ
emmanuel	ﺍﻡﺍﻥیﻭﻝ
emmen	ﺍﻡﻥ
emmerson	ﺍﻡرﺱﻭﻥ
emmert	ﺍﻡرﺕ
emmetie	ﺍﻡیﺕی
emmett	ﺍﻡیﺕ
emmons	ﺍیﻡﺍﻥﺱ
emona	ﺍﻡﻭﻥﺍ
emory	ﺍﻡﻭﺭی
emperor	ﺍﻡپﺭﻭﺭ
empey	ﺍﻡپی
empleo	ﺍﻡپﻝیﻭ
empranthiri	ﺍیﻡپﺭﺍﻥﺕیﺭی
empson	ﺍﻡپﺱﻭﻥ
emre	ﺍﻡﺭ
ems	ﺍﻡﺱ
emyr	ﺍﻡیﺭ
ender	ﺍﻥﺩﺭ
enderborg	ﺍﻥﺩﺭﺏﻭﺭگ
enderby	ﺍﻥﺩﺭﺏی
endesworth	ﺍیﻥﺩﺱﻭرﺙ
endre	ﺍﻥﺩﺭ
endurance	ﺍﻥﺩییﻭﺭﺍﻥﺱ
enerio	ﺍﻥﺭیﻭ
enete	ﺍﻥﺕ
enfant	ﺍﻥﻑﺍﻥﺕ
enfield	ﺍﻥﻑیﻝﺩ
eng	ﺍﻥگ
engaged	ﺍیﻥگیﺝﺩ
engebretsen	ﺍﻥگﺏﺭﺕﺱﻥ
engebretson	ﺍﻥﺝﺏﺭﺕﺱﻭﻥ
engelholm	ﺍﻥگﻝﻩﻝﻡ
engelhorn	ﺍﻥگﻝﻩﻭﺭﻥ
engels	ﺍﻥگﻝﺯ
engelsma	ﺍﻥگﻝﺍﺱﻡﺍ
engelson	ﺍﻥگﻝﺱﻭﻥ
engeltje	ﺍﻥگﻝﺕﺝ
engi	ﺍﻥﺝی
engin	ﺍﻥﺝیﻥ
england	ﺍﻥگﻝﻥﺩ
englander	ﺍﻥگﻝﺍﻥﺩﺭ
engle	ﺍﻥگﻝ
english	ﺍیﻥگﻝیﺵ
englund	ﺍﻥگﻝﺍﻥﺩ
enhua	ﺍﻥﻩییﻭﺍ
enis	ﺍﻥیﺱ
enkerli	ﺍﻥکﺭﻝی
ennis	ﺍﻥیﺱ
enno	ﺍﻥﻭ
eno	ﺍﻥﻭ
enoksson	ﺍیﻥﻭکﺱﻥ
enos	ﺍﻥﻭﺱ
enotiadis	ﺍﻥﻭﺕییﺍﺩیﺱ
enric	ﺍﻥﺭیک
enrique	ﺍﻥﺭیکیﻭ
enriquez	ﺍﻥﺭیکییﻭﺯ
entje	ﺍﻥﺕ
entrance	ﺍیﻥﺕرﻥﺱ
entrikin	ﺍﻥﺕﺭیکیﻥ
entropy	ﺍﻥﺕﺭﺍپی
envoy	ﺍﻥﻭﻭی
enyart	ﺍﻥیﺍﺭﺕ
enying	ﺍﻥیﻥگ
enyo	ﺍﻥییﻭ
enzinger	ﺍﻥﺯیﻥگﺭ
eos	ﺍیﻭﺱ
eosin	ﺍیﻭﺱیﻥ
ephraim	ﺍﻑﺭﺍیﻡ
epje	ﺍپ
epler	ﺍپﻝر
epp	ﺍپ
epperly	ﺍپﺭﻝی
epperson	ﺍیپﺭﺱﻭﻥ
eppert	ﺍیپﺭﺕ
eppstein	ﺍپیﺱﺕیﻥ
epshteyn	ﺍپﺵﺕیﻥ
epsilon	ﺍپﺱیﻝﻭﻥ
epstein	ﺍپﺱﺕیﻥ
equatorial	ﺍکییﻭﺍﺕﻭریﺍﻝ
erach	ﺍﺭﺍﺵ
eran	ﺍﺭﺍﻥ
erann	ﺍﺭﺍﻥ
erasmus	ﺍﺭﺍﺱﻡﻭﺱ
erben	ﺍﺭﺏﻥ
ercolessi	ﺍﺭکﻭﻝﺱی
erdem	ﺍﺭﺩﻡ
eremin	ﺍﺭﻡیﻥ
erewhon	ﺍرﻭﻭﻥ
erez	ﺍﺭﺯ
erginel	ﺍرﺝیﻥﻝ
erhard	ﺍﺭﻩﺍﺭﺩ
eric	ﺍﺭیک
erica	ﺍﺭیکﺍ
erich	ﺍﺭیچ
erick	ﺍﺭیک
erickson	ﺍﺭیکﺱﻭﻥ
erik	ﺍﺭیک
erika	ﺍﺭیکﺍ
eriksen	ﺍﺭیکﺱﻥ
eriksson	ﺍﺭیکﺱﻭﻥ
erin	ﺍﺭیﻥ
erman	ﺍرﻡﺍﻥ
ernest	ﺍﺭﻥﺱﺕ
ernst	ﺍرﺱﺕ
eronen	ﺍﺭﻭﻥﻥ
errico	ﺍﺭیکﻭ
ersheid	ﺍﺭﺵیﺩ
erskine	ﺍﺭﺱکﺍیﻥ
ertle	ﺍﺭﺕﻝ
escalante	ﺍﺱکﺍﻝﺍﻥﺕ
escmundelf	ﺍکﻡﻭﻥﺩﻝﻑ
eskeldson	ﺍﺱکﻝﺩﺱﻭﻥ
esker	ﺍﺱکﺭ
eskite	ﺍﺱکﺍیﺕ
eskra	ﺍﺱکرﺍ
esler	ﺍﺱﻝﺭ
esquibel	ﺍﺱکﻭیﺏﻝ
esquivel	ﺍﺱکﻭیﻭیﻝ
ess	ﺍﺱ
estabrooks	ﺍﺱﺕﺍﺏﺭﻭکﺯ
estanol	ﺍﺱﺕﺍﻥﻭﻝ
esteves	ﺍﺱﺕیﻭﺱ
etesse	ﺍﺕیﺯ
ethilrede	ﺍﺕیﻝرﺩ
etienne	ﺍﺕیﻥی
etkins	ﺍﺕکیﻥﺯ
etters	ﺍﺕﺭﺯ
etue	ﺍﺕﻭ
eugenio	ﺍﻭگﻥیﻭ
eustis	ﺍیﻭﺱﺕیﺱ
evan	ﺍیﻭﺍﻥ
evangelista	ﺍﻭﻥگﻝیﺱﺕﺍ
eve	ﺍﻭﻩ
evelyn	ﺍیﻭﻝیﻥ
evens	ﺍیﻭﻥﺱ
evenson	ﺍﻭﻥﺱﻭﻥ
everett	ﺍﻭﻭﺭﺕ
evers	ﺍیﻭﺭﺱ
eversberg	ﺍﻭﺭﺱﺏﺭگ
everts	ﺍﻭﺭﺕﺱ
ewacha	ﺍﻭﺍچﺍ
ewald	ﺍیﻭﺍﻝﺩ
ewing	ﺍیﻭﺍیﻥگ
ewins	ﺍﻭیﻥﺯ
excretia	ﺍکﺱکﺭیﺕیﺍ
exile	ﺍکﺱﺍیﻝ
express	ﺍکﺱپﺭﺱ
exter	ﺍکﺱﺕر
eye	ﺍی
eyes	ﺍیﺯ
eyles	ﺍیﻝیﺱ
eyman	ﺍیﻡﻥ
eynon	ﺍیﻥﻭﻥ
eyntje	ﺍیﻥژ
eyre	ﺍیﺭ
eyster	ﺍیﺱﺕﺭ
ezor	ﺍﺯﺭ
fabbro	ﻑﺏﺭﻭ
faber	ﻑیﺏﺭ
fabiano	ﻑﺍﺏیﺍﻥﻭ
fabre	ﻑﺍﺏﺭﻩ
fabris	ﻑﺍﺏﺭیﺱ
fabro	ﻑﺍﺏﺭﻭ
face	ﻑیﺱ
fadia	ﻑﺍﺩیﺍ
fadil	ﻑﺍﺩیﻝ
fadila	ﻑﺍﺩیﻝﺍ
fadl	ﻑﺍﺩﻝ
fagans	ﻑﺍگﺍﻥﺱ
fagen	ﻑﺍﺝﻥ
fahd	ﻑﺍﺩ
fahima	ﻑﻩیﻡﺍ
fairbairn	ﻑیﺭﺏﺭیﻥ
fairbank	ﻑﺍیﺭﺏﺍﻥک
fairen	ﻑیرﻥ
fairuz	ﻑیرﻭز
fairweather	ﻑیﺭﻭﺩﺭ
faiz	ﻑیﺽ
faiza	ﻑیﺽﺍ
faizel	ﻑیﺽﻝ
fakhri	ﻑﺍﺥری
fakhriyya	ﻑﺥرییﺍ
falchuk	ﻑﺍﻝچﻭک
falco	ﻑﺍﻝکﻭ
falconer	ﻑﺍﻝکﻭﻥﺭ
falk	ﻑﺍﻝک
fallate	ﻑﻝﺍﺕ
fallon	ﻑﺍﻝﻭﻥ
fan	ﻑﻥ
fandrich	ﻑﺍﻥﺩﺭیچ
fane	ﻑﻥی
fang	ﻑﻥگ
fanger	ﻑﻥگﺭ
fannin	ﻑﻥیﻥ
farag	ﻑرگ
farago	ﻑﺍﺭﺍگﻭ
farah	طرﺍﺡ
farer	ﻑﺭﺭ
farid	ﻑریﺩ
farida	ﻑریﺩﺍ
faris	ﻑریﺱ
farkas	ﻑﺍﺭکﺍﺱ
farmer	ﻑﺍﺭﻡﺭ
farooq	طﺍرﻕ
farouk	ﻑرﻭک
farrah	طرﺍﺡ
farrell	ﻑﺍﺭﻝ
farrigan	ﻑﺍﺭیگﺍﻥ
farrington	ﻑﺍﺭیﻥگﺕﻭﻥ
farrior	ﻑﺍﺭیﻭﺭ
farris	ﻑﺍریﺱ
farrugia	ﻑﺍﺭﻭگیﺍ
farry	ﻑﺍﺭی
farwaniyah	ﻑرﻭﺍﻥیﺍﻩ
fasel	ﻑﺍﺱﻝ
fash	ﻑﺍﺵ
fason	ﻑیﺱﻭﻥ
fast	ﻑﺱﺕ
fatima	ﻑﺍطیﻡﺍ
fatin	ﻑﺍﺕیﻥ
faubert	ﻑﺍﺏﺭﺕ
faucett	ﻑﺍﻭﺱﺕ
faucher	ﻑﺍﻭچﺭ
faught	ﻑﺍﻭﺕ
faulkner	ﻑﺍﻝکﻥﺭ
faultless	ﻑﺍﻝﺕﻝﺱ
faunce	ﻑﺍﻭﻥﺱ
faunt	ﻑﺍﻭﻥﺕ
fausett	ﻑﺍﻭﺱﺕ
favelle	ﻑﺍﻭﻝﻩ
fawaris	ﻑﺍﻭﺍریﺱ
fawaz	ﻑﺍﻭﺍﺯ
fawzi	ﻑﺍزی
fay	ﻑی
fayette	ﻑﺍیﺕ
fayiz	ﻑﺍیز
fayne	ﻑﺍیﻥ
fazio	ﻑﺍﺯیﻭ
fearn	ﻑیﺭﻥ
feck	ﻑک
feder	ﻑﺩﺭ
federle	ﻑﺩﺭﻝ
federman	ﻑﺩﺭﻡﻥ
fedor	ﻑیﺩﻭﺭ
feeken	ﻑیکﻥ
feely	ﻑیﻝی
feenan	ﻑیﻥﺍﻥ
feeney	ﻑیﻥی
feil	ﻑیﻝ
feiler	ﻑیﻝﺭ
feist	ﻑیﺱﺕ
felder	ﻑﻝﺩﺭ
feldman	ﻑﻝﺩﻡﺍﻥ
feldmar	ﻑﻝﺩﻡﺍﺭ
feldspar	ﻑﻝﺩﺱپﺍﺭ
felice	ﻑﻝﺍیﺱ
felices	ﻑﻝیﺱﺯ
felix	ﻑﻝیکﺱ
felizardo	ﻑﻝیﺯﺍﺭﺩﻭ
felteau	ﻑﻝﺕیﻭ
femea	ﻑﻡیﺍ
femmetje	ﻑیﻡیﺝﻩ
fenchurch	ﻑﻥچﺍﺭچ
fender	ﻑﻥﺩﺭ
feng	ﻑﻥگ
fengstad	ﻑﻥگﺱﺕﺍﺩ
fenn	ﻑﻥ
fennis	ﻑیﻥیﺱ
fenno	ﻑﻥﻭ
fensel	ﻑﻥﺱﻝ
fenske	ﻑﻥﺱکی
fentiman	ﻑﻥﺕیﻡﺍﻥ
fenton	ﻑﻥﺕﻭﻥ
fenyes	ﻑﻥیﺱ
fera	ﻑﺭﺍ
ferdig	ﻑﺭﺩیگ
ferdinand	ﻑﺭﺩﺍیﻥﻥﺩ
ferguson	ﻑﺭگﻭﺱﻥ
fermier	ﻑﺭﻡیﺭ
fernandez	ﻑﺭﻥﺍﻥﺩﺯ
fernando	ﻑﺭﻥﺍﻥﺩﻭ
ferran	ﻑرﺍﻥ
ferrari	ﻑﺭﺍﺭی
ferree	ﻑﺭی
ferreira	ﻑریرﺍ
ferrian	ﻑریﺍﻥ
ferrier	ﻑﺭیﺭ
ferris	ﻑﺭیﺱ
fertik	ﻑﺭﺕیک
ferworn	ﻑرﻭرﻥ
fesler	ﻑﺱﻝر
fetchen	ﻑﺕچﻥ
fetra	ﻑﺕﺭﺍ
fetter	ﻑﺕﺭ
fetters	ﻑیﺕرﺯ
feustel	ﻑیﻭﺱﺕﻝ
fiarito	ﻑیﺍﺭیﺕﻭ
fiasconaro	ﻑیﺍﺱکﻭﻥﺍﺭﻭ
fick	ﻑیک
fickling	ﻑیکﻝیﻥگ
fidalgo	ﻑیﺩﺍﻝگﻭ
fidel	ﻑیﺩﻝ
fidler	ﻑیﺩﻝﺭ
fiedler	ﻑیﺩﻝر
field	ﻑیﻝﺩ
fields	ﻑیﻝﺩﺯ
fielek	ﻑیﻝک
fife	ﻑﺍیﻑ
fifer	ﻑیﻑﺭ
figard	ﻑیگﺍﺭﺩ
figura	ﻑیگﻭﺭﺍ
fike	ﻑﺍیک
fikriyya	ﻑکری
filias	ﻑیﻝیﺍﺱ
fils	ﻑﺍیﻝﺱ
filzek	ﻑیﻝﺯک
fin	ﻑیﻥ
finan	ﻑیﻥﺍﻥ
finberg	ﻑیﻥﺏرگ
finch	ﻑیﻥچ
findlow	ﻑیﻥﺩﻝﻭ
finelli	ﻑیﻥﻝی
finerty	ﻑﺍیﻥﺭﺕی
finesse	ﻑیﻥﺱ
finestone	ﻑﺍیﻥﺱﺕﻭﻥ
finger	ﻑیﻥگر
finke	ﻑﺍیﻥک
finkel	ﻑیﻥکﻝ
finkle	ﻑیﻥکﻝ
finlay	ﻑیﻥﻝی
finlayson	ﻑیﻥﻝﺍیﺱﻭﻥ
finley	ﻑیﻥﻝی
finn	ﻑیﻥ
finney	ﻑﺍیﻥﻥی
finnin	ﻑیﻥیﻥ
finnis	ﻑیﻥیﺱ
finton	ﻑﺍیﻥﺕﻭﻥ
fiore	ﻑیﻭﺭ
firma	ﻑیﺭﻡﺍ
fish	ﻑیﺵ
fishbein	ﻑیﺵﺏیﻥ
fisher	ﻑیﺵﺭ
fisk	ﻑیﺱک
fitch	ﻑیﺕچ
fitta	ﻑیﺕﺍ
fittery	ﻑیﺕری
fitts	ﻑیﺕﺱ
fitzgerald	ﻑیﺕﺯﺝﺭﺍﻝﺩ
fitzwell	ﻑیﺕﺯﻭﻝ
fitzwilliam	ﻑیﺕﺯﻭیﻝیﺍﻡ
fix	ﻑیکﺱ
flaglelee	ﻑﻝﺍگﻝﻝی
flaherty	ﻑﻝﺍﻩﺭﺕی
flame	ﻑﻝیﻡ
flanagan	ﻑﻝﺍﻥﺍگﺍﻥ
flardinga	ﻑﻝﺍرﺩیﻥگﺍ
flat	ﻑﻝﺍﺕ
flater	ﻑﻝﺍﺕر
flatters	ﻑﻝﺍﺕرﺯ
fleming	ﻑﻝیﻡیﻥگ
flemmer	ﻑﻝﻡﺭ
fleury	ﻑﻝیﻭﺭی
flickinger	ﻑﻝیکیﻥگﺭ
fliegel	ﻑﻝیگﻝ
flinders	ﻑﻝیﻥﺩﺭﺯ
flint	ﻑﻝیﻥﺕ
flodin	ﻑﻝﻭﺩیﻥ
floortje	ﻑﻝﻭرﺕﺝ
florence	ﻑﻝﻭﺭﻥﺱ
flores	ﻑﻝﻭﺭﺯ
flowers	ﻑﻝﻭﻭﺭﺯ
floyd	ﻑﻝﻭیﺩ
fluche	ﻑﻝﻭچﻩ
fluet	ﻑﻝﻭیﺕ
flute	ﻑﻝﻭﺕ
fluur	ﻑﻝﻭﺭ
fly	ﻑﻝﺍی
flygare	ﻑﻝﺍیگیﺭ
foders	ﻑﺍﺩرﺯ
fodor	ﻑﺍﺩﻭﺭ
foley	ﻑﺍﻝی
folkes	ﻑﻝکﺱ
folkins	ﻑﻝکیﻥﺯ
folliot	ﻑﺍﻝیﻭﺕ
folsom	ﻑﺍﻝﺱﺍﻡ
foltak	ﻑﺍﻝﺕﺍک
foniok	ﻑﻭﻥیﻭک
fontaine	ﻑﻭﻥﺕیﻥ
fontenot	ﻑﻭﻥﺕﻥﻭﺕ
fontes	ﻑﺍﻥﺕﺱ
fool	ﻑﻭﻝ
foot	ﻑﻭﺕ
forbes	ﻑﻭﺭﺏﺯ
forbis	ﻑﻭﺭﺏیﺱ
force	ﻑﻭﺭﺱ
forde	ﻑﻭﺭﺩ
fordham	ﻑﻭﺭﺩﻩﺍﻡ
foreland	ﻑﻭرﻝﻥﺩ
forget	ﻑﺭگﺕ
forgy	ﻑﻭﺭﺝی
fork	ﻑﻭﺭک
forman	ﻑﻭﺭﻡﻥ
formanek	ﻑﻭﺭﻡﺍﻥک
forrer	ﻑﻭﺭﺭ
forrest	ﻑﺍﺭﺱﺕ
forsale	ﻑﻭﺭﺱیﻝ
forsberg	ﻑﺍﺭﺱﺏﺭگ
forsblom	ﻑﻭﺭﺱﺏﻝﺍﻡ
forsling	ﻑﻭﺭﺱﻝیﻥگ
forsman	ﻑﺭﺱﻡﻥ
forster	ﻑﻭرﺱﺕر
forsyth	ﻑﻭﺭﺱﺍیﺕ
forsythe	ﻑﻭﺭﺱﺍیﺕ
forte	ﻑﻭﺭﺕ
forts	ﻑﻭﺭﺕﺱ
fosbury	ﻑﺍﺱﺏری
fosdal	ﻑﺱﺩﺍﻝ
foss	ﻑﺍﺱ
fossberg	ﻑﺍﺱﺏﺭگ
fosseng	ﻑﻭﺱﻥگ
foster	ﻑﺍﺱﺕﺭ
fotinos	ﻑﻭﺕیﻥﻭﺱ
fotis	ﻑﺍﺕیﺱ
fotter	ﻑﻭﺕر
foulds	ﻑﻭﻝﺩﺯ
foulk	ﻑﻭﻝک
fountain	ﻑﺍﻭﻥﺕیﻥ
fourney	ﻑﻭﺭﻥی
fournie	ﻑﻭﺭﻥی
fournier	ﻑﻭﺭﻥیﺭ
foust	ﻑﺍﻭﺱﺕ
fouts	ﻑﻭﺕﺱ
fowler	ﻑﻭﻝﺭ
fowlkes	ﻑﻭﻝکﺱ
fownes	ﻑﺍﻭﻥﺱ
fox	ﻑﺍکﺱ
foy	ﻑﻭی
fozzard	ﻑﻭﺯﺍﺭﺩ
fracture	ﻑﺭکچﺭ
fradkin	ﻑﺭﺩکیﻥ
fragen	ﻑﺭﺝﻥ
frageorgia	ﻑﺭﺍگﻭﺭگیﺍ
frahm	ﻑﺭﺍﻡ
frame	ﻑﺭیﻡ
framson	ﻑﺭﺍﻡﺱﻭﻥ
fran	ﻑﺭﺍﻥ
france	ﻑﺭﺍﻥﺱ
frances	ﻑﺭﺍﻥﺱﺱ
francis	ﻑرﺍﻥﺱیﺱ
francisca	ﻑرﺍﻥﺱیﺱکﺍ
franco	ﻑﺭﺍﻥکﻭ
francois	ﻑﺭﻥﺱﻭیﺱ
francyntie	ﻑرﺍﻥﺱیﻥﺕی
francytje	ﻑرﺍﻥﺱیﺕژ
frandsen	ﻑﺭﺍﻥﺩﺱﻥ
frangakis	ﻑﺭﺍﻥگﺍکیﺱ
frank	ﻑرﺍﻥک
franke	ﻑﺭﻥک
frankel	ﻑﺭﺍﻥکﻝ
frankenberger	ﻑرﺍﻥکﻥﺏرگر
frankie	ﻑﺭﺍﻥکی
franklin	ﻑرﺍﻥکﻝیﻥ
franko	ﻑﺭﺍﻥکﻭ
frankson	ﻑﺭﻥکﺱﻭﻥ
frans	ﻑرﺍﻥﺱ
franscyntje	ﻑرﺍﻥﺱیﻥﺕژ
franser	ﻑﺭﺍﻥﺱﺭ
fransiska	ﻑرﺍﻥﺱیکﺍ
frantisek	ﻑﺭﺍﻥﺕیﺱک
frantzen	ﻑﺭﺍﻥﺕﺯﻥ
fraser	ﻑﺭیﺯﺭ
frausin	ﻑﺭﺍﺱیﻥ
frazer	ﻑﺭیﺯﺭ
frazier	ﻑﺭﺍﺯییﺭ
fred	ﻑﺭﺩ
fredda	ﻑﺭﺩﺍ
freddie	ﻑﺭﺩی
freddy	ﻑﺭﺩی
frederic	ﻑﺭﺩﺭیک
frederick	ﻑﺭﺩﺭیک
frederico	ﻑﺭﺩﺭیکﻭ
frederik	ﻑﺭﺩﺭیک
frederique	ﻑﺭﺩﺭیک
frederking	ﻑﺭﺩﺭکیﻥگ
fredric	ﻑرﺩریک
fredrik	ﻑﺭﺩﺭیک
free	ﻑﺭی
freedman	ﻑﺭیﺩﻡﻥ
freeland	ﻑﺭیﻝﻥﺩ
freels	ﻑﺭیﻝﺯ
freemal	ﻑﺭیﻡﺍﻝ
freer	ﻑﺭیﺭ
freese	ﻑﺭیﺯ
freeto	ﻑﺭیﺕﻭ
frega	ﻑرگﺍ
freidin	ﻑﺭیﺩیﻥ
freimuth	ﻑﺭیﻡﻭﺕ
freitag	ﻑﺭیﺕﺍگ
freitas	ﻑﺭیﺕﺍﺱ
freiwald	ﻑﺭیﻭﺍﻝﺩ
french	ﻑﺭﻥچ
frenkel	ﻑﺭﻥکﻝ
frenzel	ﻑﺭﻥﺯﻝ
fretwell	ﻑﺭیﺕﻭﻝ
fretz	ﻑرﺕﺯ
frey	ﻑری
friday	ﻑﺭﺍیﺩی
fridman	ﻑﺭیﺩﻡﻥ
friebel	ﻑریﺏﻝ
frieda	ﻑریﺩﺍ
friedberger	ﻑﺭیﺩﺏﺭگﺭ
friedmar	ﻑﺭیﺩﻡﺍﺭ
fries	ﻑﺭیﺱ
friess	ﻑﺭیﺱ
frink	ﻑﺭیﻥک
frisian	ﻑریزیﺍ
fritgersa	ﻑریﺕگرﺱﺍ
frith	ﻑﺭیﺕ
frits	ﻑﺭیﺕﺱ
fritton	ﻑﺭیﺕﻥ
fritz	ﻑیریﺕﺯ
fritzius	ﻑﺭیﺕﺯیﻭﺱ
frix	ﻑﺭیکﺱ
froitland	ﻑرﻭیﺕﻝﻥﺩ
frome	ﻑﺭﻡ
fromhein	ﻑﺭﻭﻡیﻥ
frost	ﻑﺭﺍﺱﺕ
frostbite	ﻑرﺍﺱﺕﺏیﺕ
frosti	ﻑﺭﺍﺱﺕی
fruin	ﻑریﻭﻥ
fry	ﻑﺭﺍی
fubler	ﻑﺍﺏﻝﺭ
fuchs	ﻑﺍچﺱ
fude	ﻑﻭﺩ
fudenberg	ﻑﺍﺩﻥﺏﺭگ
fuess	ﻑﻭیﺱ
fuhrmann	ﻑﻭﺭﻡﻥ
fuhs	ﻑﺍﺱ
fui	ﻑﻭی
fuji	ﻑﻭﺝی
fujioka	ﻑﻭﺝیﻭکﺍ
fujita	ﻑﻭﺝیﺕﺍ
fujiwara	ﻑﺍﺝیﻭﺍﺭ
fukuro	ﻑﻭکﻭرﻭ
fulconis	ﻑﻭﻝکﺍﻥیﺱ
fullman	ﻑﻭﻝﻡﻥ
fuloria	ﻑﻝﻭﺭی
fulton	ﻑﺍﻝﺕﻭﻥ
fumerton	ﻑﻭﻡﺭﺕﻭﻥ
fumiaki	ﻑﻭﻡیﺍکی
fundal	ﻑﻭﻥﺩﺍﻝ
fungus	ﻑﺍﻥگﻭﺱ
funky	ﻑﻭﻥکی
furat	ﻑﺍﺭﺍﺕ
furdesanden	ﻑﻭﺭﺩﺱﺍﻥﺩﻥ
furio	ﻑﻭریﻭ
furlong	ﻑﺭﻝﺍﻥگ
furr	ﻑﺭ
furtek	ﻑﺍﺭﺕک
fuss	ﻑﺍﺱ
fuzzy	ﻑﺍﺯی
gaal	گﺍﻝ
gaba	گﺍﺏﺍ
gabara	گﺍﺏﺍﺭﺍ
gabe	گیﺏ
gabel	گﺍﺏﻝ
gable	گیﺏﻝ
gabler	گﺍﺏﻝﺭ
gables	گﺍﺏﻝﺱ
gabor	گیﺏﻭﺭ
gabriel	گﺍﺏریﻝ
gabriele	گﺍﺏﺭیﻝﻩ
gabriella	گﺍﺏﺭیﻝ
gabrielle	گﺍﺏﺭیﻝﻩ
gabrielsson	گﺍﺏﺭییﻝﺱﻭﻥ
gabrin	گﺍﺏریﻥ
gaca	گﺍﺱﺍ
gadbois	گﺍﺩﺏﻭیﺱ
gadbury	گﺍﺩﺏری
gades	گیﺩﺯ
gadi	گﺍﺩی
gadil	گﺍﺩیﻝ
gael	گﺍﻝ
gaeris	گﺍﺭیﺱ
gaetan	گیﺕﻥ
gaetz	گﺍییﺕﺯ
gaffin	گﺍﻑیﻥ
gaffney	گﺍﻑﻥی
gagne	گﺍگﻥﻩ
gaherty	گﺍﻩﺭﺕی
gaige	گﺍیگﻩ
gail	گیﻝ
gaillot	گیﻝﻭﺕ
gaines	گیﻥﺯ
gainor	گﺍیﻥﻭﺭ
gair	گیﺭ
gaitonde	گیﺕﻭﻥﺩ
galahad	گﺍﻝﺍﻩﺍﺩ
galatea	گﺍﻝﺍﺕیﺍ
galbraith	گﺍﻝﺏریﺕ
gali	گﺍﻝی
galibert	گﺍﻝیﺏﺭﺕ
galila	گﺍﻝیﻝﺍ
galileo	گﺍﻝیﻝﻩ
galinato	گﺍﻝیﻥﺍﺕﻭ
galizia	گﺍﻝیﺯیﺍ
galko	گﺍﻝکﻭ
gallagher	گﺍﻝﺍگﺭ
gallant	گﺍﻝﺍﻥﺕ
gallatin	گﺍﻝﺍﺕیﻥ
gallaty	گﺍﻝیﺕی
galli	گﺍﻝی
gallion	گﺍﻝیﻭﻥ
gallo	گﺍﻝﻭ
galloway	گﺍﻝﺍﻭی
gallula	گﺍﻝﻭﻝﺍ
gallun	گﺍﻝﺍﻥ
galmiche	گﺍﻡیﺵﻩ
galo	گﺍﻝﻭ
galocy	گﺍﻝﻭﺱی
galpin	گﺍﻝپیﻥ
galt	گﺍﻝﺕ
galvan	گﺍﻝﻭﺍﻥ
galvin	گﺍﻝﻭیﻥ
gamage	گﺍﻡیﺝ
gamal	کﻡﺍﻝ
gambino	گﺍﻡﺏیﻥﻭ
gamble	گﻡﺏﻝ
gamero	گﺍﻡﺭﻭ
gamez	گیﻡﺯ
gamil	کﻡیﻝ
gammel	گﺍﻡﻝ
gammon	گﺍﻡﻭﻥ
gan	گﺍﻥ
ganapathy	گﺍﻥﺍپﺍﺕی
ganatra	گﺍﻥﺍﺕﺭﺍ
gandy	گﺍﻥﺩی
ganesan	گﺍﻥیﺱﺍﻥ
ganesvoort	گﺍﻥﺱﻭرﺕ
gang	گﺍﻥگ
gangolli	گﺍﻥگﻭﻝی
gann	گﺍﻥ
gannon	گﺍﻥﻭﻥ
gans	گﺍﻥﺱ
gantert	گﺍﻥﺕﺭﺕ
ganti	گﺍﻥﺕی
ganzak	گﺍﻥﺯﺍک
gao	گﺍﻭ
gapen	گیپﻥ
garagan	گﺍﺭﺍگﺍﻥ
garbe	گﺍﺭﺏﻩ
garces	گﺍﺭﺱﺱ
garcia	گﺍﺭﺱیﺍ
gardner	گرﺩﻥر
gareri	گﺍرری
gareth	گﺭﺕ
garfield	گﺍﺭﻑیﻝﺩ
garfinkel	گﺍﺭﻑیﻥکﻝ
garg	گﺭگ
garito	گﺍﺭیﺕﻭ
garland	گﺍرﻝﻥﺩ
garlick	گرﻝیک
garlock	گﺍﺭﻝﺍک
garms	گﺍﺭﻡﺯ
garner	گﺍﺭﻥﺭ
garnett	گﺍﺭﻥﺕ
garofalo	گﺍﺭﺍﻑﺍﻝﻭ
garon	گﺍﺭﻥ
garrick	گﺍﺭیک
garrigues	گﺍریگﺱ
garrison	گﺍﺭیﺱﻥ
garrod	گﺍﺭﻭﺩ
garruto	گﺍﺭﻭﺕﻭ
garshol	گﺍﺭﺵﻭﻝ
garth	گﺍﺭث
gartin	گﺍﺭﺕیﻥ
gartmann	گﺍﺭﺕﻡﻥ
garvey	گﺍﺭﻭی
gary	گﺍری
gasch	گﺍﺵ
gascoigne	گﺍﺱکﻭییﻥگ
gascoyne	گﺍﺱکﻭییﻥ
gashler	گﺍﺵﻝﺭ
gasic	گﺍﺱیک
gaskin	گﺍﺱکیﻥ
gaskins	گﺍﺱکیﻥز
gaspar	گﺍﺱپﺍﺭ
gasper	گﺍﺱپﺭ
gass	گﺱ
gastineau	گﺍﺱﺕیﻥیﻭ
gastli	گﺱﺕﻝ
gastrell	کﺍﺱﺕرﻝ
gat	گﺍﺕ
gatcombe	گﺍﺕکﻭﻡﺏ
gate	گیﺕ
gates	گیﺕﺱ
gatewood	گیﺕﻭﻭﺩ
gath	گﺍﺕ
gathercole	گﺍﺕرکﻭﻝ
gatlin	گﺍﺕﻝیﻥ
gatling	گﺍﺕﻝیﻥگ
gatta	گﺍﺕﺍ
gattis	گﺍﺕیﺯ
gatz	گﺍﺕﺯ
gaudrault	گﺩﺭﺍﻝﺕ
gaukur	گﺍیﻭکﻭﺭ
gault	گﺍیﻭﻝﺕ
gaure	گﺍﻭر
gaus	گﺍﻭﺱ
gaut	گﺍﺕ
gauthier	گﺍﻭﺕیﺭ
gautier	گﺍﺕیﺭ
gavazzeni	گﺍﻭﺍﺯﻥی
gavin	گیﻭیﻥ
gaw	گﺍیﻭ
gawboy	کﺍﺏﻭی
gawne	گﺍیﻭﻥ
gaxiola	گﺍکﺱیﻭﻝﺍ
gay	گی
gaya	گﺍیﺍ
gayda	گﺍیﺩﺍ
gayler	گیﻝﺭ
gaynell	گﺍیﻥﻝ
gazer	گﺍﺯر
gazis	گﺍﺯیﺱ
gearhart	گیﺭﻩﺍﺭﺕ
geary	گییری
gease	گیﺱ
gebing	گﺏیﻥگ
geddis	گﺩیﺱ
gedeck	گﺩک
gee	گی
geer	گیر
geertruda	گرﺕرﺍﺩﺍ
geertruyd	گرﺕرﻭیﺩ
geertsen	گیﺭﺕﺱﻥ
geervliet	گریﻭﻝیﺕ
geiger	گیگﺭ
geiser	ﺝیﺱﺭ
geisler	گیﺱﻝﺭ
geldefsman	گﻝﺩزﻡﻥ
geleta	گیﻝیﺕﺍ
gell	ﺝﻝ
geller	گیﻝﺭ
gemmell	گیﻡﻝ
gendreau	ﺝﻥﺩﺭیﺍﻭ
gendrich	ﺝﻥﺩﺭیچ
genks	گیﻥکز
gennuso	گﻥﻭﺱﻭ
gentges	ﺝﻥﺕﺝﺱ
gently	ﺝﻥﺕﻝی
gentry	ﺝﻥﺕﺭی
geocaris	گﻭیکﺍﺭیﺱ
geoff	گیﻭﻑ
geoffl	ﺝﻭﻑﻝ
georgeu	ﺝﻭﺭﺝیﻭ
georgia	ﺝﻭﺭﺝیﺍ
gepje	چپژ
geppert	گپرﺕ
geraghty	گﺭﺍگﺕی
gerald	ﺝﺭﺍﻝﺩ
gerard	ﺝﺭﺍﺭﺩ
gerardi	ﺝﺭﺍﺭﺩی
gerardin	گﺭﺍﺭﺩیﻥ
gerber	گﺭﺏﺭ
gerbes	گﺭﺏﺱ
gerhard	گﺭﻩﺍﺭﺩ
gerhardt	گﺭﻩﺍﺭﺕ
gerhart	گﺭﻩﺍﺭﺕ
germack	گﺭﻡﺍک
germuska	ﺝیﺭﻡﺍﺱکﺍ
gerringe	گریﻥگ
gerritje	گریﺕی
gerritse	گﺭیﺕﺱ
gerritsen	گﺭیﺕﺱﻥ
gerrity	ﺝﺭیﺕی
gersdorf	گﺭﺱﺩﻭﺭﻑ
gerstein	ﺝﺭﺱﺕیﻥ
gerstel	گﺭﺱﺕﻝ
gerstl	ﺝﺭﺱﺕﻝ
gerth	گﺭﺕ
gertner	گﺭﺕﻥﺭ
gertrude	گرﺕرﻭﺩ
gertz	گرﺕﺯ
geston	ﺝﺱﺕﻭﻥ
gettys	گﺕیﺱ
getz	گﺕﺯ
geurt	گرﺕ
geweke	گﻭکﻩ
ghalib	گﻝیﺏ
ghaliya	ﻕﺍﻝیﺍ
gharbiyah	ﻍریﺏیﻩ
ghassan	گﺱﺍﻥ
ghayth	گیﺕ
ghufran	گﺍﻑرﺍﻥ
giacobbe	گیﺍکﻭﺏ
giacobe	ﺝیﺍکﻭﺏ
giancola	گییﺍﻥکﻭﻝﺍ
gianni	ﺝیﺍﻥی
giarratana	گیﺍﺭﺍﺕﺍﻥﺍ
gibb	گیﺏ
gibbard	گیﺏرﻥﺩ
gibbins	ﺝیﺏیﻥﺱ
gibboni	گیﺏﻭﻥی
gibbons	گیﺏﻭﻥﺯ
gibbs	گیﺏز
gibson	گیﺏﺱﻥ
gideon	گیﺩﻭﻥ
giegel	گﺍیگﻝ
gift	گیﻑﺕ
gijsbertus	گیﺝﺱﺏرﺕﺍﺱ
gil	گیﻝ
gilbert	گیﻝﺏﺭﺕ
gilby	گیﻝﺏﺍی
gilham	گیﻝﻩﺍﻡ
gilhuly	گیﻝﻩﺍﻝی
gill	گیﻝ
gillam	گیﻝﺍﻡ
gillen	گیﻝﻥ
giller	ﺝیﻝر
gillespie	گیﻝﺱپی
gillett	ژیﻝﺕ
gilley	گیﻝی
gilliam	گیﻝیﺍﻡ
gillie	گیﻝی
gillies	گیﻝیﺯ
gillilan	گیﻝیﻝﺍﻥ
gilliland	گیﻝیﻝﻥﺩ
gillis	گیﻝیﺯ
gillogly	گیﻝﺍگﻝی
gilmer	گیﻝﻡﺭ
gilmore	گیﻝﻡﻭﺭ
gilner	گیﻝﻥﺭ
gilpin	گیﻝپیﻥ
gilroy	گیﻝﺭﻭی
gimenez	گیﻡﻥﺯ
gimeno	گیﻡﻥﻭ
gin	گیﻥ
ginatta	گیﻥﺍﺕﺍ
gindin	گیﻥﺩیﻥ
ginger	گیﻥﺝﺭ
ginsburg	گیﻥﺱﺏﺭگ
ginton	گیﻥﺕﻥ
giordani	ﺝیﺍﻭﺭﺩﺍﻥی
giordano	ﺝیﻭﺭﺩﺍﻥﻭ
giovanni	گیﻭﻭﺍﻥی
girash	گیﺭﺍﺵ
girgensohn	گیرگﻥﺱﻭﻥ
girl	گﺭﻝ
gische	گیﺵﻩ
gitaitis	گیﺕیﺕیﺱ
gitlin	گیﺕﻝیﻥ
gitomer	گیﺕﻭﻡﺭ
gittelman	گیﺕﻝﻡﻥ
giuliani	ﺝﻭﻝیﺍﻥی
giulietti	گیﻭﻝیﺕی
givon	گیﻭﻥ
gizaw	گیﺯﺍﻭ
glacier	گﻝﺍﺱییﺭ
glaciers	گﻝﺱیﺭﺯ
gladders	گﻝﺍﺩﺭﺯ
glandorf	گﻝﻥﺩﻭﺭﻑ
glass	گﻝﺍﺱ
glassco	گﻝﺍﺱکﻭ
glasscock	گﻝﺱکﻭک
glasson	گﻝﺍﺱﻭﻥ
glatz	گﻝﺍﺕﺯ
gleason	گﻝیﺱﻭﻥ
gleaves	گﻝیﻭﺱ
gleich	گﻝیچ
gleichman	گﻝیچﻡﻥ
gleick	گﻝیک
gleizer	گﻝیﺯﺭ
glenn	گﻝﻥ
glenns	گﻝیﻥﺯ
glicksman	گﻝیکﺱﻡﻥ
glidden	گﻝیﺩﻥ
glines	گﻝیﻥﺯ
gloege	گﻝﻭﺝ
glos	گﻝﺍﺱ
glover	گﻝﺍﻭﺭ
glynn	گﻝیﻥ
gnagy	گﻥﺍگی
gnishilda	گیﺵیﻝﺩﺍ
gobble	گﺍﺏﺏﻝ
goble	گﻭﺏﻝ
goch	گﻭﺵ
godau	گﻭﺩﺍ
godbout	گﺍﺩﺏﺕ
goddard	گﺩﺍﺭﺩ
goddijn	گﺍﺩیﺝﻥ
godel	گﻭﺩﻝ
goderre	گﺩﺭ
godfrey	گﺍﺩﻑﺭی
godfroid	گﺍﺩﻑﺭﻭیﺩ
godic	گﺍﺩیک
godman	گﺍﺩﻡﻥ
godson	گﺍﺩﺱﻥ
godwin	گﺍﺩﻭیﻥ
goebel	گﻭﺏﻝ
goedecke	گﻭﺩک
goegan	گﻭگﺍﻥ
goel	گﻭیﻝ
goering	ﺝﻭﺭیﻥگ
goerwitz	ﺝﻭﺭﻭیﺕﺯ
goff	گﺍﻑ
goguen	گﻭگﻭﺍﻥ
goh	گﻭﻩ
gohde	گﻭﻩﺩ
goheen	گﻭﻩیﻥ
gohlke	گﻭﻝک
goland	گﻭﻝﺍﻥﺩ
gold	گﻝﺩ
goldberg	گﻝﺩﺏﺭگ
goldberger	گﻝﺩﺏﺭگﺭ
golden	گﻝﺩﻥ
goldenberg	گﻝﺩﻥﺏﺭگ
golder	گﻝﺩﺭ
goldfoot	گﻝﺩﻑﻭﺕ
goldhagen	گﻝﺩﻩﺍگﻥ
golding	گﻝﺩیﻥگ
goldkamp	گﻝﺩکﻡپ
goldman	گﻝﺩﻡﻥ
goldrich	گﻝﺩریخ
goldsmith	گﻝﺩﺍﺱﻡیﺕ
goldsteen	گﻝﺩﺍﺱﺕییﻥ
goldsworthy	گﻝﺩﺯﻭﺭثی
goli	گﻝی
gollan	گﻭﻝﺍﻥ
golomb	گﻭﻝﻭﻡﺏ
golombek	گﻭﻝﻭﻡﺏک
golub	گﻝﻭﺏ
gomes	گﻭﻡﺯ
gondek	گﻭﻥﺩک
gonderzik	گﺍﻥﺩﺭﺯیک
gong	گﺍﻥگ
goniea	گﻭﻥیﺍ
gonna	گﻭﻥﻥﺍ
gonot	گﻭﻥﻭﺕ
gonsalves	گﺍﻥﺱﺍﻝﻭﺱ
gonville	گﺍﻥﻭیﻝ
gony	گﻭﻥی
gonyer	گﺍﻥیﺭ
gonzalez	گﺍﻥﺯﺍﻝﺯ
gonzalo	گﻭﻥﺯﺍﻝﻭ
good	گﻭﺩ
goodall	گﻭﺩﺍﻝ
goode	گﻭﺩ
goodell	گﻭﺩﻝ
goodey	گﻭﺩی
goodfriend	گﻭﺩﻑرﻥﺩ
goodger	گﺍﺝر
gooding	گﻭﻭﺩیﻥگ
goodman	گﻭﺩﻡﺍﻥ
goodrum	گﻭﺩﺭﺍﻡ
goods	گﻭﺩﺯ
goodsen	گﻭﺩﺱﻥ
goodwin	گﻭﺩﻭیﻥ
goodwyn	گﻭﺩﻭیﻥ
goolsbee	گﻭﻝﺱﺏی
goolsby	گﻭﻝﺱﺏی
goor	گﻭﺭ
goose	گﻭﺱ
gooshy	گﻭﺵی
gootee	گﻭﺕی
gootjes	گﻭﺕﺝﺱ
gopala	گﻭپﺍﻝﺍ
gopalan	گﻭپﺍﻝﺍﻥ
gopinath	گﻭپیﻥﺍﺕ
gopisetty	گﺍپیﺱﺕی
goran	گﻭﺭﺍﻥ
gorav	گﻭﺭﺍﻭ
gorberg	گﻭﺭﺏﺭگ
gord	گﻭرﺩ
gordan	گﺭﺩﺍﻥ
gorde	گﻭﺭﺩ
gordin	گﻭﺭﺩیﻥ
gore	گﻭﺭ
gorel	گﻭﺭﻝ
gorev	گﻭﺭﻭ
gorgons	گﻭﺭگﺍﻥﺯ
gorik	گﻭﺭیک
gorin	گریﻥ
gorinchem	گرﻭیﻥچﻡ
goringe	گﻭﺭیﻥگ
goris	گﻭﺭیﺱ
gorki	گﻭﺭکی
gorm	گﺭﻡ
gornall	گﻭﺭﻥﺍﻝ
gorospe	گﻭﺭﺍﺱپی
gorry	گﻭﺭی
gorton	گﻭﺭﺕﻭﻥ
gorwitz	گﻭﺭﻭیﺕﺯ
gosewitz	گﻭﺯﻭیﺕﺯ
goss	گﺍﺱ
gossard	گﺍﺱﺍﺭﺩ
gossink	گﺍﺱیﻥک
gossler	گﺍﺱﻝﺭ
gosta	گﺍﺱﺕﺍ
gostin	گﺍﺱﺕیﻥ
goswell	کﺍﺱﺕﻭﻝ
goswick	گﻭﺱﻭیک
gothic	گﻭﺕیک
gotley	گﺍﺕﻝی
gotovac	گﻭﺕﻭﻭﺍک
gotseff	گﺍﺕﺱﻑ
gottesman	گﺍﺕﺱﻡﻥ
gotthard	گﺍﺕﻩﺍرﺩ
gottlieb	گﺍﺕﻝیﺏ
gotts	گﺍﺕﺱ
goucher	گﺍچﺭ
gouda	گﻭیﻭﺩﺍ
goudier	گﻭﺩیﺭ
goudreau	گﻭﺩﺭﻭ
goudswaard	گﺍﺩﺱﻭﺍﺭﺩ
gough	گﺍﻑ
gould	گﻭﻝﺩ
goulden	گﺍﻝﺩﻥ
goulding	گﻭﻝﺩیﻥگ
gourav	گﻭرﺍﻭ
gourdin	گﻭرﺩیﻥ
gourdon	گﻭﺭﺩﻥ
gourlay	گﻭﺭﻝی
gourmet	گﻭﺭﻡﺕ
gousset	گﻭﺱﺕ
gouvousis	گﻭﻭﻭﺱیﺱ
gover	گﻭر
goverd	گﺍﻭرﺩ
governor	گﺍﻭﺭﻥﺭ
govil	گﻭیﻝ
govind	گﺍﻭیﻥﺩ
govindan	گﺍﻭیﻥﺩﺍﻥ
govinder	گﻭﻭیﻥﺩﺭ
gowan	گﻭﺍﻥ
goward	گﻭﺍﺭﺩ
gowell	گﻭیﻝ
gowri	گﻭﺭی
gozzi	ﺝﻭﺯی
graae	گﺭﺍیی
graben	گﺭﺍﺏﻥ
grabiner	گﺭﺍﺏیﻥﺭ
grabnar	گﺭﺍﺏﻥﺍﺭ
grace	گﺭیﺱ
grad	گﺭﺍﺩ
graduation	گﺭﺝﻭﺍیﺵﻥ
grady	گﺭﺩی
graf	گﺭﺍﻑ
graft	گﺭﺍﻑﺕ
graham	گﺭﺍﻩﺍﻡ
grahame	گﺭﺍﻩﺍﻡ
grahorna	گﺭﺍﻩﺭﻥﺍ
graifer	گﺭیﻑﺭ
grainger	گریﻥگر
gralian	گﺭﺍﻝیﻥ
grammer	گﺭﻡﺭ
gran	گﺭﻥ
granade	گرﺍﻥیﺩ
grand	گﺭﻥﺩ
grande	گﺭﺍﻥﺩ
grandfield	گﺭﻥﺩﺍﻑیﻝﺩ
grandidier	گﺭﻥﺩیﺩیﺭ
grandmaster	گﺭﻥﺩﻡﺱﺕﺭ
grandstrom	گرﺍﻥﺩﺍﺱﺕرﻭﻡ
granite	گﺭﺍﻥیﺕ
granli	گﺭﻥﻝی
granroth	گﺭﺍﻥﺭﻭﺩ
granslo	گرﺍﻥﺱﻝﻭ
grant	گﺭﺍﻥﺕ
grantham	گﺭﺍﻥﺕﺍﻡ
granzeau	گﺭﺍﻥﺯیﻭ
grape	گرپ
graphite	گﺭﻑیﺕ
graptolite	گرپﺕﻭﻝیﺕ
graser	گﺭیﺱﺭ
grass	گﺭﺱ
grassel	گرﺍﺱﻝ
grasteinen	گﺭﺱﺕیﻥﻥ
grasty	گﺭﺱﺕی
grattan	گرﺍﺕﺍﻥ
gratton	گرﺍﺕﻭﻥ
gratz	گرﺕﺯ
grau	گﺭﺍﻭ
graves	گﺭیﻭﺯ
gravolin	گﺭﺍﻭﻝیﻥ
graw	گﺭﺍﻭ
gray	گﺭی
greanias	گﺭیﻥیﺍﺱ
greatbanks	گریﺕﺏﺍﻥکز
greco	گﺭکﻭ
green	گﺭییﻥ
greenaway	گﺭیﻥﻭی
greenberg	گﺭیﻥﺏﺭگ
greene	گﺭیﻥ
greenen	گﺭیﻥﻥ
greenfield	گریﻥﻑیﻝﺩ
greeniaus	گریﻥیﺍﺱ
greenop	گﺭیﻥﻭپ
greenough	گﺭیﻥﻭ
greenwald	گﺭییﻥﻭﺍﻝﺩ
greenwood	گﺭیﻥﻭﻭﺩ
greer	گﺭیﺭ
gregg	گﺭگ
gregoire	گﺭگﻭﺭ
gregory	گﺭیگﻭﺭی
greifer	گﺭیﻑﺭ
greiff	گﺭیﻑ
greig	گﺭیگ
gremban	گﺭﻡﺏﺍﻥ
grenander	گﺭﻥﺍﻥﺩﺭ
grendell	گرﻥﺩﻝ
grenville	گﺭﻥﻭیﻝ
gretchen	گﺭﺕچﻥ
greuel	گﺭیﻭﻝ
greyson	گﺭیﺱﻭﻥ
gribble	گﺭیﺏﻝ
griefer	گﺭیﻑﺭ
grieger	گﺭیگﺭ
griepenkerl	گﺭیپﻥکﺭﻝ
grier	گﺭیﺭ
griesenbeck	گریﺱﻥﺏک
grieve	گﺭﺍییﻭ
griff	گﺭیﻑ
griffin	گﺭیﻑیﻥ
griffis	گﺭیﻑیﺱ
griffith	گریﻑیﺕ
griffiths	گﺭیﻑیﺕﺯ
griffon	گریﻑﻭﻥ
grilk	گﺭیﻝک
grillenbeck	گﺭیﻝﻥﺏک
grimaldo	گﺭیﻡﺍﻝﺩﻭ
grimes	گﺭیﻡﺯ
grimm	گریﻡ
grimme	گﺭﺍیﻡ
grindley	گﺭیﻥﺩﻝی
grinsven	گﺭیﻥﺱﻭﻥ
grinter	گﺭیﻥﺕﺭ
griseldis	گریﺱﻝﺩیﺱ
grishilde	گریﺵیﻝﺩ
grismore	گﺭیﺱﻡﻭﺭ
grissom	گﺭیﺱﺍﻡ
grist	گﺭیﺱﺕ
griswald	گﺭیﺱﻭﺍﻝﺩ
griswold	گﺭیﺱﻭﻝﺩ
grit	گﺭیﺕ
grivas	گﺭﺍیﻭﺍﺱ
grizzly	گﺭیﺯﻝی
groat	گﺭﻭﺕ
groce	گﺭﻭﺱ
groebe	گﺭﻭﺏی
groenink	گﺭﻭﻥیﻥک
groff	گرﻭﻑ
grog	گﺭﺍگ
grogono	گرﻭگﻭﻥﻭ
groner	گﺭﻭﻥﺭ
gronlund	گرﺍﻥﻝﻥﺩ
groom	گﺭﻭﻡ
groovy	گﺭﻭﻭی
grosek	گﺭﻭﺱک
grosjean	گرﻭﺱﺝیﻥ
gross	گﺭﺍﺱ
grosser	گﺭﺍﺱﺭ
grossjohann	گﺭﻭﺱﺝﻭﻩﺍﻥ
grothause	گﺭﻭﺕﻩﺍﻭﺱ
grothkast	گرﻭثکﺍﺱﺕ
group	گرﻭپ
grout	گﺭﻭﺕ
grov	گﺭﺍﻭ
grove	گﺭﺍﻭ
grover	گﺭﻭﻭﺭ
groves	گﺭﺍﻭﺯ
grubb	گﺭﺍﺏ
grubbs	گرﺍﺏﺱ
gruber	گﺭﺍﺏﺭ
gruchy	گﺭﻭچی
gruen	گﺭﻭیﻥ
gruhn	گﺭﺍﻥ
grumann	گﺭﺍﻡﻥ
grumbine	گرﺍﻡﺏﺍیﻥ
grunberger	گﺭﺍﻥﺏﺭگﺭ
grunewald	گﺭﻭﻥﻭﺍﻝﺩ
grupe	گﺭﻭپ
gruskin	گﺭﺍﺱکیﻥ
guan	گﻭﺍﻥ
guanyao	گﻭﺍﻥیﺍﻭ
gubal	گﻭﺏﺍﻝ
gubbin	گﺍﺏیﻥ
gudat	گﻭﺩﺍﺕ
gudgel	گﺍﺩگﻝ
gudmundur	گﺍﺩﻡﺍﻥﺩﻭﺭ
gudrun	گﻭﺩﺭﺍﻥ
guenther	گﻭﺍﻥﺕﺭ
guerin	گﻭﺍریﻥ
guest	گﺱﺕ
guethlein	ﺝﻭﺕﻝیﻥ
gui	گﻭی
guia	گﻭیﺍ
guido	گیﺩﻭ
guidry	گیﺩﺭی
guilford	گیﻝﻑﺭﺩ
guillaume	گیﻝﺍﻡ
guillen	گﻭیﻝﻥ
guillerm	گیﻝﺭﻡ
guillermo	گیﻝﺭﻡﻭ
guillon	گﺍیﻝﻭﻥ
guillory	گیﻝﺭی
guimond	گﺍیﻡﻭﻥﺩ
guitard	گیﺕﺍﺭﺩ
gul	گﻝ
gulch	گﺍﻝچ
gulf	گﻝﻑ
gull	گﺍﻝ
gulledge	گﺍﻝﺝ
gullett	گﺍﻝﺕ
gully	گﺍﻝی
gulovsen	گﺍﻝﻭﺱﻥ
gunawan	گﺍﻥﺍﻭﺍﻥ
gunderson	گﺍﻥﺩﺭﺱﻭﻥ
gundlach	گﺍﻥﺩﻝچ
gundy	گﺍﻥﺩی
gung	گﺍﻥگ
gunn	گﺍﻥ
gunnar	گﺍﻥﺍﺭ
gunnerus	گﺍﻥﺭﻭﺱ
gunson	گﺍﻥﺱﻭﻥ
gunter	گﺍﻥﺕﺭ
gunther	گﺍﻥﺕﺭ
gunthorpe	گﺍﻥﺕرپ
guntram	گﺍﻥﺕﺭﺍﻡ
guntrip	گﺍﻥﺕریپ
guo	گﻭ
guochun	گﻭچﺍﻥ
guoqiano	گﻭکیﺍﻥﻭ
gupwell	گﻭپﻭﻝ
gural	گﻭﺭﺍﻝ
guralp	گﻭﺭﺍﻝپ
gurdev	گﻭﺭﺩﻑ
gurinder	گﻭﺭیﻥﺩﺭ
gurley	گﺭﻝی
gurman	گﻭﺭﻡﻥ
gurney	گرﻥی
gursky	گﺍﺭﺱکی
guru	گﻭﺭﻭ
gurudevan	گﺍﺭﺍﺩﻭﺍﻥ
gurupartap	گﻭﺭﺍپﺍﺭﺕﺍپ
gurusamy	گﻭﺭﻭﺱﺍﻡی
guscott	گﺍﺱکﺍﺕ
guse	گیﻭﺯ
gussie	گﺍﺱی
gustav	گﻭﺱﺕﺍﻭ
gustin	ﺝﺍﺱﺕیﻥ
gutman	گﺍﺕﻡﻥ
gutmann	گﺍﺕﻡﻥ
gutteridge	گﺍرﺕریﺝ
gutwein	گﺍﺕﻭیﻥ
gutzwiller	گﺍﺕﺯﻭیﻝﺭ
guy	گﺍی
guyatt	گیﺍﺕ
guyer	گﺍیﺭ
guzek	گﺍﺯک
guzman	گﺍﺯﻡﻥ
gwillim	گﻭییﻝیﻡ
gwinup	گﻭییﻥﺍپ
gwynn	گیﻥ
gwynne	گﻭﺍیﻥﻩ
gymer	گﺍیﻡﺭ
haange	ﻩﺍﻥگﻩ
haber	ﻩﺍﺏﺭ
habercom	ﻩﺍﺏﺭکﺍﻡ
habereder	ﻩﺍﺏﺭﺩﺭ
haberlach	ﻩﺍﺏﺭﻝچ
haberman	ﻩﺍﺏﺭﻡﻥ
habib	ﺡﺏیﺏ
habiba	ﺡﺏیﺏﺍ
habura	ﻩﺍﺏﻭﺭﺍ
hack	ﻩک
hacker	ﻩکﺭ
hackett	ﻩکﺕ
hacking	ﻩﺍکیﻥگ
hackley	ﻩﺍکﻝی
hackshaw	ﻩکﺵﺍﻭ
hadavi	ﻩﺩﺍﻭی
haddock	ﻩﺩﺍک
haden	ﻩﺍﺩﻥ
hadi	ﺡﺩی
hadid	ﺡﺩیﺩ
hadil	ﺡﺩیﻝ
hadj	ﻩﺝ
hadland	ﻩﺍﺩﻝﻥﺩ
hadley	ﻩﺍﺩﻝی
hafsah	ﺡﺩﺱﺍ
haga	ﻩﺍگﺍ
hagan	ﻩﺍگﺍﻥ
hagelin	ﻩﺍگﻝیﻥ
hagen	ﻩیگﻥ
hager	ﻩﺍگﺭ
hagerman	ﻩﺍگرﻡﻥ
haggard	ﻩﺍگﺍﺭﺩ
hagin	ﻩﺍگیﻥ
hagir	ﺡﺍﺝیر
hagland	ﻩگﻝﻥﺩ
hagler	ﻩﺍگﻝﺭ
haibach	ﻩیﺏﺍخ
haich	ﻩﺍیچ
haidar	ﺡیﺩر
haifa	ﺡیﻑﺍ
haigh	ﻩی
haik	ﻩیک
haikola	ﻩﺍیکﻭﻝﺍ
hail	ﺡیﻝ
hailey	ﻩﺍیﻝی
hain	ﻩﺍیﻥ
hainge	ﻩیﻥگ
haj	ﻩﺍﺝ
hajar	ﺡﺝر
hajery	ﻩﺝﺭی
hakes	ﻩیکﺯ
hakim	ﺡکیﻡ
hakulinen	ﻩﺍکﻭﻝیﻥﻥ
halab	ﺡﻝﺍﺏ
halat	ﻩﺍﻝﺍﺕ
haldre	ﻩﺍﻝﺩﺭ
hale	ﻩیﻝ
haley	ﻩﺍﻝی
halford	ﻩﺍﻝﻑرﺩ
halkedis	ﻩﺍﻝکﺩیﺱ
hall	ﻩﺍﻝ
hallam	ﻩﺍﻝﺍﻡ
hallberg	ﻩﺍﻝﺏرگ
halleck	ﻩﺍﻝک
haller	ﻩﺍﻝﺭ
hallert	ﻩﺍﻝﺭﺕ
halliburton	ﻩﺍﻝیﺏﺭﺕﻭﻥ
halligan	ﻩﺍﻝیگﺍﻥ
halliwell	ﻩﺍﻝیﻭﻝ
hallock	ﻩﺍﻝﺍک
halloran	ﻩﺍﻝﻭرﺍﻥ
halm	ﻩﺍﻝﻡ
halpin	ﻩﺍﻝپیﻥ
halsell	ﻩﺍﻝﺱﻝ
halsted	ﻩﺍﻝﺱﺕﺩ
halverson	ﻩﺍﻝﻭرﺱﻭﻥ
hamad	ﺡﺍﻡﺩ
hamah	ﺡﺍﻡﺍﻩ
hamam	ﺡﻡﺍﻡ
hamdan	ﺡﻡﺩﺍﻥ
hameed	ﺡﺍﻡیﺩ
hamer	ﻩﺍﻡﺭ
hami	ﻩﺍﻡی
hamill	ﻩﺍﻡیﻝ
hamilton	ﻩﺍﻡیﻝﺕﻥ
hamlin	ﻩﺍﻡﻝیﻥ
hammans	ﻩﺍﻡﺍﻥز
hammarquist	ﻩﺍﻡﺍﺭکﻭییﺱﺕ
hammel	ﻩﺍﻡﻝ
hammer	ﻩﺍﻡﺭ
hammerton	ﻩﺍﻡرﺕﻥ
hammill	ﻩﺍﻡیﻝ
hammond	ﻩﺍﻡﻭﻥﺩ
hammonds	ﻩﺍﻡﻭﻥﺩﺯ
hamparian	ﻩﺍﻡپﺭیﻭﻥ
hampshire	ﻩﺍﻡپﺵیر
hampton	ﻩﺍﻡپﺕﻭﻥ
han	ﻩﺍﻥ
hanaa	ﺡﻥﺍ
hanakken	ﻩﺍﻥﺍکﻥ
hand	ﻩﻥﺩ
handel	ﻩﺍﻥﺩﻝ
handelsman	ﻩﻥﺩﻝﺱﻡﻥ
handley	ﻩﺍﻥﺩﻝی
handloser	ﻩﻥﺩﻝﺍﺱﺭ
handojo	ﻩﺍﻥﺩﻭﺝﻭ
hands	ﻩﻥﺩﺯ
hanebuth	ﻩﺍﻥﺏﻭﺕ
haney	ﻩﺍﻥی
hang	ﻩﻥگ
hanifa	ﺡﻥیﻑﺍ
hanke	ﻩﺍﻥکﻩ
hanks	ﻩﺍﻥکز
hann	ﻩﺍﻥ
hanna	ﻩﺍﻥﺍ
hannaford	ﻩﺍﻥﺍﻑﻭﺭﺩ
hannawi	ﻩﺍﻥﺍﻭی
hannemann	ﻩﺍﻥیﻡﻥ
hanners	ﻩﺍﻥرﺯ
hanney	ﻩﻥی
hannigan	ﻩﻥیگﺍﻥ
hanning	ﻩﻥیﻥگ
hannu	ﻩﺍﻥﻭ
hannula	ﻩﻥﻭﻝﺍ
hansen	ﻩﺍﻥﺱﻥ
hansford	ﻩﻥﺱﻑﻭرﺩ
hansher	ﻩﺍﻥﺵﺭ
hansje	ﻩﺍﻥﺱﺝ
hanson	ﻩﺍﻥﺱﻭﻥ
hanssen	ﻩﺍﻥﺱﻥ
hansson	ﻩﺍﻥﺱﻭﻥ
hao	ﻩﺍﻭ
harald	ﻩﺍﺭﺍﻝﺩ
haraldsen	ﻩﺍﺭﺍﻝﺩﺱﻥ
haramoto	ﻩﺍﺭﻡﻭﺕﻭ
harari	ﻩﺍﺭﺍﺭی
haratz	ﻩﺍﺭﺍﺕﺯ
harber	ﻩﺍﺭﺏﺭ
harbidge	ﻩرﺏیﺝ
harbor	ﻩﺍﺭﺏﺭ
harbour	ﻩﺍﺭﺏﺭ
harbud	ﻩﺍرﺏﺩ
harburn	ﻩﺍﺭﺏﺭﻥ
harden	ﻩﺍﺭﺩﻥ
hardie	ﻩﺍﺭﺩیﻩ
hardikar	ﻩﺍﺭﺩیکﺍﺭ
hardiman	ﻩﺍﺭﺩیﻡﻥ
hardin	ﻩﺍﺭﺩیﻥ
harding	ﻩﺍﺭﺩیﻥگ
hardison	ﻩﺍﺭﺩیﺱﻭﻥ
hardwick	ﻩﺍﺭﺩﻭیک
hardyck	ﻩﺍرﺩیک
hares	ﻩﺍﺭﺱ
harford	ﻩﺍرﻑﻭرﺩ
hargrave	ﻩﺍرگریﻭ
hargroves	ﻩﺍﺭگﺭﺍﻭﺯ
haricken	ﻩریکﻥ
hariharan	ﻩﺍﺭیﻩﺍﺭﺍﻥ
harincar	ﻩﺍﺭیﻥکﺍﺭ
harith	ﺡریﺙ
harkcom	ﻩﺍﺭکﻭﻡ
harker	ﻩﺍﺭکﺭ
harkin	ﻩﺍﺭکیﻥ
harkins	ﻩﺍﺭکیﻥﺯ
harlan	ﻩﺍﺭﻝﻥ
harland	ﻩﺍﺭﻝﻥﺩ
harlow	ﻩﺍﺭﻝﻭ
harman	ﻩرﻡﻥ
harmer	ﻩﺍﺭﻡﺭ
harms	ﻩﺍﺭﻡﺯ
harold	ﻩﺍﺭﻝﺩ
haroon	ﻩﺍﺭﻭﻥ
haroun	ﻩرﻭﺱ
harpe	ﻩﺍﺭپ
harper	ﻩﺍﺭپﺭ
harrekilde	ﻩﺍرکیﻝﺩ
harrell	ﻩﺍﺭﻝ
harrer	ﻩﺍﺭﺭ
harries	ﻩﺍﺭیﺯ
harrig	ﻩﺍﺭﺭیگ
harrington	ﻩﺍﺭیﻥگﺕﻭﻥ
harris	ﻩﺍﺭیﺯ
harrison	ﻩریﺱﻭﻥ
harrow	ﻩﺍﺭﻭ
harry	ﻩﺍﺭی
harsh	ﻩﺍﺭﺵ
harsha	ﻩﺍﺭﺵﺍ
hart	ﻩﺍﺭﺕ
hartel	ﻩﺍﺭﺕﻝ
harter	ﻩﺍﺭﺕﺭ
hartfield	ﻩﺍﺭﺕﻑیﻝﺩ
hartford	ﻩﺍﺭﺕﻑﻭﺭﺩ
hartigan	ﻩﺍﺭﺕیگﺍﻥ
hartmann	ﻩﺍﺭﺕﻡﻥ
hartog	ﻩﺍﺭﺕﺍگ
hartsough	ﻩﺍﺭﺕﺱﺍﻭ
hartwell	ﻩریﻭﻝ
haruhisa	ﻩﺍﺭﻭﻩیﺱﺍ
haruhito	ﻩﺍﺭﻭﻩیﺕﻭ
haruni	ﻩﺍﺭﻭﻥی
harvard	ﻩﺍﺭﻭﺍﺭﺩ
harvell	ﻩﺍﺭﻭﻝ
harvey	ﻩﺍﺭﻭی
harvie	ﻩﺍﺭﻭﺍی
harwood	ﻩﺍﺭﻭﻭﺩ
hasakah	ﺡﺍﺱﺍکﺍﻩ
hasan	ﺡﺱﻥ
hasbrouck	ﻩﺍﺱﺏﺭﻭک
hascall	ﻩﺍﺱکﺍﻝ
hashimoto	ﻩﺍﺵیﻡﻭﺕﻭ
haskell	ﻩﺍﺱکﻝ
haskett	ﻩﺍﺱکﺕ
haslum	ﻩﺍﺱﻝﻭﻡ
hasna	ﺡﺱﻥﺍ
hasse	ﻩﺱ
hassett	ﻩﺍﺱﺕ
haste	ﻩﺱﺕ
hasty	ﻩﺱﺕی
hatcher	ﻩﺕچﺭ
hate	ﻩیﺕ
hatem	ﻩﺍﺕﻡ
hatmaker	ﻩﺍﺕﻡیکﺭ
hatrell	ﻩﺍﺕﺭﻝ
hatter	ﻩﺕر
hatton	ﻩﺍﺕﻭﻥ
hattori	ﻩﺍﺕﻭﺭی
hau	ﻩﺍﻭ
havard	ﻩﺍﻭﺍﺭﺩ
havel	ﻩﺍﻭﻝ
haven	ﻩﺍﻭﻥ
haverkamp	ﻩﺍﻭرکﻡپ
havok	ﻩﻭک
havola	ﻩﺍﻭﻭﻝﺍ
haw	ﻩﺍﻭ
hawalli	ﺡﻭﺍﻝی
hawdon	ﻩﺍﻭﺩﻭﻥ
hawk	ﻩﺍﻭک
hawken	ﻩﻭکﻥ
hawker	ﻩﺍﻭکﺭ
hawkes	ﻩﺍیﻭکﺯ
hawkin	ﻩﺍﻭکیﻥ
hawkins	ﻩیﻭکیﻥﺯ
hawkinson	ﻩﺍیﻭکیﻥﺱﻭﻥ
hawks	ﻩﺍکﺱ
hawley	ﻩﺍﻭﻝی
hawthorne	ﻩﺍﻭﺕﻭﺭﻥ
hawtin	ﻩﺍﻭﺕیﻥ
hawton	ﻩﺍﺕﻭﻥ
haxel	ﻩﺍکﺱﻝ
hay	ﻩی
haydu	ﻩﺍیﺩﻭ
haygood	ﻩﺍیگﻭﺩ
hayler	ﻩیﻝر
haylett	ﻩیﻝﺕ
hayman	ﻩیﻡﻥ
haynes	ﻩیﻥﺯ
haynie	ﻩﺍیﻥی
hays	ﻩیﺯ
hayter	ﻩﺍیﺕﺭ
hayward	ﻩیﻭﺍرﺩ
hazlewood	ﻩزﻝیﻭﺩ
hazzard	ﻩﺯﺍﺭﺩ
heacox	ﻩیکﺍکﺱ
head	ﻩﺩ
heading	ﻩﺩیﻥگ
headland	ﻩﺩﻝﻥﺩ
headley	ﻩﺩﻝی
heald	ﻩیﻝﺩ
healton	ﻩﻝﺕﻭﻥ
healy	ﻩیﻝی
hean	ﻩییﻥ
heaney	ﻩیﻥی
hearn	ﻩیﺭﻥ
hearne	ﻩیﺭﻥﻩ
heathcote	ﻩیﺱکﻭﺕ
heather	ﻩیﺕﺭ
heatlie	ﻩیﺕﻝی
heaton	ﻩیﺕﻭﻥ
hebborn	ﻩیﺏﻭرﻥ
hebenton	ﻩﺏﻥﺕﻭﻥ
hecke	ﻩک
heckel	ﻩکﻝ
heckenbach	ﻩکﻥﺏﺍخ
heckendorn	ﻩکﻥﺩﻭرﻥ
hecker	ﻩکﺭ
hecking	ﻩکیﻥگ
hedges	ﻩﺝﺱ
hedin	ﻩﺩیﻥ
hedlund	ﻩﺩﻝﻭﻥﺩ
hedrick	ﻩﺩﺭیک
heelan	ﻩﻝﺍﻥ
heerdegen	ﻩیﺭﺩگﻥ
heeswyk	ﻩیﺱﻭیک
heetan	ﻩیﺕﻥ
heeter	ﻩیﺕﺭ
heezemans	ﻩیزیﻡﻥز
heffler	ﻩیﻑﻝﺭ
heffron	ﻩﻑﺭﻭﻥ
hefley	ﻩﻑﻝی
hegarty	ﻩگﺍﺭﺕی
hegedus	ﻩگﺩﻭﺱ
hegermann	ﻩیگﺭﻡﻥ
heggie	ﻩگی
hegrad	ﻩگﺭﺍﺩ
hegyes	ﻩگیﺯ
hehman	ﻩﻩﻡﻥ
hei	ﻩی
heiberg	ﻩیﺏﺭگ
heiberger	ﻩیﺏرگر
heidel	ﻩیﺩﻝ
heiden	ﻩیﺩﻥ
heiderich	ﻩیﺩﺭیچ
heidi	ﻩیﺩی
heidmann	ﻩﺍیﺩﻡﻥ
heidner	ﻩیﺩﻥﺭ
heidrich	ﻩیﺩﺭیﺵ
heifetz	ﻩیﻑﺕﺯ
heights	ﻩیﺕﺱ
heigl	ﻩیگﻝ
heikki	ﻩیکی
heiko	ﻩیکﻭ
heil	ﻩیﻝ
heiland	ﻩیﻝﻥﺩ
heilgalo	ﻩیﻝگﺍﻝﻭ
heim	ﻩیﻡ
heini	ﻩیﻥی
heinly	ﻩیﻥﻝی
heino	ﻩیﻥﻭ
heinonen	ﻩیﻥﻭﻥﻥ
heinous	ﻩیﻥﻭﺯ
heinz	ﻩیﻥﺯ
heiser	ﻩیﺱﺭ
heiss	ﻩیﺱ
heitmann	ﻩیﺕﻡﻥ
heke	ﻩک
hekezen	ﻩکﺯﻥ
helal	ﻩﻝﺍﻝ
helbig	ﻩﻝﺏیگ
helbing	ﻩﻝﺏیﻥگ
held	ﻩﻝﺩ
heleentje	ﻩیﻝیﻥﺕ
helen	ﻩﻝﻥ
helena	ﻩﻝﻥﺍ
helene	ﻩﻝﻥ
helfand	ﻩﻝﻑﺍﻥﺩ
helfman	ﻩﻝﻑﻡﻥ
helga	ﻩﻝگﺍ
helke	ﻩﻝک
hell	ﻩﻝ
hellekant	ﻩﻝکﺍﻥﺕ
hellen	ﻩﻝﻥ
heller	ﻩﺍﻝﺭ
hellerstein	ﻩیﻝیﺭﺵﺕیﻥ
helliwell	ﻩﻝیﻭﻝ
hellmer	ﻩﻝﻡﺭ
hellstrom	ﻩﻝﺱﺕﺭﻭﻡ
hellwege	ﻩﻝﻭﺝ
helman	ﻩﻝﻡﻥ
helmenstine	ﻩﻝﻡﻥﺱﺕﺍیﻥ
helms	ﻩﻝﻡﺯ
helou	ﻩﻝﻭ
helt	ﻩﻝﺕ
hemer	ﻩﻡﺭ
hemmer	ﻩﻡﺭ
hempe	ﻩﻡپ
hemstede	ﻩیﻡﺱﺕﺩ
henault	ﻩﻥﻭﻝﺕ
hendee	ﻩﻥﺩی
henders	ﻩﻥﺩرﺯ
henderson	ﻩﺍﻥﺩﺭﺱﻭﻥ
hendrickje	ﻩﻥﺩریچی
hendricks	ﻩﻥﺩﺭیکﺱ
hendrickson	ﻩﻥﺩﺭیکﺱﻥ
hendricus	ﻩﻥﺩریچﻭز
hendrikje	ﻩﻥﺩریک
hendriks	ﻩﻥﺩﺭیکﺱ
hendrikse	ﻩﻥﺩﺭیکﺱﻩ
hendrix	ﻩﻥﺩریکﺱ
hendry	ﻩﻥﺩری
henegan	ﻩیﻥگﺍﻥ
heng	ﻩﻥگ
henke	ﻩﻥک
henkel	ﻩﻥکﻝ
henle	ﻩﻥﻝ
henley	ﻩﻥﻝی
henneke	ﻩﻥیک
hennenfent	ﻩﻥﻥﻑﻥﺕ
hennessey	ﻩﻥﺱی
hennick	ﻩﻥیک
hennigan	ﻩﻥیگﺍﻥ
henning	ﻩﻥیﻥگ
henningsen	ﻩﻥیﻥگﺱﻥ
henri	ﻩﻥری
henriet	ﻩﻥریﺕ
henrik	ﻩﻥﺭیک
henry	ﻩﻥﺭی
hensley	ﻩﻥﺱﻝی
henson	ﻩﻥﺱﻥ
hentig	ﻩﻥﺕیگ
hentje	ﻩﻥﺕ
hentrich	ﻩﻥﺕریچ
henze	ﻩﻥﺯ
hepler	ﻩپﻝﺭ
hepworth	ﻩپﻭرﺕ
herberg	ﻩﺭﺏﺭگ
herbert	ﻩﺭﺏﺭﺕ
herborth	ﻩﺭﺏﻭﺭﺕ
herbsleb	ﻩﺭﺏﺱﻝﺏ
herd	ﻩﺭﺩ
herdsfield	ﻩرﺩزﻑیﻝﺩ
herland	ﻩﺭﻝﻥﺩ
herlevi	ﻩﺭﻝﻭی
herlindis	ﻩرﻝیﻥﺩیﺱ
herlitz	ﻩرﻝیﺕﺯ
herman	ﻩﺭﻡﺍﻥ
hermann	ﻩﺭﻡﺍﻥ
hermans	ﻩﺭﻡﺍﻥﺱ
hermes	ﻩﺭﻡﺯ
hermoso	ﻩﺭﻡﻭﺱﻭ
hernacki	ﻩﺭﻥﺍکی
hernandez	ﻩﺭﻥﺍﻥﺩﺯ
herndon	ﻩﺭﻥﺩﻭﻥ
herodotou	ﻩرﺍﺩﺕﻭ
herr	ﻩﺭ
herrera	ﻩﺭﺭﺍ
herrick	ﻩﺭیک
herringshaw	ﻩﺭیﻥگﺵﺍﻭ
herrman	ﻩﺭﻡﺍﻥ
herrmann	ﻩﺭﻡﺍﻥ
herron	ﻩرﻭﻥ
hertling	ﻩﺭﺕﻝیﻥگ
herttrich	ﻩرﺕریچ
hertweck	ﻩﺭﺕﻭک
hervey	ﻩﺭﻭی
herweijer	ﻩرﻭیﺝر
herzegovina	ﻩرﺯگﻭیﻥ
hesemans	ﻩزﻡﻥز
hesketh	ﻩﺱکیﺕ
hesse	ﻩﺱ
hester	ﻩﺱﺕﺭ
hetenyi	ﻩﺕﻥی
hethcox	ﻩﺕکﻭکﺱ
hetrick	ﻩﺕﺭیک
hett	ﻩﺕ
hettinga	ﻩﺕیﻥگﺍ
hetzler	ﻩﺕﺯﻝﺭ
heuer	ﻩیﻭﺭ
hewing	ﻩﻭیﻥگ
hewitt	ﻩیﻭﻭیﺕ
hewko	ﻩیﻭکﻭ
heyltje	ﻩیﻝیﺕﻩ
heymann	ﻩیﻡﻥ
heymanson	ﻩیﻡﺍﻥﺱﻭﻥ
hibberd	ﻩﺍیﺏﺭﺩ
hibbert	ﻩیﺏﺭﺕ
hibbs	ﻩﺍیﺏﺯ
hickey	ﻩیکی
hickler	ﻩیکﻝﺭ
hickling	ﻩﺍیکﻝیﻥگ
hickman	ﻩیکﻡﻥ
hickory	ﻩیکﻭﺭی
hidajat	ﻩیﺩﺍﺝﺍﺕ
hidalgo	ﻩیﺩﺍﻝگﻭ
hiebert	ﻩیﺏﺭﺕ
hiern	ﻩیﺭﻥ
hieronimus	ﻩرﻭﻥیﻡﻭﺱ
hieu	ﻩﺍییﻭ
higa	ﻩیگﺍ
higdon	ﻩیﺝﺩﺍﻥ
higgins	ﻩیگیﻥﺯ
highland	ﻩﺍیﻝﻥﺩ
highlord	ﻩﺍیﻝﻭﺭﺩ
higuchi	ﻩیﻕﺍچی
hikaru	ﻩیکﺍﺭﻭ
hilal	ﺡیﻝﺍﻝ
hildebrandislant	ﻩیﻝﺩﺏرﺍﻥﺩیﺱﻝﺍﻥﺕ
hilker	ﻩیﻝکﺭ
hill	ﻩیﻝ
hillberry	ﻩیﻝﺏﺭی
hille	ﻩیﻝ
hillery	ﻩیﻝﺭی
hilletje	ﻩیﻝﺕ
hillis	ﻩیﻝیﺱ
hillyard	ﻩیﻝیﺍﺭﺩ
hilsenteger	ﻩیﻝﺱﻥﺕیگﺭ
hilson	ﻩیﻝﺱﻭﻥ
hilton	ﻩیﻝﺕﻥ
hiltz	ﻩیﺕﺯ
hime	ﻩﺍیﻡ
hin	ﻩیﻥ
hince	ﻩیﻥﺱ
hinchey	ﻩیﻥچی
hinchley	ﻩیﻥچﻝی
hinchliffe	ﻩﻥچﻝیﻑ
hind	ﻩیﻥﺩ
hine	ﻩﺍیﻥ
hinely	ﻩﺍیﻥﻝی
hiner	ﻩیﻥﺭ
hines	ﻩیﻥﺯ
hinika	ﻩیﻥیکﺍ
hinson	ﻩیﻥﺱﻭﻥ
hinz	ﻩیﻥﺯ
hiongun	ﻩیﻭﻥگﺍﻥ
hipgrave	ﻩیپگﺭیﻭ
hipp	ﻩیپ
hippely	ﻩﺍیپﻝی
hipps	ﻩیپﺱ
hirai	ﻩیﺭﺍی
hirata	ﻩیرﺍﺕﺍ
hiroi	ﻩیرﻭی
hirota	ﻩیﺭﻭﺕﺍ
hirt	ﻩیﺭﺕ
hisan	ﻩیﺱﺍﻥ
hiscocks	ﻩیﺱکﻭکﺱ
hisel	ﻩیﺱﻝ
hitchcock	ﻩیچکﺍک
hitchens	ﻩیچﻥﺱ
hitchman	ﻩیچﻡﻥ
hitesman	ﻩیﺕﺱﻡﺍﻥ
hitson	ﻩیﺕﺱﻭﻥ
hiu	ﻩیﻭ
hixon	ﻩیکﺱﻭﻥ
hlavenka	ﻝﺍﻭﻥکﺍ
hlavin	ﻩﻝﺍﻭیﻥ
hoadley	ﻩﻭﺍﺩﻝی
hoang	ﻩﻭیﻥگ
hoar	ﻩﻭﺍﺭ
hobbs	ﻩﺍﺏﺯ
hoberman	ﻩﻭﺏﺭﻡﻥ
hoborough	ﻩﺍﺏﻭرگ
hobson	ﻩﺍﺏﺱﻭﻥ
hochhalter	ﻩﺍچﻩﺍﻝﺕﺭ
hock	ﻩﺍک
hockey	ﻩﺍکی
hodgeman	ﻩﺍگﻡﻥ
hodgers	ﻩﺍﺝﺭﺯ
hodges	ﻩﺍﺝﺯ
hodgin	ﻩﻭﺩگی
hodgkins	ﻩﺍگکیﻥز
hodgson	ﻩﺍﺝﺱﻭﻥ
hofbauer	ﻩﺍﻑﺏﺍﻭیر
hoff	ﻩﺍﻑ
hoffmann	ﻩﺍﻑﻡﻥ
hofgaard	ﻩﻭﻑگﺍﺭﺩ
hofmann	ﻩﺍﻑﻡﻥ
hoford	ﻩﻭﻑﺭﺩ
hogan	ﻩﻭگﺍﻥ
hogarty	ﻩﻭگﺍﺭﺕی
hoge	ﻩﻭگ
hogg	ﻩﺍگ
hogley	ﻩﺍگﻝی
hoglund	ﻩﺍگﻝﺍﻥﺩ
hohensohn	ﻩﻭﻩﻥﺱﻭﻥ
hoiberg	ﻩﻭیﺏﺭگ
hoitink	ﻩﻭیﺕیﻥک
hokon	ﻩﻭکﻭﻥ
holcomb	ﻩﻭﻝکﺍﻡﺏ
holden	ﻩﻝﺩﻥ
holdsworth	ﻩﻭﻝﺩﺯﻭﺭث
holeman	ﻩﻭﻝﻡﻥ
holfelder	ﻩﺍﻝﻑﻝﺩﺭ
holford	ﻩﺍﻝﻑﻭﺭﺩ
holkner	ﻩﺍﻝکﻥﺭ
holland	ﻩﺍﻝﻥﺩ
hollander	ﻩﻝﻥﺩﺭ
holle	ﻩﻝی
holliday	ﻩﺍﻝیﺩی
hollifield	ﻩﺍﻝیﻑیﻝﺩ
hollinden	ﻩﻝیﻥﺩﻥ
hollinger	ﻩﺍﻝیﻥگر
hollyman	ﻩﺍﻝیﻡﻥ
holm	ﻩﻭﻝﻡ
holman	ﻩﺍﻝﻡﻥ
holmes	ﻩﻝﻡﺯ
holmquist	ﻩﻭﻝﻡکﻭیﺱﺕ
holroyd	ﻩﻭﻝﺭﻭیﺩ
holst	ﻩﺍﻝﺱﺕ
holsten	ﻩﻭﻝﺱﺕﻥ
holt	ﻩﺍﻝﺕ
holton	ﻩﺍﻝﺕﻭﻥ
holtsinger	ﻩﺍﻝﺕﺱیﻥگﺭ
holtz	ﻩﺍﻝﺕﺯ
holub	ﻩﺍﻝﻭﺏ
holum	ﻩﻝﻭﻡ
holy	ﻩﻝی
holzman	ﻩﻝﺯﻡﻥ
holzwarth	ﻩﻭﻝﺯﻭﺍﺭث
homan	ﻩﻭﻡﻥ
homann	ﻩﻭﻡﺍﻥ
hon	ﻩﻥ
hong	ﻩﺍﻥگ
honig	ﻩﻥیگ
honigberg	ﻩﻭﻥیگﺏﺭگ
honnencourt	ﻩﺍﻥﻥکﻭﺭﺕ
honnur	ﺍﻥﻭﺭ
hooft	ﻩﻭﻑﺕ
hoogenboom	ﻩﻭگﻥﺏﻭﻡ
hoogeveen	ﻩﻭگﻭیﻥ
hoogheem	ﻩﻭﻕیﻡ
hoogland	ﻩﻭگﻝﻥﺩ
hooi	ﻩﻭی
hook	ﻩﻭک
hooker	ﻩﻭکﺭ
hoon	ﻩﻭﻥ
hooper	ﻩﻭپﺭ
hoopes	ﻩﻭپﺯ
hoos	ﻩﻭﺱ
hooten	ﻩﻭﺕﻥ
hooven	ﻩﻭﻭﻥ
hoover	ﻩﻭﻭﺭ
hope	ﻩﻭپ
hopkins	ﻩﺍپکیﻥﺯ
hoppe	ﻩﻭپ
hopper	ﻩﺍپﺭ
hopps	ﻩﺍپﺯ
hor	ﻩﻭر
horak	ﻩﺭﺍک
horan	ﻩﺭﺍﻥ
horgan	ﻩﻭﺭگﺍﻥ
horio	ﻩﺍﺭیﻭ
horkan	ﻩﻭﺭکﺍﻥ
horn	ﻩﺭﻥ
horne	ﻩﺭﻥ
hornecker	ﻩﺭﻥکﺭ
horner	ﻩﺍﺭﻥﺭ
hornig	ﻩﻭﺭیﻥگ
hornsby	ﻩﺭﻥﺱﺏﺍی
horowitz	ﻩﻭﺭﻭیﺕﺯ
horree	ﻩﻭﺭی
horsfall	ﻩﺭﺱﻑﺍﻝ
horsford	ﻩﻭﺭﺱﻑﻭﺭﺩ
horsmeier	ﻩﻭﺭﺱﻡیﺭ
horst	ﻩﻭﺭﺱﺕ
hortmann	ﻩﻭﺭﺕﻡﻥ
horton	ﻩﻭﺭﺕﻥ
horvat	ﻩﻭﺭﻭﺍﺕ
horvath	ﻩﺍﺭﻭﺍﺕ
horwitz	ﻩﻭرﻭیﺕﺯ
hosain	ﺡﺱیﻥ
hosek	ﻩﺱک
hoskins	ﻩﺍﺱکیﻥﺯ
hosler	ﻩﺍﺱﻝر
hosn	ﺡﺱﻥ
hosny	ﺡﺱﻥی
hostetler	ﻩﺍﺱﺕﺕﻝﺭ
hotopp	ﻩﺍﺕﺍپ
hou	ﻩﻭ
houde	ﻩﻭﺩ
hough	ﻩﻭ
houghtailing	ﻩگﺕیﻝیﻥگ
houghten	ﻩﺍگﺕﻥ
houghton	ﻩﺍﻭﺕﻭﻥ
hourcle	ﻩﺍﺭکﻝ
hourihan	ﻩﻭﺭیﻩﺍﻥ
houser	ﻩﺍﻭﺱﺭ
houston	ﻩﺍﺱﺕﻭﻥ
hovey	ﻩﺍﻭی
howard	ﻩﺍﻭﺍﺭﺩ
howarth	ﻩﻭﻭﺍﺭﺕ
howe	ﻩﻭ
howell	ﻩﺍﻭﻝ
howells	ﻩﺍﻭﻝﺯ
howerter	ﻩﻭﺭﺕﺭ
howk	ﻩﺍﻭک
howland	ﻩﺍﻭﻝﻥﺩ
hoy	ﻩﻭی
hrabi	ﻩﺭﺍﺏی
hua	ﻩﻭیﺍ
hubein	ﻩﺍﺏیﻥ
huber	ﻩﺍﺏﺭ
hubner	ﻩﺍﺏﻥر
huby	ﻩﺍﺏی
huck	ﻩﺍک
huckaby	ﻩﺍکﺍﺏﺍی
huckriede	ﻩﺍکریﺩ
huckvale	ﻩﺍکﻭیﻝ
hudaydah	ﺡﺩیﺩﻩ
hudden	ﻩﺍﺩﻥ
hudoba	ﻩﺍﺩﻭﺏﺍ
hudson	ﻩﺍﺩﺱﻥ
huerta	ﻩﻭﺍﺭﺕﺍ
huetten	ﻩیﻭﺕﻥ
huff	ﻩﺍﻑ
huffer	ﻩﺍﻑر
huffman	ﻩﺍﻑﻡﻥ
hug	ﻩﺍگ
hugard	ﻩﻭگﺍﺭﺩ
hugdahl	ﻩﺍگﺩﺍﻝ
huggard	ﻩﻭگﺍﺭﺩ
hugh	ﻩیﻭ
hughes	ﻩیﻭﺯ
hughson	ﻩﺍگﺱﻭﻥ
hugo	ﻩﻭگﻭ
huhtala	ﻩﺍﻩﺕﺍﻩﺍ
hui	ﻩﻭی
huigen	ﻩیﻭگﻥ
huisken	ﻩﻭییﺱکﻥ
huizenga	ﻩﻭیﺯﻥگﺍ
huizing	ﻩﺭﺍیﺯیﻥگ
hukill	ﻩﺍکیﻝ
hulan	ﻩﺍﻝﺍﻥ
hull	ﻩﺍﻝ
hulme	ﻩﺍﻝﻡﻩ
hulse	ﻩﻭﻝﺱ
hulsey	ﻩﺍﻝﺱی
hum	ﻩﺍﻡ
humanes	ﻩیﻭﻡﻥﺯ
hume	ﻩیﻭﻡ
humiecki	ﻩﺍﻡیچی
humm	ﻩﻭﻡ
hummel	ﻩﺍﻡﻝ
hummock	ﻩﻭﻡﺍک
humpherys	ﻩﺍﻡﻑﺭیﺯ
humphrey	ﻩﺍﻡﻑﺭی
humphreys	ﻩﺍﻡﻑﺭیﺯ
hung	ﻩﺍﻥگ
hungerford	ﻩﺍﻥگﺭﻑﻭﺭﺩ
hunkler	ﻩﺍﻥکﻝﺭ
hunnicutt	ﻩﻭﻥیکﺍﺕ
hunsaker	ﻩﺍﻥﺱﺍکﺭ
hunt	ﻩﺍﻥﺕ
huntington	ﻩﺍﻥﺕیﻥگﺕﻭﻥ
hureslede	ﻩرﺱﻝﺩ
hurley	ﻩﺍﺭﻝی
hurt	ﻩﺍﺭﺕ
hurtack	ﻩرﺕﺍک
hurtah	ﻩﺍﺭﺕﺍﻩ
hurzeler	ﻩﻭﺭﺯﻝﺭ
husain	ﺡﺱیﻥ
husby	ﻩﺍﺱﺏی
husik	ﻩﺍﺱیک
husk	ﻩﺍﺱک
hussain	ﺡﺱیﻥ
hussein	ﺡﺱیﻥ
hussey	ﻩﻭﺱی
husvar	ﻩﺍﺱﻭﺍر
hutcheson	ﻩﺍﺕچﺱﻭﻥ
hutchins	ﻩﺍچیﻥﺯ
hutchinson	ﻩﺍچیﻥﺱﻭﻥ
hutchison	ﻩﺍچیﺱﻭﻥ
huth	ﻩﺍﺕ
hutter	ﻩﺍﺕﺭ
huttley	ﻩﺍﺕﻝی
hutton	ﻩﺍﺕﻭﻥ
hutty	ﻩﺕی
huyck	ﻩﺍیک
huyer	ﻩﺍیﺭ
huyge	ﻩﺍیگ
huyler	ﻩﻭیﻝر
huyser	ﻩﻭیﺱﺭ
hvezda	ﻭﺯﺩﺍ
hviid	ﻩﻭیﺩ
hvinden	ﻭیﻥﺩﻥ
hwang	ﻩﻭﺍﻥگ
hyde	ﻩﺍیﺩ
hyland	ﻩیﻝﻥﺩ
hyler	ﻩﺍیﻝر
hyman	ﻩیﻡﻥ
hynes	ﻩیﻥﺯ
hyslop	ﻩیﺱﻝﺍپ
hyson	ﻩﺍیﺱﻭﻥ
hyun	ﻩﺍیﻥ
hyunsoo	ﻩیﻭﻥﺱﻭ
hyvonen	ﻩﺍﻭﻭﻥﻥ
iacoletti	یﺍکﻭﻝﺕی
ian	یﺍﻥ
iant	ﺍیﺍﻥﺕ
iarla	یﺍﺭﻝﺍ
ibar	ﺍیﺏﺍﺭ
ibarra	ﺍیﺏﺍرﺍ
ibbetson	ﺍیﺏﺕﺱﻭﻥ
ibironke	ﺍیﺏیﺭﻭﻥک
ibrahim	ﺍﺏﺭﺍﻩیﻡ
ibrini	ﺍﺏﺭیﻥی
icarus	ﺍیکﺍﺭﻭﺱ
ice	ﺍیﺱ
icefall	ﺍیﺱﻑﺍﻝ
icefalls	ﺍیﺱﻑﺍﻝﺯ
icelic	ﺍیﺱﻝیک
ichiro	ﺍیچیﺭﻭ
iclozan	ﺍیکﻝﻭﺯﺍﻥ
ida	ﺍیﺩﺍ
iddo	ﺍیﺩﻭ
idris	ﺍﺩﺭیﺱ
idun	ﺍیﺩﺍﻥ
idury	ﺍیﺩﻭﺭی
ienatch	ﺍیﻥﺍچ
ierardi	ﺍیﺭﺍﺭﺩی
ifje	ﺍیﻑ
ifo	ﺍیﻑﻭ
igloo	ﺍیگﻝﻭ
ignasi	ﺍیگﻥﺍﺱی
ignatius	ﺍیگﻥﺍﺕیﻭﺱ
igoe	ﺍیگﻭ
igor	ﺍیگﻭﺭ
ihan	ﺍیﻩﺍﻥ
ijuin	ﺍیﺝﻭیﻥ
ike	ﺍیکﻩ
ikeda	ﺍیکﺩﺍ
ilan	ﺍیﻝﺍﻥ
ilana	ﺍیﻝﺍﻥﺍ
ileen	ﺍیﻝیﻥ
iler	ﺍیﻝﺭ
ilidio	ﺍیﻝیﺩیﻭ
ilieve	ﺍیﻭ
iliff	یﻝیﻑ
ilkka	ﺍیﻝکﺍ
illgner	ﺍیﻝگﻥر
ilpo	ﺍیﻝپﻭ
ilyess	ﺍیﻝیﺱ
imants	ﺍیﻡﺍﻥﺕﺯ
imar	ﺍیﻡﺍﺭ
imerio	ﺍیﻡﺭیﻭ
immanuel	ﺍﻡﺍﻥﻭیﻝ
immelman	ﺍﻡﻝﻡﺍﻥ
inan	ﺍیﻥﺍﻥ
inauen	ﺍیﻥﺍیﻥ
inca	ﺍیﻥکﺍ
inch	ﺍیﻥچ
incognita	ﺍیﻥکﻭگﻥیﺕﺍ
indewey	ﺍیﻥﺩﻭی
indian	ﺍیﻥﺩیﻥ
indigo	ﺍیﻥﺩیگﻭ
indiresan	ﺍیﻥﺩﺍیﺭﺱﻥ
indra	ﺍیﻥﺩﺭﺍ
indranil	ﺍیﻥﺩﺭﺍﻥیﻝ
indrelee	ﺍیﻥﺩﺭﻝی
indulis	ﺍیﻥﺩﺍﻝیﺱ
ines	ﺍیﻥﺱ
infante	ﺍیﻥﻑﻥﺕ
infinite	ﺍیﻥﻑیﻥیﺕ
infotek	ﺍیﻥﻑﻭﺕیک
ing	ﺍیﻥگ
ingalls	ﺍیﻥگﺍﻝﺯ
inge	ﺍیﻥگ
ingegneri	ﺍیﻥﺝﺝﻥﺭی
ingemar	ﺍیﻥگﻡﺍﺭ
ingersoll	ﺍیﻥگرﺱﻭﻝ
ingham	ﺍیﻥگﻩﺍﻡ
ingle	ﺍیﻥگﻝ
ingles	ﺍیﻥگﻝﺱ
inglis	ﺍیﻥگﻝیﺱ
ingmar	ﺍیﻥگﻡﺍﺭ
ingo	ﺍیﻥگﻭ
ingolf	ﺍیﻥگﻝﻑ
ingraham	ﺍیﻥگﺭﺍﻩﺍﻡ
ingram	ﺍیﻥگﺭﺍﻡ
ingres	ﺍیﻥگرﺱ
ingresole	ﺍیﻥگریﺱﻝ
ingria	ﺍیﻥگﺭیﺍ
ingrid	ﺍیﻥگﺭیﺩ
ingvar	ﺍیﻥگﻭﺍﺭ
inho	ﺍیﻥﻩﻭ
inland	ﺍیﻥﻝﻥﺩ
inlet	ﺍیﻥﻝﺕ
inmarsat	ﺍیﻥﻡﺍﺭﺱﺍﺕ
innes	ﺍیﻥﺯ
innocent	ﺍیﻥﻭﺱﻥﺕ
insane	ﺍیﻥﺱیﻥ
institut	ﺍﻥﺱﺕیﺕﻭ
intelsat	ﺍیﻥﺕﻝﺱﺍﺕ
internet	ﺍیﻥﺕﺭﻥﺕ
intyre	ﺍیﻥﺕﺍیﺭ
inzhenery	ﺍیﻥﺯﻩﻥﺭی
ion	ﺍیﻭﻥ
irani	ﺍیﺭﺍﻥی
irbid	ﺍرﺏیﺩ
ireland	ﺍیﺭﻝﻥﺩ
irissou	ﺍیﺭیﺱﻭ
irizarry	ﺍیﺭیﺯﺍﺭی
irvin	ﺍیﺭﻭیﻥ
irvine	ﺍیرﻭیﻥ
irving	ﺍرﻭیﻥگ
irwin	ﺍیﺭﻭییﻥ
isa	ﺍیﺱﺍ
isaac	ﺍیﺱﺍک
isaacs	ﺍیﺱﺍکﺱ
isacq	ﺍیزﺍک
isbell	ﺍیﺱﺏﻝ
isecke	ﺍیﺱک
iselt	ﺍیﺱﻝﺕ
ishizaki	ﺍیﺵیﺯﺍکی
iskander	ﺍیﺱکﺍﻥﺩﺭ
isman	ﺍیزﻡﻥ
isom	ﺍیﺱﺍﻡ
israel	ﺍﺱﺭﺍییﻝ
israngkura	ﺍیﺱﺭﻥکﻭﺭﺍ
istian	ﺍیﺱﺕیﻥ
itamar	ﺍیﺕﺍﻡﺍﺭ
itchon	ﺍیﺕچﻭﻥ
iunn	یﻭﻥ
ivanich	ﺍیﻭﺍﻥیچ
ivanov	ﺍیﻭﺍﻥﻭﻭ
ivar	ﺍیﻭﺍﺭ
iverson	ﺍیﻭﺭﺱﻭﻥ
ivery	ﺍیﻭﺭی
ivetic	ﺍیﻭﺕیک
iwane	ﺍیﻭﺍﻥ
iwatsuki	ﺍیﻭﺍﺕﺱﻭکی
iyengar	ﺍیﻥگﺍر
iyer	ﺍیﺭ
izadi	ﺍیﺯﺩی
izen	ﺍیﺯﻥ
izroda	ﺍیﺯﺭﻭﺩﺍ
izzo	ﺍیﺯﻭ
jaantje	ژﺍﻥﺕ
jacaway	ﺝﺍکﺍﻭی
jack	ﺝک
jackman	ﺝکﻡﻥ
jackson	ﺝکﺱﻭﻥ
jacobje	ژﺍکﻭﺏ
jacobs	ﺝکﺏﺱ
jacobsen	ﺝکﺏﺱﻥ
jacobson	ﺝﺍکﻭﺏﺱﻭﻥ
jacobsson	ﺝﺍکﻭﺏﺱﻭﻥ
jacoby	ﺝﺍکﻭﺏی
jacomyntie	ژﺍکﻭﻡیﻥﺕﺍی
jacques	ژﺍکیﻭﺱ
jagard	ﺝﺍگﺍﺭﺩ
jager	ﺝﺍگﺭ
jago	ﺝﺍگﻭ
jahmane	ﺝﺍﻩﻡﺍﻥﻩ
jahn	ﺝﺍﻥ
jahra	زﻩرﺍ
jain	ﺝیﻥ
jakeman	ﺝکﻡﻥ
jakes	ﺝیکﺱ
jakobsson	ﺝکﻭﺏﺱﻭﻥ
jala	ﺝﺍﻝﺍ
jalal	ﺝﻝﺍﻝ
jalani	ﺝﻝﺍﻥی
jaleel	ﺝﺍﻝیﻝ
jalen	ﺝﺍﻝﻥ
jalonen	ﺝﺍﻝﻭﻥﻥ
jamal	ﺝﻡﺍﻝ
james	ﺝیﻡز
jameson	ﺝیﻡﺱﻭﻥ
jamie	ﺝیﻡی
jamih	ﺝﻡیﻩ
jamil	ﺝﻡیﻝ
jamulla	ﺝﻡﻭﻝﺍ
jamuna	ﺝﺍﻡﻭﻥﺍ
jan	ﺝﺍﻥ
jana	ﺝﺍﻥﺍ
janakiraman	ﺝیﻥﺍکیﺭﺍﻡﺍﻥ
janardhan	ﺝﺍﻥﺍﺭﺩﻩﺍﻥ
janches	ﺝﺍﻥچﺱ
janecek	ﺝیﻥیک
janecka	ﺝﺍﻥیکﺍ
janes	ﺝیﻥﺯ
jang	ﺝﺍﻥگ
jani	ﺝﺍﻥی
janicki	ﺝﺍﻥیکی
jann	ﺝﺍﻥ
janneken	ﺝﺍﻥکﻥ
jannetje	ﺝﺍﻥﺕ
janotje	ﺝﺍﻥﺕ
jansen	ﺝیﻥﺱﻥ
jansje	ژﺍﻥﺱ
jansky	ﺝﺍﻥﺱکی
janssen	ﺝﺍﻥﺱﻥ
janzen	ﺝیﻥﺯﻥ
jarash	ﺍرﺵ
jardine	ﺝﺍﺭﺩیﻥ
jarrett	ﺝﺍﺭﺕ
jarvis	ﺝرﻭیﺱ
jarwala	ﺝﺍﺭﻭﺍﻝﺍ
jasmine	ﺝﺱﻡیﻥ
jasper	ﺝﺍﺱپﺭ
jaspers	ﺝﺍﺱپﺭﺯ
jasvinder	ﺝﺍﺱﻭیﻥﺩﺭ
jatinder	ﺝﺍﺕیﻥﺩﺭ
jatou	ﺝﺍﺕﻭ
javed	ﺝﺍﻭیﺩ
jawf	ﺝﺍﻑ
jayan	ﺝﺍیﺍﻥ
jayant	ﺝﺍیﺍﻥﺕ
jayaraman	ﺝﺍیﺍﺭﺍﻡﺍﻥ
jaymes	ﺝیﻡﺯ
jayne	ﺝیﻥ
jaynes	ﺝیﻥﺯ
jazayerli	ﺝﺯﺍیرﻝی
jazlyn	ﺝزﻝیﻥ
jean	ﺝیﻥ
jebsen	ﺝﺏﺱﻥ
jed	ﺝﺩ
jee	ﺝی
jeff	ﺝﻑ
jeffcock	ﺝﻑکک
jefferies	ﺝﻑﺭﺍیﺯ
jeffrey	ژﻑﺭی
jeffries	ﺝﻑﺭیﺯ
jehan	ﺝﻩﺍﻥ
jelenc	ﺝﻝﻥک
jelleyman	ﺝیﻝﻡﻥ
jeltje	ژﻝﺕﺝ
jelvemark	ﺝﻝﻭﻡﺍﺭک
jen	ﺝﻥ
jenah	ﺝﻥﺍﺡ
jeng	ﺝﻥگ
jenings	ﺝﻥیﻥگﺯ
jenkinson	ﺝﺍﻥکیﻥﺱﻭﻥ
jenks	ﺝﻥکﺱ
jenneke	ژﻥک
jennifer	ﺝﻥیﻑﺭ
jensen	ﺝﻥﺱﻥ
jeppesen	ﺝپﺱﻥ
jerada	ﺝﺭﺍﺩﺍ
jeremias	ﺝرﻡیﺍﺱ
jeremic	ﺝﺭﻡیک
jeremy	ﺝﺭﻡی
jergens	ﺝﺭگﻥﺯ
jeske	ﺝﺱک
jess	ﺝیﺱ
jesse	ﺝیﺱﻩ
jessica	ﺝﺱیکﺍ
jessick	ﺝﺱیک
jester	ﺝیﺱﺕﺭ
jesus	ﺝیﺱﻭﺯ
jethro	ﺝﺕﺭﻭ
jetsam	ﺝﺕﺱﺍﻡ
jewell	ﺝیﻭیﻝ
jeynes	ﺝیﻥﺱ
jezire	ﺝﺯیﺭﻩ
jia	ﺝیﺍ
jian	ﺝیﺍﻥ
jigang	ﺝیگﺍﻥگ
jill	ﺝیﻝ
jilles	ﺝیﻝﺯ
jillian	ﺝیﻝیﺍﻥ
jim	ﺝیﻡ
jiminey	ﺝیﻡیﻥی
jin	ﺝیﻥ
jing	ﺝیﻥگ
jirman	ﺝیﺭﻡﻥ
jirousek	ﺝیﺭﻭﺱک
jitta	ﺝیﺕﺍ
jizan	ﺝیزﺍﻥ
joab	ﺝﻭﺍﺏ
joan	ﺝﻭﺍﻥ
joao	ﺝﻭﺍﻭ
joaptie	ژﻭپﺕﺍی
jobje	ژﺍﺏژ
jody	ﺝﻭﺩی
joel	ژﻭﻝ
joesph	ﺝﻭیﺱﻑ
joffe	ﺝﻭﻑ
jog	ﺝﺍگ
johanes	ﺝﻭﻩﺍﻥﺯ
johann	ﺝﻭﻩﺍﻥ
johanna	ﺝﻭﻩﺍﻥﺍ
johanne	ﺝﻭﻩﺍﻥ
johannes	ژﻭﻩﺍﻥﺱ
johannesen	ﺝﻭﻩﺍﻥﺱﻥ
johannson	ﺝﻭﻩﺍﻥﺱﻭﻥ
johansen	ﺝﻭﻩﺍﻥﺱﻥ
johansson	ژﻭﻩﺍﻥﺱﻥ
johar	ﺝﻭﻩﺭ
john	ژﺍﻥ
johnathan	ﺝﺍﻥﺍﺕﺍﻥ
johnny	ﺝﺍﻥی
johns	ﺝﺍﻥﺯ
johnsen	ﺝﺍﻥﺱﻥ
johnson	ﺝﺍﻥﺱﻭﻥ
joiner	ﺝﻭیﻥﺭ
joisher	ﺝﻭیﺵر
jokin	ﺝکیﻥ
jokitalo	ﺝﻭکیﺕﺍﻝﻭ
jolee	ﺝﻭﻝی
jolene	ﺝﻝﻥی
jolliff	ﺝﻭﻝیﻑ
jolly	ژﻭﻝی
joltes	ﺝﻭﻝﺕﺯ
joly	ﺝﻭﻝی
jolyon	ﺝﻝیﻭﻥ
jon	ﺝﺍﻥ
jonas	ﺝﻭﻥﺍﺱ
jonathan	ﺝﺍﻥﺍﺕﺍﻥ
jonathon	ﺝﺍﻥﺍﺕﻭﻥ
jong	ﺝﺍﻥگ
jonin	ﺝﻭﻥیﻥ
jonn	ﺝﻭﻥ
jonsson	یﻭﻥﺱﻭﻥ
joon	ﺝﻭﻥ
jooss	ﺝﻭﺱ
joppru	ﺝﻭپﺭﻭ
jorge	ﺝﻭﺭﺝ
jorgen	ﺝﻭﺭﺝﻥ
jorgensen	ﺝرﺝیﻥﺱﻥ
jorritsma	ﺝریﺕﺱﻡﺍ
jory	ﺝﻭﺭی
josef	ﺝﻭﺯﻑ
josephson	ﺝﻭﺯﻑﺱﻭﻥ
josephus	ﺝﻭﺯﻑﻭﺱ
josey	ﺝﻭﺯی
josh	ﺝﺍﺵ
joshi	ﺝﻭﺵی
joshua	ﺝﺍﺵﻭﺍ
josi	ﺝﻭﺯی
josip	ﺝﻭﺱیپ
joslin	ﺝﻭﺱﻝیﻥ
jossac	ﺝﻭﺱﺍک
jost	ﺝﺍﺱﺕ
jostein	ﺝﺍﺱﺕیﻥ
joswig	ﺝﻭﺱﻭیگ
josyntie	ژﻭﺱیﻥﺕﻩ
joubb	ﺝﻭﺏ
joubert	ﺝﻭﺏﺭﺕ
joubin	ﺝﻭﺏیﻥ
jouko	ﺝﻭکﻭ
joungane	ﺝﻭﻥگﺍﻥ
jouni	ﺝﻭﻥی
joura	ﺝﻭﺭﺍ
jouravlev	ﺝﻭﺭﺍﻭﻝﻭ
jovica	ﺝﺍﻭیکﺍ
jowett	ﺝﻭیﺕ
joyce	ﺝﻭیﺱ
joydeep	ﺝﻭیﺩیپ
joyner	ﺝﻭیﻥﺭ
juan	ﺝﻭﺍﻥ
juana	ﺝﻭﺍﻥﺍ
juang	ﺝﻭﺍﻥگ
juanita	ﺝﻭﺍﻥیﺕﺍ
juay	ﺝﻭﺍی
jubal	ﺝﻭﺏﺍﻝ
jubb	ﺝﺍﺏ
jud	ﺝﺍﺩ
judas	ﺝﻭﺩﺍﺱ
judd	ﺝﺍﺩ
jude	ﺝﺍﺩ
judi	ﺝﻭﺩی
judith	ژﻭﺩیث
judson	ﺝﺍﺩﺱﻭﻥ
juerg	ﺝﻭیﺭگ
juergen	ﺝﻭﺭگﻥ
juhani	ﺝﻭﻩﺍﻥی
juisai	ﺝﻭیﺱﺍی
jumayao	ﺝﻭﻡﺍیﺍﻭ
jun	ﺝﺍﻥ
junaid	ﺝﻭﻥﺍیﺩ
jung	ﺝﺍﻥگ
junger	ﺝﺍﻥگﺭ
junghans	ﺝﻭﻥگﺍﻥﺯ
jungnickel	ﺝﺍﻥگﻥیکﻝ
junior	ﺝﻭﻥیﻭﺭ
junk	ﺝﺍﻥک
junker	ﺝﺍﻥکر
junkie	ﺝﻭﻥکی
juno	ﺝﻭﻥﻭ
junod	ﺝﻭﻥﺩ
jurah	ﺝﻭﺭﺍﻩ
jurek	ﺝﻭﺭک
jurgens	ﺝﻭﺭگﻥﺯ
jurisica	ژﻭﺭیﺱیکﺍ
jurran	ﺝﻭﺭﺍﻥ
jurt	ﺝﻭﺭﺕ
justham	ﺝﺍﺱﺕﺍﻡ
justice	ﺝﺍﺱﺕیﺱ
justin	ﺝﺍﺱﺕیﻥ
justine	ﺝﺍﺱﺕیﻥ
justje	ﺝﺍﺱﺕیﻩ
justo	ﺝﺍﺱﺕﻭ
jutzi	ﺝﻭﺕﺯی
juvander	ﺝﻭﺍﻥﺩﺭ
juza	ﺝﻭﺯﺍ
kabakibo	کﺏﺍکیﺏﻭ
kabir	کﺏیﺭ
kacalek	کﺍکﺍﻝک
kacandes	کﺍکﺍﻥﺩﺱ
kaden	کﺍﺩﻥ
kadin	کﺍﺩیﻥ
kado	کﺍﺩﻭ
kadribasic	کﺍﺩﺭیﺏیﺱیک
kagle	کﺍگﻝ
kahane	کﺍﻩﺍﻥ
kahoon	کﺍﻩﻭﻥ
kai	کﺍی
kailas	کﺍیﻝﺍﺱ
kailasa	کیﺍﻝﺍﺱﺍ
kairoff	کﺍیﺭﻭﻑ
kais	کﺍیﺱ
kaj	کﺍﺝ
kaki	کﺍکی
kakodkar	کﺍکﺩکﺍﺭ
kalafut	کﺍﻝﺍﻑﻭﺕ
kalapa	کﺍﻝﺍپﺍ
kalathur	کﺍﻝﺍﺕﻭﺭ
kalb	کﺍﻝﺏ
kalbus	کﺍﻝﺏﺍﺱ
kaldis	کﺍﻝﺩیﺱ
kale	کیﻝ
kaleb	کﺍﻝﺏ
kalemis	کﺍﻝﻡیﺱ
kalev	کﺍﻝﻭ
kalia	کﺍﻝیﺍ
kalil	کﺍﻝیﻝ
kalila	کﺍﻝیﻝﺍ
kalish	کﺍﻝیﺵ
kalisiak	کﺍﻝیﺱیﺍک
kalkan	کﺍﻝکﺍﻥ
kallberg	کﺍﻝﺏﺭگ
kalle	کﺍﻝ
kalliany	کﺍﻝیﺍﻥی
kalman	کﺍﻝﻡﺍﻥ
kalpak	کﺍﻝپﺍک
kalpana	کﺍﻝپﺍﻥﺍ
kalsow	کﺍﻝﺱﻭ
kalt	کﺍﻝﺕ
kalucki	کﺍﻝﻭکی
kalyan	کﺍﻝیﺍﻥ
kam	کﺍﻡ
kamal	کﺍﻡﺍﻝ
kamala	کﺍﻡﺍﻝﺍ
kamath	کﺍﻡﺍﺕ
kambiz	کﺍﻡﺏیﺯ
kamchi	کﺍﻡچی
kamdar	کﺍﻡﺩﺍﺭ
kame	کﺍﻡ
kamel	کﺍﻡﻝ
kamelen	کﺍﻡﻝﻥ
kamen	کﺍﻡﻥ
kamenev	کﺍﻡﻥﻭ
kamens	کﺍﻡﻥﺱ
kamerud	کﺍﻡﺭﻭﺩ
kamholz	کﺍﻡﻩﻭﻝﺯ
kamien	کﺍﻡیﻥ
kamil	کﺍﻡﻝ
kamilah	کﻡیﻝﺍ
kaminer	کﺍﻡیﻥﺭ
kamiya	کﺍﻡیﺍ
kamlish	کﺍﻡﻝیﺵ
kammeyer	کﻡیﺭ
kampe	کﺍﻡپ
kamper	کﺍﻡپﺭ
kamphuis	کﻡﻑﻭیﺱ
kamskaya	کﺍﻡﺱکﺍیﺍ
kan	کﺍﻥ
kanak	کﺍﻥﺍک
kanaka	کﺍﻥﺍکﺍ
kanakakorn	کﺍﻥﺍکﺍکﻭﺭﻥ
kanal	کﺍﻥﺍﻝ
kandell	کﻥﺩﻝ
kandi	کﺍﻥﺩی
kandolf	کﻥﺩﻭﻝﻑ
kane	کیﻥ
kang	کﺍﻥگ
kania	کﺍﻥیﺍ
kannan	کﺍﻥﺍﻥ
kansas	کﺍﻥﺱﺍﺱ
kant	کﺍﻥﺕ
kanthan	کﺍﻥﺕﺍﻥ
kantola	کﺍﻥﺩﻭﻝﺍ
kantor	کﺍﻥﺕﻭﺭ
kanze	کﺍﻥﺯی
kao	کیﻭ
kaos	کﺍﻭﺱ
kapalka	کﺍپﺍﻝکﺍ
kapetan	کپﺕﺍﻥ
kaphan	کﻑﺍﻥ
kapila	کﺍپیﻝﺍ
kapje	کپﺝﻩ
kaplan	کﺍپﻝﺍﻥ
kaplenk	کﺍپﻝیﻥک
kaply	کﺍپﻝی
kapner	کﺍپﻥﺭ
kapoor	کﺍپﻭﺭ
kappen	کﺍپﻥ
kapson	کﺍپﺱﻭﻥ
kar	کﺭ
kara	کﺍﺭﺍ
karabulut	کﺍﺭﺍﺏﻭﻝﻭﺕ
karaca	کﺍﺭﺍﺱﺍ
karahan	کﺍرﺍﻩﺍﻥ
karak	کرک
karan	کﺍﺭﺍﻥ
karas	کﺭﺍﺭﺍﺱ
karasu	کﺍﺭﺍﺱﻭ
karayel	کﺍﺭﺍیﻝ
karbala	کرﺏﻝﺍ
kardal	کرﺩﺍﻝ
kardel	کﺍﺭﺩﻝ
kardelis	کﺍﺭﺩﻝیﺱ
kareltje	کﺍرﻝﺕ
karen	کﺍﺭﻥ
karena	کﺍرﻥﺍ
kari	کﺍﺭی
karida	کریﺩﺍ
kariger	کﺍﺭیﺝﺭ
karim	کﺭیﻡ
karl	کﺍﺭﻝ
karlquist	کﺍﺭﻝکﻭیﺱﺕ
karlsson	کﺍﺭﺱﻭﻥ
karmann	کﺍﺭﻡﺍﻥ
karn	کﺍﺭﻥ
karner	کﺍﺭﻥﺭ
karp	کﺍﺭپ
karplus	کﺍﺭپﻝﺍﺱ
karr	کﺭ
karras	کﺍﺭﺍﺱ
kartik	کﺍﺭﺕیک
karty	کﺍﺭﺕی
karumuri	کﺭﺍﻡﺍﺭی
karvinen	کﺍﺭﻭیﻥﻥ
karwin	کﺍﺭﻭیﻥ
kasahara	کﺍﺱﺍﻩﺍﺭﺍ
kasai	کﺱﺍی
kasapi	کﺱپی
kasat	کﺍﺱﺍﺕ
kasaty	کﺍﺱﺍﺕی
kasemsant	کﺍﺱﻡﺱﺍﻥﺕ
kasouf	کﺍﺱﻭﻑ
kasprzak	کﺍﺱپﺭﺯﺍک
kassam	کﺍﺱﺍﻡ
kassem	کﺍﺱﻡ
kast	کﺱﺕ
kasteel	کﺍﺱﺕیﻝ
kastein	کﺍﺱﺕیﻥ
kasterchem	کﺍﺱﺕرچﻡ
kastner	کﺍﺱﺕﻥﺭ
kastrup	کﺱﺕﺭﺍپ
kasturi	کﺍﺱﺕﻭﺭی
kasun	کﺍﺱﻭﻥ
kateb	کﺍﺕﺏ
kateri	کﺍﺕﺭی
kates	کیﺕﺱ
kathleen	کﺍﺕﻝیﻥ
kathol	کﺍﺕﻝ
kathy	کﺕی
kati	کﺍﺕی
katie	کیﺕی
katishna	کﺍﻥیﺵﻥﺍ
katiyar	کﺍﺕیﺍﺭ
katleman	کﺍﺕﻝﻡﻥ
katopis	کﺍﺕﻭپیﺱ
katrin	کﺍﺕﺭیﻥ
katrina	کﺍﺕﺭیﻥﺍ
katryntje	کﺍﺕریﻥ
katta	کﺍﺕﺍ
kattan	کﺍﺕﺍﻥ
katwala	کﺍﺕﻭﺍﻝﺍ
katy	کﺕی
kauk	کﺍیک
kave	کﺍﻭﻩ
kaveh	کﺍﻭﻩ
kawado	کﺍﻭﺍﺩﻭ
kawai	کﺍﻭﺍیی
kayani	کیﺍﻥی
kaye	کی
kayser	کﺍیﺱﺭ
kayton	کﺍیﺕﻭﻥ
kazdan	کﺍﺯﺩﺍﻥ
kazi	کﺍﺯی
kazmaier	کﺍﺯﻡﺍیﺭ
kazuhiro	کﺍﺯﻭﻩیﺭﻭ
kazuhito	کﺍﺯﻭﻩیﺕﻭ
kazuo	کﺍﺯﻭ
keagle	کیگﻝ
kean	کیﻥ
keane	کیﻥ
keanini	کیﻥیﻥی
keasha	کیﺵﺍ
keat	کیﺕ
keating	کیﺕیﻥگ
keay	کی
keber	کﺏﺭ
kebir	کﺏیﺭ
kebire	کﺏیﺭﻩ
kecheng	کچﻥگ
keck	کک
kedar	کﺩﺭ
kee	کی
keeble	کیﺏﻝ
keebler	کیﺏﻝﺭ
keech	کیچ
keegan	کیگﺍﻥ
keelan	کیﻝﺍﻥ
keele	کیﻝ
keeler	کیﻝﺭ
keen	کیﻥ
keene	کیﻥ
keep	کیپ
keeping	کیپیﻥگ
keerthi	کیﺭﺕی
kees	کیﺱ
keesee	کیﺱی
keet	کیﺕ
keetje	کیﺕﺝ
kehle	کﻝ
kehoe	کیﻩﻭ
kei	کی
keidra	کیﺩﺭﺍ
keifer	کیﻑﺭ
keijo	کیﺝﻭ
keil	کیﻝ
keim	کیﻡ
keinanen	کیﻥﺍﻥﻥ
keinath	کیﻥﺍث
keinknen	کیﻥکﻥﻥ
keir	کیﺭ
keiran	کیﺭﺍﻥ
keith	کیﺕ
keithley	کیﺕﻝی
kelimoff	کﻝیﻡﻭﻑ
kelkar	کﻝکﺍﺭ
kellar	کﻝﺍﺭ
kellen	کﻝﻥ
keller	کیﻝﺭ
kellman	کﻝﻡﻥ
kellner	کﻝﻥﺭ
kellogg	کﻝﺍگ
kelly	کﻝی
kelm	کﻝﻡ
kelty	کﻝﺕی
keltz	کﻝﺕﺯ
kelvinen	کﻝﻭیﻥﻥ
kemker	کﻡکﺭ
kemmett	کﻡﺕ
kemp	کﻡپ
kempe	کﻡپ
kemper	کﻡپﺭ
kempster	کﻡپﺍﺱﺕر
ken	کﻥ
kendal	کﻥﺩﺍﻝ
kendall	کﻥﺩﺍﻝ
kendi	کﻥﺩی
kendrick	کﻥﺩﺭیک
keng	کﻥگ
kenn	کﻥ
kennaway	کﻥﺍﻭﺍی
kennedy	کﻥﺩی
kennepohl	کﻥپﻭﻝ
kenney	کﻥی
kenning	کﻥﻥیﻥگ
kennington	کﻥیﻥگﺕﻭﻥ
kensingto	کﻥﺱیﻥگﺕﻭ
kensiski	کﻥیﺱکی
kent	کﻥﺕ
kenta	کﻥﺕﺍ
kentaro	کﻥﺕﺍﺭﻭ
keny	کﻥی
kenyon	کﻥیﻥ
kenz	کﻥﺯ
kephart	کﻑﺍﺭﺕ
kepley	کپﻝی
kepner	کپﻥر
keppel	کپﻝ
kepus	کپﺍﺱ
kerbel	کﺭﺏﻝ
kerber	کرﺏیر
kerger	کﺭگﺭ
kerhong	کﺭﻩﺍﻥگ
kerien	کﺭیﻥ
kerila	کﺭیﻝﺍ
kermit	کﺭﻡیﺕ
kernie	کﺭﻥﺍی
kerns	کﺭﻥﺯ
keromitis	کﺭﻭﻡیﺕﺱ
kerrie	کﺭﺍی
kerrigan	کﺭیگﺍﻥ
kerry	کﺭی
kershner	کﺭﺵﻥﺭ
kerslake	کﺭﺱﻝیک
kerstin	کﺭﺱﺕیﻥ
kerwood	کرﻭﺩ
kesek	کﺱک
keshav	کﺵﺍﻭ
keshavan	کﺵﺍﻭﺍﻥ
keshlan	کﺵﻝﻥ
keskin	کﺱکیﻥ
kessler	کﺱﻝﺭ
kesson	کﺱﻭﻥ
kester	کﺍﺱﺕﺭ
kesterson	کﺱﺕﺭﺱﻭﻥ
kesti	کﺱﺕی
kestutis	کﺱﺕﺍﺕیﺱ
ket	کﺕ
ketan	کﺕﺍﻥ
ketcham	کﺕچﺍﻡ
ketil	کﺕیﻝ
ketley	کﺕﻝی
ketola	کﺕﻭﻝﺍ
kettell	کﺕﻝ
kettlewell	کﺕﻝﻭﻝ
kettyle	کﺕﺍیﻝ
keulen	کﻝﻥ
keun	کیﻭﻥ
kev	کﻭ
keven	کﻭﻥ
kevran	کﻭﺭﺍﻥ
kevyn	کﻭیﻥ
key	کی
keyes	کیﺯ
keyne	کیﻥ
keys	کیﺯ
keyser	کیﺱﺭ
keyuan	کیﻭﺍﻥ
khai	خﺍی
khalidah	ﺥﺍﻝیﺩﻩ
khan	خﺍﻥ
kheong	کﻭﺍﻥگ
khoury	خﻭری
kian	کیﺍﻥ
kianos	کیﺍﻥﻭﺱ
kiat	کیﺍﺕ
kibbe	کیﺏﻩ
kibler	کیﺏﻝﺭ
kibo	کیﺏﻭ
kick	کیک
kid	کیﺩ
kidby	کیﺩﺏی
kidd	کیﺩ
kief	کیﻑ
kiehl	کیﻩﻝ
kielhorn	کیﻝﻩﻭﺭﻥ
kiely	کیﻝی
kien	کیﻥ
kiepert	کیپﺭﺕ
kiera	کیﺭﺍ
kieran	کیﺭﺍﻥ
kieras	کیﺭﺍﺱ
kiernan	کییرﻥﺍﻥ
kieth	کیﺕ
kiev	کیﻭ
kifer	کیﻑر
kikuma	کیکﻭﻡﺍ
kilbane	کیﻝﺏیﻥ
kilby	کیﻝﺏی
kilg	کیﻝگ
kilgour	کیﻝگﻭﺭ
kilian	کیﻝیﺍﻥ
killer	کیﻝﺭ
killermet	کیﻝﺭﻡﺕ
killion	کیﻝیﻭﻥ
kills	کیﻝﺯ
kilpatrick	کیﻝپﺍﺕریک
kilpe	کیﻝپ
kilzer	کیﻝﺯﺭ
kim	کیﻡ
kimball	کیﻡﺏﺍﻝ
kimberey	کیﻡﺏری
kimberley	کیﻡﺏرﻝی
kimes	کیﻡﺯ
kimmo	کیﻡﻭ
kimo	کیﻡﻭ
kimon	کیﻡﻭﻥ
kimppa	کیﻡپﺍ
kimura	کیﻡﻭﺭﺍ
kin	کیﻥ
kinahan	کیﻥﺍﻩﺍﻥ
kinane	کیﻥﺍﻥ
kinard	کیﻥﺍﺭﺩ
kinchen	کیﻥچﻥ
kinder	کیﻥﺩﺭ
king	کیﻥگ
kingdon	کیﻥگﺩﺍﻥ
kingery	کیﻥگﺭی
kingfai	کیﻥگﻑﺍی
kingsford	کیﻥگﺱﻑﻭﺭﺩ
kingsley	کیﻥگﺱﻝی
kingsnorth	کیﻥگزﻥﻭرﺕ
kingston	کیﻥگزﺕﻥ
kini	کیﻥی
kinkade	کیﻥکیﺩ
kinky	کیﻥی
kinman	کیﻥﻡﻥ
kinnersley	کیﻥﺭﺱﻝی
kinney	کیﻥی
kinns	کیﻥﺯ
kinsell	کیﻥﺱﻝ
kinsey	کیﻥﺯی
kinsman	کیﻥﺯﻡﺍﻥ
kinson	کیﻥﺱﻭﻥ
kint	کیﻥﺕ
kintel	کیﻥﺕﻝ
kinzl	کیﻥﺯﻝ
kiong	کیﻭﻥگ
kip	کیپ
kipling	کیپﻝیﻥگ
kipp	کیپ
kips	کیپﺯ
kirby	کیﺭﺏی
kirill	کﺭیﻝ
kirin	کﺭیﻥ
kirishi	کیﺭیﺵی
kirk	کیﺭک
kirlew	کﺭﻝﻭ
kirmse	کیﺭﻡﺯ
kiser	کیﺱﺭ
kish	کیﺵ
kishore	کیﺵﻭﺭ
kisley	کیﺱﻝی
kislo	کیﺱﻝﻭ
kiss	کیﺱ
kissane	کیﺱیﻥ
kissinger	کیﺱیﻥﺝﺭ
kitaguchi	کیﺕﺍگﻭچی
kitamura	کیﺕﺍﻡﻭﺭﺍ
kitayama	کیﺕﺍیﺍﻡﺍ
kitch	کیﺕچ
kitchen	کیچﻥ
kitchin	کیچیﻥ
kitt	کیﺕ
kittel	کیﺕﻝ
kiuchi	کیﻭچی
kivimaa	کیﻭیﻡﺍ
kivivalli	کیﻭیﻭﺍﻝی
kizer	کیﺯﺭ
klafka	کﻝﺍﻑکﺍ
klammer	کﻝﺍﻡﺭ
klasmeier	کﻝﺍﺱﻡیر
klassa	کﻝﺍﺱﺍ
klassen	کﻝﺍﺱﻥ
klatt	کﻝﺍﺕ
klausmeier	کﻝﺍﺱﻡیﺭ
klausner	کﻝﺍﻭﺱﻥﺭ
klawiter	کﻝﺍﻭیﺕﺭ
klebanow	کﻝﺏﺍﻥﻭ
kleckner	کﻝکﻥر
kleiber	کﻝیﺏﺭ
klein	کﻝیﻥ
kleinsorge	کﻝیﻥﺱﻭﺭگ
klemans	کﻝﻡﺍﻥﺯ
klemm	کﻝﻡ
klemmer	کﻝیﻡﺭ
klemp	کﻝﻡپ
klie	کﻝی
klinck	کﻝیﻥک
kline	کﻝیﻥ
klingler	کﻝیﻥگﻝﺭ
klosterman	کﻝﺍﺱﺕرﻡﻥ
kloth	کﻝﻭﺕ
klotz	کﻝﺍﺕﺯ
kloubek	کﻝﻭﺏک
kloukinas	کﻝﻭکیﻥﺍﺱ
klug	کﻝﺍگ
klute	کﻝﻭﺕﻩ
klyber	کﻝیﺏﺭ
knapp	ﻥپ
knappen	ﻥﺍپﻥ
knel	ﻥﻝ
knelangen	ﻥﻝﺍﻥگﻥ
knepper	کپﺭ
kneusel	ﻥﻭﺱﻝ
knickerbacker	کﻥیکرﺏکر
kniffin	ﻥیﻑیﻥ
knight	کیﻥﺕ
knights	ﻥﺍیﺕﺯ
knip	ﻥیپ
knippenberg	ﻥیپﻥﺏﺭگ
knispel	ﻥیﺱپﻝ
knob	کﻥﻭﺏ
knobel	ﻥﻭﺏﻝ
knoefel	ﻥﻭیﻑﻝ
knoell	ﻥﻭیﻝ
knoerzer	ﻥﻭرﺯر
knoke	ﻥﺍک
knoles	ﻥﻭﻝﺱ
knoll	کﻥﻭﻝ
knolls	ﻥﻭﻝﺯ
knop	ﻥﺍپ
knoph	ﻥﺍﻑ
knowles	ﻥﺍیﻭﻝﺱ
knox	ﻥﻭکﺱ
knufinke	کﻥﻭﻑیﻥکﻩ
knutsen	ﻥﺍﺕﺱﻥ
knutson	ﻥیﻭﺕﺱﻭﻥ
knutzen	ﻥﻭﺕﺯﻥ
kobb	کﻭﺏ
kobben	کﻭﺏﻥ
kobel	کﻭﺏﻝ
koci	کﺍﺱی
kocian	کﻭﺵیﻥ
kocourek	کﻭکﻭﺭک
kodish	کﻭﺩیﺵ
koenraad	کﻥرﺍﺩ
kogias	کﻭﺝیﺍﺱ
kogoma	کﻭگﻭﻡﺍ
koichi	کﻭیچی
koike	کﻭیک
kojamo	کﻭﺝﺍﻡﻭ
kojian	کﻭﺝیﺍﻥ
kok	کﺍک
kokal	کﻭکﺍﻝ
kokenge	کﻭکﻥﺝ
kokinis	ککیﻥیﺱ
kokkonen	کﻭکﻭﻥﻥ
kolasa	کﻭﻝﺍﺱﺍ
kole	کﻝ
kolen	کﻭﻝﻥ
kolesar	کﻭﻝﺱﺍﺭ
kolichala	کﻭﻝیچﺍﻝﺍ
koliha	کﻭﻝیﻩﺍ
kolkka	کﻭﻝکﺍ
kollars	کﻭﻝﺍرﺱ
koller	کﺍﻝﺭ
kolluri	کﺍﻝﺭی
kolodney	کﻝﺩﻥی
kolodny	کﻭﻝﻭﺩﻥی
kolstad	کﻭﻝﺱﺕﺍﺩ
kolte	کﻭﻝﺕ
koma	کﻡﺍ
komorita	کﻭﻡﻭﺭیﺕﺍ
komp	کﻭﻡپ
kompar	کﺍﻡپﺍﺭ
kon	کﻭﻥ
kondis	کﻭﻥﺩیﺱ
konerding	کﻥﺭﺩیﻥگ
konestabo	کﺍﻥﺱﺕﺍﺏﻭ
kong	کﺍﻥگ
konganda	کﻭگﺍﻥﺩﺍ
konig	کﺍﻥیگ
koning	کﻭﻥیﻥگ
kono	کﻭﻥﻭ
konopka	کﻭﻥﻭپکﺍ
konvinse	کﻥﻭیﻥﺱ
koo	کﻭ
kook	کﻭک
koolen	کﻭﻝﻥ
koontz	کﻭﻥﺕﺯ
koop	کﻭپ
koosis	کﻭﺯیﺱ
koosje	کﻭزی
kopack	کپﺍک
koper	کﻭپﺭ
koperen	کﻭپﺭﻥ
kopp	کﻭپ
kopper	کﻭپر
koppes	کﻭپﺱ
koprulu	کﻭپﺭﻭﻝﻭ
kopulos	کپﻭﻝﻭﺱ
kor	کﻭﺭ
korabell	کﻭرﺍﺏﻝ
korambath	کﻭﺭﺍﻡﺏﺱ
koray	کﻭرﺍی
korcuska	کﺍرکﻭﺱکﺍ
kordes	کﻭﺭﺩﺱ
kordic	کﻭﺭﺩیک
kordt	کﻭرﺕ
korn	کﻭﺭﻥ
kornele	کﻭﺭﻥﻝﻩ
korp	کﻭﺭپ
korsman	کرﺱﻡﻥ
korsten	کﻭﺭﺱﺕﻥ
kortright	کﻭﺭﺕﺭﺍیﺕ
kory	کﻭﺭی
kosenko	کﻭﺱﻥکﻭ
koshy	کﺍﺵی
kosiba	کﻭﺱیﺏﺍ
kosinski	کﺍﺱیﻥﺱکی
koslov	کﻭﺱﻝﻭ
kosmicki	کﺍﺱﻡیچی
koss	کﻭﺱ
kossack	کﻭﺱﺍک
kosta	کﻭﺱﺕﺍ
kostelak	کﺱﺕﻝﺍک
kosten	کﻭﺱﺕﻥ
koster	کﺍﺱﺕﺭ
kostis	کﻭﺱﺕیﺱ
kosuge	کﻭﺱﻭگﻩ
kotara	کﺕﺍﺭﺍ
kotla	کﻭﺕﻝﺍ
kotoski	کﻭﺕﺱکی
kotrozo	کﻭﺕرﻭﺯﻭ
kotte	کﺕی
kottmann	کﺍﺕﻡﻥ
kottmeier	کﻭﺕﻡﺍیﺭ
kou	کﻭ
kouba	کﻭﺏﺍ
koukalik	کﻭکﺍﻝیک
kouki	کﻭکی
kousky	کﻭﺱکی
kovar	کﻭﻭﺍﺭ
kovarski	کﻭﺍﺭﺱکی
koven	کﺍﻭﻥ
kowal	کﻭﺍﻝ
kowald	کﻭﺍﻝﺩ
kowalik	کﻭیﺍﻝیک
kowalski	کﻭیﺍﻝﺱکی
kowitt	کﻭیﺕ
kowsik	کﻭﺱیک
kozo	کﻭﺯﻭ
kraaij	کﺭﺍیﺝ
krab	کﺭﺍﺏ
kragen	کﺭﺍگﻥ
kraig	کﺭﺍیگ
kraken	کرﺍکﻥ
kram	کﺭﺍﻡ
kramer	کرﺍﻡر
krasen	کﺭﺍﺯﻥ
krasic	کﺭﺍﺱیک
krasner	کﺭﺱﻥﺭ
krasnow	کﺭﺱﻥﻭ
krattiger	کﺭﺍﺕیگﺭ
kratzer	کﺭﺍﺕﺯﺭ
kre	کﺭﻩ
krebser	کﺭﺏﺱﺭ
krech	کﺭچ
kreg	کرگ
kreger	کرگر
kregg	کﺭگ
krelis	رﻝیز
krelius	رﻝیﻭز
krenz	کﺭﻥﺯ
kresh	کﺭﺵ
kresna	کﺭﺯﻥﺍ
kreuer	کﺭﻭیﺭ
krey	کﺭی
krezel	کﺭﺯﻝ
krieg	کﺭیگ
krieger	کﺭیگﺭ
kriger	کﺭیگﺭ
kriman	کﺭیﻡﻥ
kris	کﺭیﺱ
krishan	کﺭیﺵﺍﻥ
krisje	ریﺱﺝی
krisoijn	رﺱیﻭیﻥ
kriss	کریﺱ
krissie	کریﺱی
krissy	کﺭیﺱی
krista	کﺭیﺱﺕﺍ
krister	کﺭیﺱﺕﺭ
kristian	کﺭیﺱﺕیﺍﻥ
kristijntje	ریﺱﺕیﻥﺕﺝی
kristin	کﺭیﺱﺕیﻥ
kristina	کﺭیﺱﺕیﻥﺍ
kristine	کﺭیﺱﺕیﻥ
kristler	کﺭیﺱﺕﻝﺭ
kristofer	کریﺱﺕﻭﻑر
kristofor	کریﺱﺕﻭﻑﻭر
kristol	کﺭیﺱﺕﻭﻝ
kriston	کﺭیﺱﺕﻭﻥ
kristopher	کﺭیﺱﺕﻭﻑﺭ
kristyn	کریﺱﺕیﻥ
kriwonos	کﺭیﻭﻭﻥﻭﺯ
krok	کﺭﻭک
krol	کرﻭﻝ
kroll	کرﻭﻝ
kromann	کﺭﻭﻡﻥ
kromer	کﺭﻭﻡﺭ
kronz	کﺭﺍﻥﺯ
kropik	کﺭﻭپیک
kroth	کرﻭﺕﺱ
kroum	کﺭﻭﻡ
krug	کﺭﻭگ
krumm	کﺭﻭﻡ
krupp	کﺭﺍپ
kruschen	رﺍﺱچﻥ
kuan	کﻭﺍﻥ
kuang	کﻭﺍﻥگ
kube	کﺍﺏ
kubo	کﻭﺏﻭ
kucera	کﻭﺱیﺭﺍ
kuchar	کﻭچﺍﺭ
kuchling	کﺍچﻝیﻥگ
kudlacek	کﺍﺩﻝﺍﺱک
kudreikis	کﺍﺩﺭیکیﺱ
kugel	کﻭگﻝ
kuha	کﺍﻩﺍ
kuhlmann	کﺍﻝﻡﻥ
kuiper	کﻭیپﺭ
kukla	کﺍکﻝﺍ
kukulies	کیﻭکیﻭﻝیﺱ
kulbida	کﺍﻝﺏیﺩﺍ
kuldell	کﺍﻝﺩﻝ
kulesh	کﻭﻝﺵ
kullen	کﻭﻝﻥ
kullmann	کﺍﻝﻡﻥ
kulp	کﺍﻝپ
kumar	کیﻭﻡﺭ
kumaran	کﻭﻡﺍﺭﺍﻥ
kumari	کﻭﻡﺍری
kummer	کﺍﻡﺭ
kumoro	کﻭﻡﻭﺭﻭ
kun	کﺍﻥ
kunath	کﺍﻥﺍﺕﺱ
kundu	کﺍﻥﺩﻭ
kung	کﺍﻥگ
kunnen	کﺍﻥﻥ
kunselman	کﺍﻥﺱﻝﻡﻥ
kunst	کﺍﻥﺕ
kuntz	کﻭﻥﺕﺯ
kupec	کﺍپک
kuper	کﻭپﺭ
kuperblum	کپﺭﺏﻝﻭﻡ
kupferman	کﺍپﻑﺭﻡﺍﻥ
kurdzo	کﺍرﺩﺯﻭ
kurien	کﻭﺭیﻥ
kurilla	کﻭﺭیﻝﺍ
kurke	کﺭک
kurki	کرکی
kurktchi	کﺍﺭکچی
kuroki	کﻭرﻭکی
kursun	کﻭﺭﺱﻥ
kurt	کﺍﺭﺕ
kusack	کﺍﺱﺍک
kushay	کﻭﺵﺍی
kushnir	کﺍﺵﻥیﺭ
kusterman	کﻭﺱﺕﺭﻡﻥ
kusumoto	کیﻭﺱﻡﺍﺕﻭ
kutz	کﻭﺕﺯ
kuwayt	کﻭیﺕ
kuyper	کﺍیپﺭ
kwan	کﻭﺍﻥ
kwang	کﻭﺍﻥگ
kwast	کﻭﺍﺱﺕ
kwong	کﻭﺍﻥگ
kyle	کﺍیﻝ
kyrus	کﺍیﺭﺍﺱ
kyte	کﺍیﺕ
laan	ﻝﺍﻥ
laas	ﻝﺍﺱ
labatt	ﻝﺍﺏﺍﺕ
labdon	ﺍﻝﺏﻭﻥ
labella	ﻝﺍﺏﻝﺍ
labelle	ﻝﺍﺏﻝ
laberge	ﻝیﺏﺭگ
labore	ﻝﺏﻭﺭ
labrinidis	ﻝﺏﺭیﻥیﺩیﺱ
labriola	ﻝﺍﺏﺭیﻭﻝﺍ
labroad	ﻝﺍﺏﺭﺍﺩ
lacelle	ﻝﺍکﻝﻩ
lachance	ﻝﺍچﻥﺱ
lachlan	ﻝﺍچﻝﻥ
lachman	ﻝچﻡﻥ
lackey	ﻝﺍکی
lacoste	ﻝکﻭﺱﺕ
lacour	ﻝﺍکﻭیر
lacouture	ﻝﺍکﻭﺕﻭﺭﻩ
lacross	ﻝکﺭﻭﺱ
lacy	ﻝیﺱی
ladasky	ﻝﺍﺩﺍﺱکی
lade	ﻝیﺩ
laderoute	ﻝﺍﺩﺭﻭﺕ
ladeuil	ﻝﺍﺩیﻭیﻝ
ladic	ﻝﺍﺩیک
ladomery	ﻝﺩﻡﺭی
ladonne	ﻝﺍﺩﻭﻥ
ladwig	ﻝﺍﺩﻭیگ
laff	ﻝﺍﻑ
laforce	ﻝﺍﻑﻭرﺱ
lafountaine	ﻝﺍﻑﺍﻭﻥﺕیﻥ
lafourcade	ﻝﺍﻑﻭﺭکﺍﺩ
lagerberg	ﻝﺍﺝﺭﺏﺭگ
lagerling	ﻝﺍگﺭﻝیﻥگ
lagerstrom	ﻝﺍگﺭﺵﺕﺭﻭﻡ
lages	ﻝﺍگﺱ
lagomorph	ﻝﺍگﻭﻡﻭﺭﻭﻑ
lagoon	ﻝﺍگﻭﻥ
lahelma	ﻝﺍﻩﻝﻡﺍ
lahey	ﻝﺍﻩی
lahij	ﻝﺍﻩیﺝ
lai	ﻝﺍی
laiho	ﻝﺍیﻩﻭ
lainchbury	ﻝیﻥچﺏری
laine	ﻝیﻥ
laird	ﻝﺍیﺭﺩ
lais	ﻝیﺱ
laith	ﻝیﺕ
lak	ﻝﺍک
lake	ﻝیک
lakewood	ﻝﺍکﻭﻭﺩ
laking	ﻝیکیﻥگ
laky	ﻝﺍکﺍی
lal	ﻝﺍﻝ
lalit	ﻝﺍﻝیﺕ
lalonde	ﻝیﻝﻥﺩ
laly	ﻝﺍﻝی
lam	ﻝﺍﻡ
lamarck	ﻝﺍﻡﺍﺭک
lamark	ﻝﺍﻡﺍﺭک
lamastus	ﻝﺍﻡﺍﺱﺕﻭﺱ
lambadaris	ﻝﺍﻡﺏﺍﺩﺍﺭیﺱ
lambda	ﻝﺍﻡﺏﺩﺍ
lambert	ﻝﺍﻡﺏﺭﺕ
lamboley	ﻝﺍﻡﺏﻭﻝی
lamborn	ﻝﺍﻡﺏرﻥ
lambourne	ﻝﺍﻡﺏﻭرﻥ
lambrecht	ﻝﺍﻡریچ
lambros	ﻝﺍﻡﺏﺭﻭﺱ
lambton	ﻝﺍﻡﺏﺕﻭﻥ
lamenza	ﻝﺍﻡﻥﺯﺍ
lamers	ﻝﻡﺭﺯ
lamina	ﻝﺍﻡیﻥﺍ
lamm	ﻝﺍﻡ
lammer	ﻝﺍﻡر
lammeren	ﻝﺍﻡرﻥ
lammers	ﻝﺍﻡﺭﺱ
lamonica	ﻝﺍﻡﻭﻥیکﺍ
lamorce	ﻝﺍﻡﻭﺭﺱ
lamp	ﻝﻡپ
lampani	ﻝﺍﻡپﺍﻥی
lampen	ﻝﺍﻡپﻥ
lampi	ﻝﺍﻡپی
lamping	ﻝﻡپیﻥگ
lampitt	ﻝﺍﻡپیﺕ
lamplight	ﻝﺍﻡپﻝﺍیﺕ
lamprey	ﻝﺍﻡپری
lamykin	ﻝﺍﻡیکیﻥ
lan	ﻝﺍﻥ
lana	ﻝﺍﻥﺍ
lance	ﻝﺍﻥﺱ
lancetes	ﻝﺍﻥﺱﺕﺯ
lancing	ﻝﺍﻥﺱیﻥگ
lanctot	ﻝﻥکﺕﺕ
landahl	ﻝﻥﺩﺍﻩﻝ
landauer	ﻝﺍﻥﺩﺍیﺭ
landen	ﻝﺍﻥﺩﻥ
landers	ﻝﺍﻥﺩﺭﺯ
landi	ﻝﻥﺩی
landin	ﻝﺍﻥﺩیﻥ
landing	ﻝﻥﺩیﻥگ
landis	ﻝﺍﻥﺩیﺱ
landman	ﻝﺍﻥﺩﻡﻥ
landmark	ﻝﻥﺩﻡﺍرک
landon	ﻝﺍﻥﺩﻥ
landrum	ﻝﺍﻥﺩﺭﻭﻡ
lands	ﻝﻥﺩﺯ
lanett	ﻝﺍﻥﺕ
lanetta	ﻝﺍﻥﺕﺍ
langdon	ﻝﺍﻥگﺩﻭﻥ
lange	ﻝﺍﻥژ
langford	ﻝﺍﻥگﻑﻭرﺩ
langlands	ﻝﺍﻥگﻝﻥﺩﺯ
langmaid	ﻝﻥگﻡیﺩ
langmead	ﻝﻥگﻡیﺩ
langnes	ﻝﺍﻥگﻥﺯ
langoulant	ﻝﻥگﺍﻭﻝﻥﺕ
langpollen	ﻝﺍﻥگپﻭﻝﻥ
langs	ﻝﺍﻥگﺯ
langseth	ﻝﻥگﺱث
langston	ﻝﺍﻥگﺱﺕﻭﻥ
lani	ﻝﺍﻥی
lanka	ﻝﺍﻥکﺍ
lankshear	ﻝﺍﻥکﺵیر
lankton	ﻝﺍﻥکﺕﻭﻥ
lann	ﻝﺍﻥ
lanner	ﻝﺍﻥﺭ
lannie	ﻝﺍﻥی
lannom	ﻝﺍﻥﻭﻡ
lans	ﻝﺍﻥﺱ
lansford	ﻝﺍﻥﺯﻑﻭرﺩ
lanterman	ﻝﺍﻥﺕﺭﻡﺍﻥ
lantlosamade	ﻝﺍﻥﺕﻝﻭﺱﺍﻡﺍﺩ
lantz	ﻝﺍﻥﺕﺯ
lanusse	ﻝﺍﻥﻭﺱی
lanz	ﻝﺍﻥﺯ
lao	ﻝﺍیﻭ
lapaso	ﻝﺍپﺍﺱﻭ
laplace	ﻝﺍپﻝﺍﺱ
laplaine	ﻝﺍپﻝﺍیﻥ
laporta	ﻝپﻭﺭﺕﺍ
laputa	ﻝﺍپﻭﺕﺍ
lapworth	ﻝپﻭرﺙ
lara	ﻝﺍﺭﺍ
laralee	ﻝﺍﺭﺍﻝی
laraway	ﻝﺍرﺍﻭی
lareef	ﻝﺍﺭیﻑ
larga	ﻝﺍﺭﺝﺍ
large	ﻝﺍﺭژ
largent	ﻝﺍﺭﺝﻥﺕ
largo	ﻝﺍﺭﺝﻭ
larissa	ﻝﺍﺭیﺱﺍ
lariviere	ﻝﺍﺭیﻭیﺭ
larke	ﻝﺍرک
laro	ﻝﺍﺭﻭ
laroche	ﻝﺍﺭﻭچ
larocque	ﻝﺍﺭﻭکﻭیﻩ
larren	ﻝﺍﺭﻥ
larrouy	ﻝﺍﺭﻭی
larry	ﻝﺍﺭی
lars	ﻝﺍﺭﺱ
larson	ﻝﺍﺭﺱﻥ
larter	ﻝﺍﺭﺕﺭ
larue	ﻝﺍﺭﻭ
larurel	ﻝﺍﺭﻭﺭﻝ
las	ﻝﺍﺱ
lascari	ﻝﺍﺱکﺍﺭی
laser	ﻝیﺯﺭ
lash	ﻝﺍﺵ
lasher	ﻝﺵر
lashley	ﻝﺵﻝی
laske	ﻝﺱک
lasker	ﻝﺍﺱکر
laskos	ﻝﺍﺱکﻭﺱ
lasnik	ﻝﺍﺱﻥیک
lasovick	ﻝﺍﺱﻭﻭیک
lasser	ﻝﺍﺱﺭ
last	ﻝﺍﺱﺕ
lastra	ﻝﺍﺱﺕﺭﺍ
lateiner	ﻝﺍﺕیﻥر
lathbury	ﻝﺍﺕﺏری
lau	ﻝی
laudicina	ﻝﺍﺩیﺱیﻥﺍ
laughlin	ﻝﺍﻑﻝیﻥ
laundrie	ﻝﻥﺩﺭی
laura	ﻝﻭﺭﺍ
laurence	ﻝﺍرﻥﺱ
laurent	ﻝﻭﺭﻥﺕ
lauritsen	ﻝﺍیﻭﺭیﺕﺱﻥ
laursen	ﻝﺍﺭﺱﻥ
lautmann	ﻝﺍیﻭﺕﻡﻥ
laux	ﻝﺍﻭکﺱ
lauzac	ﻝﺍﻭﺯﺍک
lauzon	ﻝﺍﻭﺯﻥ
lavalie	ﻝﻭﺍﻝﺍی
lavey	ﻝﺍﻭی
lavictoire	ﻝﺍﻭیکﺕﻭیر
lavigne	ﻝﺍﻭیگﻥﻩ
lavonius	ﻝﺍﻭﻥیﻭﺱ
law	ﻝﺍﻭ
lawal	ﻝﺍﻭﺍﻝ
lawler	ﻝﺍﻭﻝر
lawless	ﻝﺍﻝﺱ
lawlor	ﻝﺍیﻭﻝﻭﺭ
lawrance	ﻝﺍﺭﻥﺱ
lawrie	ﻝﺍﻭﺭﺍی
laws	ﻝﺍﻭﺯ
lawson	ﻝﺍﻭﺱﻥ
lawton	ﻝﺍﻭﺕﻥ
lax	ﻝکﺱ
laxminarayan	ﻝﺍکﺱﻡیﻥﺍﺭﺍیﺍﻥ
layer	ﻝیﺭ
layl	ﻝیﻝ
lazar	ﻝیﺯﺭ
lazara	ﻝﺍﺯﺍﺭﺍ
lazard	ﻝﺍﺯﺍﺭﺩ
lazzaro	ﻝﺍﺯﺍﺭﻭ
lea	ﻝی
leach	ﻝیچ
leahy	ﻝیﻩی
leair	ﻝیﺭ
leake	ﻝیک
leamy	ﻝیﻡی
lear	ﻝیﺭ
leary	ﻝیﺭی
leas	ﻝیﺱ
leason	ﻝیﺱﻥ
leatherock	ﻝیﺩﺭﺍک
lebed	ﻝیﺏیﺩ
lebedev	ﻝﺏﺩیﻭ
lebel	ﻝیﺏﻝ
leben	ﻝﺏﻥ
leblanc	ﻝیﺏﻝﺍﻥﺱ
lebon	ﻝﺏﻭﻥ
lebourgeois	ﻝﺏﻭﺭگیﻭیﺱ
lechelle	ﻝچﻝﻩ
lechmere	ﻝچﻡر
lechner	ﻝچﻥﺭ
leckie	ﻝکی
lecomber	ﻝکﺍﻡﺏﺭ
lecren	ﻝکﺭﻥ
lection	ﻝکﺵﻥ
ledbury	ﻝﺩﺏﺭی
ledford	ﻝﺩﻑﻭﺭﺩ
ledge	ﻝﺝ
ledger	ﻝﺝﺭ
ledney	ﻝﺩﻥی
ledoux	ﻝﺩﻭکﺱ
ledwidge	ﻝﺩﻭﺍیﺩﺝ
lee	ﻝی
leeds	ﻝیﺩﺯ
leelynde	ﻝیﻝیﻥﺩ
leeper	ﻝیپر
leeuw	ﻝیﻭ
lefaive	ﻝیﻑﺍیﻭ
leff	ﻝﻑ
leffler	ﻝﻑﻝﺭ
leg	ﻝگ
legeros	ﻝﺝﺭﻭﺱ
legg	ﻝگ
lehan	ﻝﻩﺍﻥ
lehle	ﻝﻩﻝﻩ
lehman	ﻝﻩﻡﺍﻥ
lehmann	ﻝﻩﻡﺍﻥ
lehnerer	ﻝﻩﻥﺭﺭ
lehnert	ﻝﻥﺭﺕ
lehrer	ﻝﻩرر
lehto	ﻝﺕﻭ
lei	ﻝی
leibow	ﻝیﺏﺍﻭ
leibowitz	ﻝیﺏﻭیﺕﺯ
leila	ﻝیﻝﺍ
leinonen	ﻝیﻥﻭﻥﻥ
leisher	ﻝیﺵﺭ
leite	ﻝیﺕﻩ
leitner	ﻝیﺕﻥر
lemaire	ﻝﻡﺍیﺭ
lemarie	ﻝﻡﺍری
lemek	ﻝﻡک
lemer	ﻝﻡیﺭ
lemke	ﻝیﻡک
lemmon	ﻝﻡﻭﻥ
lemon	ﻝﻡﻭﻥ
lemos	ﻝﻡﻭﺯ
lendino	ﻝﻥﺩیﻥﻭ
lendl	ﻝیﻥﺩﻝ
lendvai	ﻝﻥﺩﻭﺍی
lengeling	ﻝﻥگﻝیﻥگ
lenkei	ﻝﻥکی
lennon	ﻝیﻥﺍﻥ
lennox	ﻝﻥکﺱ
lentin	ﻝﻥﺕیﻥ
leo	ﻝیﻭ
leon	ﻝیﻭﻥ
leonard	ﻝیﻭﻥﺍﺭﺩ
leonardo	ﻝیﻭﻥﺍﺭﺩﻭ
leonberger	ﻝیﻭﻥﺏﺭگﺭ
leonhard	ﻝیﻭﻥﻩﺍرﺩ
leonora	ﻝیﻥﻭرﺍ
leopard	ﻝیﻭپﺍﺭﺩ
leous	ﻝیﻭﺱ
lepage	ﻝیپیﺝ
lepard	ﻝپﺍﺭﺩ
leppart	ﻝپﺍﺭﺕ
leppla	ﻝپﻝﺍ
lerbs	ﻝﺭﺏﺯ
lerman	ﻝﺭﻡﻥ
leroux	ﻝیﺭﺍکﺱ
leroy	ﻝیﻭری
lerup	ﻝﺭﺍپ
lesesne	ﻝیﺱیﻥ
lesher	ﻝﺵﺭ
lesht	ﻝﺵﺕ
lesiak	ﻝﺱیﺍک
lesion	ﻝیﺯﻥ
lessard	ﻝﺱﺍﺭﺩ
lesser	ﻝﺱﺭ
lester	ﻝیﺱﺕﺭ
letje	ﻝژﻩ
leung	ﻝییﻭﻥگ
levavy	ﻝیﻭیﻭی
levesque	ﻝﻭﺱکیﻭ
levey	ﻝﻭی
levi	ﻝﻭی
levine	ﻝیﻭیﻥ
levinson	ﻝﻭیﻥﺱﻭﻥ
leviseur	ﻝﻭیﺱیﻭﺭ
levy	ﻝیﻭی
lewendon	ﻝیﻭﺍﻥﺩﻥ
lewin	ﻝﻭیﻥ
lewis	ﻝیﻭیﺱ
lexier	ﻝکﺱیﺭ
ley	ﻝی
leybourne	ﻝیﺏﻭﺭﻥ
leyden	ﻝیﺩﻥ
leyton	ﻝیﺕﻭﻥ
lezberg	ﻝﺯﺏرگ
liam	ﻝیﺍﻡ
lian	ﻝﺍیﺍﻥ
lianez	ﻝیﺍﻥﺯ
liao	ﻝیﺍﻭ
libannord	ﻝیﺏﺍﻥﻥرﺩ
libansud	ﻝیﺏﺍﻥﺱﻭﺩ
libberton	ﻝیﺏﺭﺕﻭﻥ
libbey	ﻝیﺏی
liberatore	ﻝیﺏرﺍﺕﻭر
liberchuk	ﻝیﺏﺭچﺍک
liberman	ﻝیﺏﺭﻡﻥ
libert	ﻝیﺏرﺕ
liberty	ﻝیﺏﺭﺕی
liblanc	ﻝیﺏﻝﺍﻥک
liblit	ﻝیﺏﻝیﺕ
librande	ﻝیﺏﺭﺍﻥﺩﻩ
librik	ﻝیﺏﺭیک
licharson	ﻝیچﺍﺭﺱﻭﻥ
lichorowic	ﻝیچﻭﺭﻭییﺱ
lichten	ﻝیچﺕﻥ
lidal	ﻝیﺩﺍﻝ
lidor	ﻝیﺩﻭﺭ
lidwina	ﻝیﺩﻭیﻥﺍ
lidz	ﻝیﺩﺯ
lie	ﻝی
liebler	ﻝیﺏﻝر
liebman	ﻝیﺏﻡﻥ
liebson	ﻝیﺏﺱﻥ
lien	ﻝیﻥ
lier	ﻝیﺭ
liese	ﻝییﺱ
liew	ﻝیﻭ
liewe	ﻝیﻭ
liggio	ﻝیگیﻭ
lightburn	ﻝﺍیﺕﺏﺭﻥ
lightman	ﻝﺍیﺕﻡﻥ
lighton	ﻝیگﺕﻥ
ligne	ﻝﺍیﻥ
likes	ﻝﺍیکﺯ
liko	ﻝیکﻭ
lila	ﻝیﻝﺍ
lilback	ﻝیﻝﺏک
lilienthal	ﻝیﻝیﻥﺕﺍﻝ
lilja	ﻝیﻝﺝﺍ
lillard	ﻝیﻝﺍﺭﺩ
lilley	ﻝیﻝی
lilli	ﻝیﻝی
lim	ﻝیﻡ
limary	ﻝیﻡﺍﺭی
limburg	ﻝیﻡﺏﻭﺭگ
liming	ﻝیﻡیﻥگ
lin	ﻝیﻥ
linares	ﻝیﻥﺍﺭﺱ
lincoln	ﻝیﻥکﻝﻥ
lind	ﻝیﻥﺩ
lindal	ﻝیﻥﺩﺍﻝ
lindback	ﻝیﻥﺩﺏک
lindberg	ﻝیﻥﺩﺏﺭگ
linde	ﻝیﻥﺩ
lindemann	ﻝیﻥﺩﻡﻥ
linden	ﻝیﻥﺩﻥ
lindenmuth	ﻝیﻥﺩﻥﻡﻭﺕ
linder	ﻝیﻥﺩﺭ
lindgard	ﻝیﻥﺩگﺍﺭﺩ
lindgren	ﻝیﻥﺩگﺭﻥ
lindholm	ﻝیﻥﺩﻩﻝﻡ
lindley	ﻝیﻥﺩﻝی
lindman	ﻝیﻥﺩﻡﻥ
lindner	ﻝیﻥﺩﻥر
lindroth	ﻝیﻥﺩﺭﻭﺕﺱ
lindstrom	ﻝیﻥﺩﺱﺕرﻭﻡ
lindvall	ﻝیﻥﻭﺍﻝ
linfield	ﻝیﻥﻑیﻝﺩ
lingley	ﻝیﻥگﻝی
lingus	ﻝیﻥگﺍﺱ
linimon	ﻝیﻥیﻡﻭﻥ
link	ﻝیﻥک
linkous	ﻝیﻥکﻭیﺱ
linstruth	ﻝیﻥﺱﺕﺭﺍﺕ
linton	ﻝیﻥﺕﻭﻥ
lintz	ﻝیﻥﺕﺯ
linwood	ﻝیﻥﻭﻭﺩ
lion	ﻝیﻭﻥ
lionel	ﻝیﻭﻥﻝ
lions	ﻝیﻭﻥﺯ
liow	ﻝیﻭ
lippard	ﻝیپﺍﺭﺩ
lippert	ﻝیپرﺕ
lippolt	ﻝیپﻭﻝﺕ
lipscombe	ﻝیپﺱکﺍﻡﺏ
lipset	ﻝیپﺱﺕ
lipton	ﻝیپﺕﻭﻥ
liquori	ﻝیکیﻭﺭی
lisa	ﻝیﺯﺍ
liscano	ﻝیﺱکﺍﻥﻭ
lisken	ﻝیﺱکﻥ
liskey	ﻝیﺱکی
lison	ﻝیﺱﻭﻥ
liss	ﻝیﺱ
lissa	ﻝیﺯﺍ
lissine	ﻝیﺱیﻥ
lisson	ﻝیﺱﻭﻥ
list	ﻝیﺱﺕ
liston	ﻝیﺱﺕﻭﻥ
litchfield	ﻝیچﻑیﻝﺩ
litel	ﻝیﺕﻝ
litt	ﻝیﺕ
little	ﻝیﺕﺕﻝ
littleton	ﻝیﺕﻝﺕﻭﻥ
littmann	ﻝیﺕﻡﻥ
littrell	ﻝیﺕﺭﻝ
litvin	ﻝیﺕﻭیﻥ
liu	ﻝیﻭ
lively	ﻝﺍیﻭﻝی
livengood	ﻝیﻭﻥگﻭﺩ
livesay	ﻝﺍیﻭﺱﺍی
liviu	ﻝیﻭیﻭ
livius	ﻝیﻭیﻭﺱ
liz	ﻝیﺯ
lizards	ﻝیﺯﺍﺭﺩﺯ
loader	ﻝﻭﺩر
loarie	ﻝﻭﺭی
loats	ﻝﻭﺍﺕﺱ
loay	ﻝﻭی
lobb	ﻝﺍﺏ
lober	ﻝﺍﺏر
lobo	ﻝﻭﺏﻭ
lobser	ﻝﺍﺏﺱﺭ
loc	ﻝﺍک
lock	ﻝﺍک
lockard	ﻝﻭکﺍﺭﺩ
lockenour	ﻝﺍکﻥﻭر
locker	ﻝﺍکﺭ
lockhart	ﻝﺍکﻩﺍﺭﺕ
lockington	ﻝﺍکیﻥگﺕﻭﻥ
lockley	ﻝﺍکﻝی
lockney	ﻝﻭکﻥی
lockshin	ﻝﺍکﺵیﻥ
lockstone	ﻝﺍکﺱﺕﻭﻥ
loco	ﻝﻭکﻭ
lodder	ﻝﺍﺩﺭ
lodge	ﻝﺍﺝ
lodi	ﻝﻭﺩی
lodman	ﻝﻭﺩﻡﻥ
lofaro	ﻝﻭﻑﺍﺭﻭ
lofaso	ﻝﻭﻑﺍﺱﻭ
lofdahl	ﻝﻭﻑﺩﺍﻩﻝ
lofgren	ﻝﺍﻑگﺭیﻥ
lofstrom	ﻝﻭﻑﺱﺕﺭﻭﻡ
loftus	ﻝﻑﺕﻭﺱ
logajan	ﻝﻭگیﺝﺍﻥ
logan	ﻝﻭگﺍﻥ
logendra	ﻝﻭگﻥﺩﺭﺍ
loges	ﻝﻭگﺯ
logic	ﻝﻭﺝیک
logie	ﻝﻭﺝی
loh	ﻝﻭﻩ
lohrentz	ﻝﻩﺭﻥﺕﺯ
loibl	ﻝﻭیﺏﻝ
lois	ﻝﻭیﺯ
loiselle	ﻝﻭییﺱﺍﻝی
loizzo	ﻝﻭییﺯﻭ
lok	ﻝﻭک
loke	ﻝﻭک
loken	ﻝﻭکﻥ
lomas	ﻝﻭﻡﺍﺱ
lomax	ﻝﻭﻡکﺱ
lommel	ﻝﻭﻡﻝ
lon	ﻝﺍﻥ
lonardo	ﻝﻭﻥﺍﺭﺩﻭ
londre	ﻝﺍﻥﺩﺭ
lones	ﻝﻭﻥﺯ
loney	ﻝﻭﻥی
long	ﻝﺍﻥگ
longshaw	ﻝﺍﻥگﺵﺍ
longstaff	ﻝﺍﻥکﺱﺕﺍﻑ
longyear	ﻝﺍﻥگیﺭ
lonkart	ﻝﺍﻥکﺍﺭﺕ
lonn	ﻝﻭﻥ
lonnemo	ﻝﻭﻥﻡﻭ
lonngren	ﻝﺍﻥگﺭﻥ
lonningdal	ﻝﻭﻥیﻥگﺩﺍﻝ
lonon	ﻝﻭﻥﺍﻥ
lonsdale	ﻝﺍﻥﺱﺩیﻝ
loo	ﻝﻭ
loofburrow	ﻝﻭﻑﺏﺍﺭﻭ
look	ﻝﻭک
loomes	ﻝﻭﻡﺯ
loon	ﻝﻭﻥ
looney	ﻝﻭﻥی
loop	ﻝﻭپ
loose	ﻝﻭﺯ
lopez	ﻝﻭپﺯ
lopp	ﻝﺍپ
lopresti	ﻝﻭپﺭﺱﺕی
lora	ﻝﻭﺭﺍ
lorch	ﻝﻭﺭچ
lord	ﻝﺭﺩ
loreena	ﻝﻭﺭﻥﺍ
loren	ﻝﻭﺭﻥ
lorentzen	ﻝﻭﺭﻥﺕﺯﻥ
lorenz	ﻝﻭﺭﻥﺯ
lorenzen	ﻝﻭﺭﻥﺯﻥ
lorenzi	ﻝﻭﺭﻥﺯی
loreti	ﻝﻭﺭﺕی
loretta	ﻝﻭرﺕﺍ
lorgio	ﻝﻭﺭﺝیﻭ
lori	ﻝﻭﺭی
lorteye	ﻝﻭﺭﺕیﻩ
lory	ﻝﻭﺭی
los	ﻝﻭﺱ
losantos	ﻝﻭﺱﺍﻥﺕﻭﺱ
losecco	ﻝﻭﺱﺱکﻭ
loser	ﻝﻭﺱﺭ
losinger	ﻝﺍﺱیﻥگﺭ
losito	ﻝﻭﺱیﺕﻭ
loss	ﻝﺍﺱ
losset	ﻝﻭﺱﺕ
lotempio	ﻝﻭﺕﻡپیﻭ
lotridge	ﻝﺕﺭیﺝ
lott	ﻝﺍﺕ
louboutin	ﻝﻭﺏﻭﺕیﻥ
loud	ﻝﺍﻭﺩ
loughe	ﻝﻭگﻩ
louie	ﻝﻭیی
lounsbery	ﻝیﻭﻥﺱﺏﺭی
loures	ﺍﻭرﺱ
louvau	ﻝﻭﺍﻭ
louvet	ﻝﻭﻭﺕ
louw	ﻝﺍﻭﻭ
loveman	ﻝﺍﻭﻡﻥ
lover	ﻝﺍﻭر
lovera	ﻝﻭﻭﺭﺍ
lovette	ﻝﺍﻭﺕی
lovitt	ﻝﺍﻭیﺕ
lovstad	ﻝﺍﻭﺱﺕﺍﺩ
low	ﻝﻭ
lowery	ﻝﻭیری
lowman	ﻝﻭﻡﻥ
lowry	ﻝﺍﻭﺭی
loyd	ﻝﻭیﺩ
lozano	ﻝﻭﺯﺍﻥﻭ
lozier	ﻝﻭﺯیﺭ
lubin	ﻝﺍﺏیﻥ
lubkin	ﻝﺍﺏکیﻥ
lucas	ﻝﻭکﺍﺱ
luce	ﻝﺍک
lucero	ﻝﻭﺱﺭﻭ
luchini	ﻝﺍچیﻥی
luchok	ﻝﺍکﻭک
lucie	ﻝﻭﺱی
lucy	ﻝﺍکی
ludorf	ﻝﻭﺩﻭﺭﻑ
ludovica	ﻝﺍﺩﻭﻭیکﺍ
ludovicus	ﺍیﺩﻭﺍیﺱﻭز
lugosi	ﻝﺍگﻭﺱی
luigi	ﻝﻭیﺝی
luinge	ﻝﻭییﻥگ
luk	ﻝﻭک
luke	ﻝﻭک
lukens	ﻝﻭکﻥﺯ
lukes	ﻝﻭکﺱ
lulkin	ﻝﺍﻝکیﻥ
lum	ﻝﻭﻡ
lumbley	ﻝﺍﻡﺏﻝی
lumley	ﻝﺍﻡﻝی
lunau	ﻝﻭﻥﺍﻭ
lund	ﻝﺍﻥﺩ
lundager	ﻝﺍﻥﺩﺍگﺭ
lundberg	ﻝﺍﻥﺩﺏﺭگ
lundeen	ﻝﺍﻥﺩیﻥ
lundell	ﻝﺍﻥﺩﻝ
lundquist	ﻝﺍﻥﺩکﻭییﺱﺕ
lundstrom	ﻝﺍﻥﺩﺍﺱﺕﺭﻭﻡ
lung	ﻝﺍﻥگ
lungu	ﻝﺍﻥگﻭ
lunsford	ﻝﺍﻥﺱﻑﺭﺩ
luntz	ﻝﺍﻥﺕﺯ
lunz	ﻝﻭﻥﺯ
lupatkin	ﻝﻭپﺍﺕکیﻥ
luper	ﻝﻭپﺭ
lupher	ﻝﻭﻑﺭ
lupien	ﻝﻭپیﻥ
luppescu	ﻝﺍپیﺱکﻭ
lurie	ﻝﻭﺭی
lursinsap	ﻝﻭﺭﺱیﻥﺱﺍپ
luscombe	ﻝﻭﺱکﻡﺏ
lusk	ﻝﺍﺱک
luskin	ﻝﺍﺱکیﻥ
lusky	ﻝﺍﺱکی
luster	ﻝﺍﺱﺕﺭ
lustig	ﻝﺍﺱﺕیﻥگ
lustri	ﻝﺍﺱﺕﺭی
lusty	ﻝﻭﺱﺕی
lutins	ﻝﻭﺕیﻥﺯ
lutkins	ﻝﺍﺕکیﻥﺯ
luttbeg	ﻝﻭﺕﺏگ
lutz	ﻝﺍﺕﺯ
luxton	ﻝﻭکﺱﺕﻭﻥ
lydea	ﻝیﺩیﺍ
lyell	ﻝییﻝ
lyford	ﻝیﻑرﺩ
lyle	ﻝﺍیﻝ
lyman	ﻝیﻡﻥ
lymn	ﻝیﻡﻥ
lyn	ﻝیﻥ
lynda	ﻝیﻥﺩﺍ
lyndel	ﻝیﻥﺩﻝ
lyndon	ﻝیﻥﺩﺍﻥ
lynds	ﻝیﻥﺩﺯ
lynker	ﻝیﻥکر
lynne	ﻝیﻥ
lyon	ﻝیﻭﻥ
lyrical	ﻝیﺭیکﺍﻝ
lytle	ﻝیﺕﻝی
lyubovny	ﻝیﻭﺏﻭﻥی
mabanag	ﻡﺍﺏﺍﻥﺍگ
mac	ﻡک
macauley	ﻡﺍکﺍیﻭﻝی
macdonald	ﻡکﺩﻭﻝﻥﺩ
macek	ﻡﺍکک
macfarlane	ﻡکﻑﺍﺭﻝیﻥ
macgowan	ﻡکگﻭﻭﺍﻥ
mach	ﻡﺍخ
machine	ﻡﺍﺵیﻥ
machler	ﻡﺍچﻝر
machteld	ﻡچﺕﻝﺩ
maciek	ﻡﺍﺱیک
macinnes	ﻡکیﻥﺯ
mack	ﻡک
macken	ﻡکﻥ
mackerras	ﻡﺍکیﺭﺍﺱ
mackey	ﻡکی
mackinnon	ﻡﺍکیﻥﻭﻥ
macko	ﻡﺍکﻭ
macky	ﻡکی
maclachlan	ﻡیکﻝﺍچﻝﻥ
maclaren	ﻡکﻝﺍﺭﻥ
maclaughlin	ﻡکﻝﺍگﻝیﻥ
maclennan	ﻡکﻝیﻥﺍﻥ
macmillan	ﻡکﻡیﻝﺍﻥ
macneil	ﻡکﻥیﻝ
macomber	ﻡﺍکﻭﻡﺏﺭ
maconochie	ﻡﺍکﻭﻥﻭچی
macra	ﻡکﺭﺍ
macrae	ﻡکﺭﺍی
macready	ﻡکﺭﺩی
macris	ﻡکﺭیﺱ
macrone	ﻡکﺭﻭﻥ
mactavish	ﻡکﺕﺍﻭیﺵ
macvoy	ﻡکﻭی
madaba	ﻡﺍﺩﺍﺏﺍ
madah	ﻡﺩﻩ
madden	ﻡﺍﺩﻥ
maddi	ﻡﺍﺩی
maddineni	ﻡﺩیﻥﻥی
maddison	ﻡﺩیﺱﻭﻥ
maddux	ﻡﺍﺩﺍکﺱ
madeleine	ﻡﺍﺩﻝیﻥ
madeline	ﻡﺍﺩﻝیﻥ
madelyn	ﻡﺍﺩﻝیﻥ
madeo	ﻡﺍﺩیﻭ
mader	ﻡیﺩﺭ
maderer	ﻡﺩﺭﺭ
madigan	ﻡﺍﺩیگﺍﻥ
madinah	ﻡﺩیﻥﺍ
madinat	ﻡﺩیﻥﺕ
madog	ﻡﺩﻭگ
madon	ﻡﺍﺩﻭﻥ
madrone	ﻡﺍﺩﺭﻭﻥ
mads	ﻡﺩﺱ
madsen	ﻡﺍﺩﺱﻥ
mafraq	ﻡﻑرک
magagna	ﻡﺍگﺍگﻥﺍ
magda	ﻡگﺩﺍ
magdalen	ﻡکﺩﺍﻝﻥ
magee	ﻡگی
mager	ﻡیگﺭ
magesh	ﻡگیﺵ
maggard	ﻡﺍگﺍﺭﺩ
maggi	ﻡگی
maggie	ﻡگی
maggio	ﻡگیﻭ
maggs	ﻡﺍگﺱ
magic	ﻡژیک
magical	ﻡﺝیکﺍﻝ
magid	ﻡﺝیﺩ
magill	ﻡﺍگیﻝ
maginel	ﻡگیﻥﻝ
magliacane	ﻡﺍگﻝیﺍکﺍﻥی
magliaro	ﻡﺍگﻝیﺭﻭ
maglott	ﻡگﻝﺍﺕ
magnan	ﻡگﻥﺍﻥ
magne	ﻡگﻥی
magnus	ﻡگﻥﻭﺱ
magnuson	ﻡگﻥﺍﺱﻥ
magnusson	ﻡﺍگﻥﻭﺱﻭﻥ
magruder	ﻡﺍگﺭﻭﺩﺭ
maguire	ﻡﺍگﻭیﺭ
mah	ﻡﻩ
maha	ﻡﺍﻩﺍ
mahadevan	ﻡﺍﻩﺍﺩﻭﺍﻥ
mahajan	ﻡﺍﻩﺍﺝﺍﻥ
mahala	ﻡﺍﻩﺍﻝﺍ
mahaly	ﻡﺍﻩﺍﻝی
mahault	ﻡﺍﻩﺍﻝﺕ
mahowald	ﻡﻩﻭﻭﺍﻝﺩ
mahrah	ﻡﺡرﺍﻩ
mahwit	ﻡﺡﻭیط
mai	ﻡی
maier	ﻡیﺭ
maiko	ﻡیکﻭ
mailhot	ﻡیﻝﻩﺍﺕ
maimone	ﻡﺍیﻡﻭﻥ
main	ﻡیﻥ
mainard	ﻡیﻥرﺍﺩ
maine	ﻡیﻥ
mains	ﻡیﻥﺯ
mainwaring	ﻡیﻥﻭﺍﺭیﻥگ
maison	ﻡیﺯﻭﻥ
maitawa	ﻡیﺕﺍﻭﺍ
maj	ﻡﺝ
majed	ﻡﺝﺩ
majee	ﻡﺍﺝی
majere	ﻡیﺝﺭی
majid	ﻡﺝیﺩ
majoe	ﻡﺍﺝﻭ
major	ﻡیﺝﺭ
majorie	ﻡﺝﻭری
mak	ﻡک
makil	ﻡکیﻝ
makuch	ﻡکﻭچ
malamood	ﻡﺍﻝﺍﻡﻭﺩ
malan	ﻡﺍﻝﺍﻥ
malat	ﻡﺍﻝﺍﺕ
malay	ﻡﻝی
malberg	ﻡﺍﻝﺏﺭگ
malcolm	ﻡﺍﻝکﻭﻡ
malde	ﻡﺍﻝﺩ
maldonado	ﻡﺍﻝﺩﻥﺍﺩﻭ
malemud	ﻡیﻝﻡﻭﺩ
malerich	ﻡﺍﻝﺭیخ
malibu	ﻡﻝیﺏﻭ
malik	ﻡﺍﻝک
malinee	ﻡﻝیﻥیی
mallchok	ﻡﺍﻝکﻭک
mallett	ﻡﺍﻝﺕ
malloy	ﻡﺍﻝﻭی
malnar	ﻡﺍﻝﻥﺭ
malone	ﻡﺍﻝﻥ
maloney	ﻡﺍﻝﻭﻥی
malpartida	ﻡﺍپﺍﺭﺕیﺩﺍ
malte	ﻡﻝﺕﻩ
maltin	ﻡﺍﻝﺕیﻥ
malur	ﻡﻝﻭﺭ
mama	ﻡﺍﻡﺍ
mame	ﻡﻡﻩ
mamelon	ﻡﻡﻝﻭﻥ
mammen	ﻡﺍﻡﻥ
mamott	ﻡﺍﻡﻭﺕ
mamta	ﻡﻡﺕﺍ
man	ﻡﺍﻥ
mana	ﻡﺍﻥﺍ
manager	ﻡﻥیﺝﺭ
manama	ﻡﺍﻥﺍﻡﺍ
manber	ﻡﺍﻥﺏﺭ
manca	ﻡﺍﻥکﺍ
mancini	ﻡﺍﻥﺱیﻥی
mancus	ﻡﺍﻥکﻭﺱ
mancuso	ﻡﻥکیﻭﺱ
manda	ﻡﺍﻥﺩﺍ
mandal	ﻡﺍﻥﺩﺍﻝ
mandar	ﻡﺍﻥﺩﺭ
mandel	ﻡﺍﻥﺩﻝ
mandible	ﻡﻥﺩیﺏﻝ
mandl	ﻡﻥﺩﻝ
mandle	ﻡﻥﺩﻝ
mandy	ﻡﻥﺩی
mane	ﻡﻥﻩ
manetta	ﻡﺍﻥﺕﺍ
manfred	ﻡﻥﻑرﺩ
manfredo	ﻡﻥﻑرﺩﻭ
manfull	ﻡﻥﻑﻭﻝ
mang	ﻡﻥگ
mangan	ﻡﺍﻥگﺍﻥ
mangano	ﻡﺍﻥگﺍﻥﻭ
mangin	ﻡﺍﻥگیﻥ
mangione	ﻡﻥﺝیﻭﻥ
manglani	ﻡﺍﻥگﻝﺍﻥی
mangus	ﻡﻥگﺱ
mani	ﻡﺍﻥی
manija	ﻡﺍﻥیﺝﺍ
manin	ﻡﻥیﻥ
manish	ﻡﺍﻥیﺵ
maniskas	ﻡﺍﻥیﺱکﺍﺱ
manith	ﻡﺍﻥیﺕ
manjeet	ﻡﺍﻥﺝیﺕ
manjit	ﻡﺍﻥﺝیﺕ
manley	ﻡﺍﻥﻝی
manly	ﻡﻥﻝی
mann	ﻡﺍﻥ
manna	ﻡﺍﻥﺍ
mannath	ﻡﺍﻥﺍﺕ
manning	ﻡﺍﻥیﻥگ
manno	ﻡﺍﻥﻭ
manns	ﻡﺍﻥﺯ
manny	ﻡﻥی
mano	ﻡﺍﻥﻭ
manoel	ﻡﺍﻥﻭیﻝ
manoj	ﻡﻥﻭﺝ
manoli	ﻡﺍﻥﻭﻝی
manolo	ﻡﺍﻥﻭﻝی
manosa	ﻡﻥﻭﺱﺍ
manoury	ﻡﺍﻥﻭﺭی
mansig	ﻡﻥﺱیگ
manson	ﻡﺍﻥﺱﻥ
mansoor	ﻡﻥصﻭﺭ
mansour	ﻡﻥصﻭﺭ
mansur	ﻡﻥصﻭﺭ
mansuri	ﻡﻥصﻭﺭی
mantell	ﻡﺍﻥﺕﻝ
mantey	ﻡﺍﻥﺕی
manti	ﻡﻥﺕی
mantick	ﻡﺍﻥﺕیک
mantle	ﻡﺍﻥﺕﻝ
mantor	ﻡﺍﻥﺕﻭﺭ
manu	ﻡﺍﻥیﻭ
manuel	ﻡﺍﻥﻭیﻝ
many	ﻡﻥی
maohai	ﻡﺍیﻭﻩﺍی
maple	ﻡپﻝ
maples	ﻡﺍپﻝﺯ
mapple	ﻡپﻝ
maqbara	ﻡﻕﺏرﻩ
maqsood	ﻡﻕصﻭﺩ
mar	ﻡﺍﺭ
maranda	ﻡﺭﻥﺩﺍ
marani	ﻡﺍﺭﺍﻥی
marasco	ﻡﺍﺭﺍﺱکﻭ
marat	ﻡﺍﺭﺍﺕ
maraud	ﻡﺍﺭﻭﺩ
marazas	ﻡﺍﺭﺍﺯﺍﺱ
marbach	ﻡﺍﺭﺏﺍچ
marble	ﻡﺍﺭﺏﻝ
marc	ﻡﺍﺭک
marcel	ﻡﺍﺭﺱﻝ
marcela	ﻡﺍﺭﺱﻝﺍ
marcelino	ﻡﺍﺭﺱﻝیﻥﻭ
march	ﻡﺍﺭچ
marchington	ﻡﺍﺭکیﻥگﺕﻭﻥ
marchiondo	ﻡﺍﺭچیﻥﺩﻭ
marcopoli	ﻡﺍﺭکﻭپﻭﻝی
marcos	ﻡﺍﺭکﻭﺱ
marcum	ﻡﺍﺭکﻭﻡ
marcy	ﻡﺍﺭﺱی
mardahl	ﻡﺍرﺩﺍﻝ
marder	ﻡﺍﺭﺩﺭ
marek	ﻡﺍﺭک
mares	ﻡﺍﺭﺱ
margarietie	ﻡﺍرگریﺕیﻩ
marget	ﻡﺍرگﺕ
margolin	ﻡﺍﺭگﻝیﻥ
margolis	ﻡﺍﺭگﻭﻝیﺱ
margoshes	ﻡﺍرگﻭﺵﻥ
margretha	ﻡﺍرگریﺕﺍ
margrietje	ﻡﺍرگریﺕ
margulieux	ﻡﺍﺭگﻭﻝیﻭکﺱ
maria	ﻡﺍﺭیﺍ
mariani	ﻡﺍﺭییﺍﻥی
mariano	ﻡﺍﺭیﺍﻥﺍ
marib	ﻡریﺏ
maricondo	ﻡﺍﺭیکﺍﻥﺩﻭ
marie	ﻡﺍری
marijken	ﻡﺍریکﻥ
marimuthu	ﻡﺍریﻡﻭﺕﻭ
marinelli	ﻡﺭیﻥﻝی
marino	ﻡﺍﺭیﻥﻭ
mario	ﻡﺍﺭیﻭ
maritje	ﻡﺍریﺕ
marius	ﻡﺍﺭیﻭﺱ
mark	ﻡﺍﺭک
markey	ﻡﺍﺭکی
markfield	ﻡﺍرکﻑیﻝﺩ
markham	ﻡﺍرکﻩﺍﻡ
markiel	ﻡﺍﺭکیﻝ
markle	ﻡﺍرکﻝ
markley	ﻡﺍﺭکﻝی
marko	ﻡﺍﺭکﻭ
markowitz	ﻡﺍﺭکﻭﺯ
markus	ﻡﺍﺭکﻭﺱ
marla	ﻡﺍﺭﻝﺍ
marlatt	ﻡﺍﺭﻝﺍﺕ
marley	ﻡﺍﺭﻝی
marlin	ﻡﺍﺭﻝیﻥ
marocchi	ﻡﺍﺭﻭچی
maroney	ﻡﺍﺭﻭﻥی
marple	ﻡﺍﺭپﻝ
marples	ﻡﺍرپﻝﺱ
marquette	ﻡﺍﺭکﻭیﺕ
marra	ﻡﺍرﺍ
marregante	ﻡﺍرگﺍﻥﺕ
marrett	ﻡﺍﺭﺕ
marris	ﻡﺍریﺱ
marritje	ﻡریﺝ
marrone	ﻡﺍﺭﻭﻥ
marrow	ﻡرﻭ
marrs	ﻡﺍﺭﺱ
mars	ﻡﺍرﺱ
marsh	ﻡﺍﺭﺵ
marshall	ﻡﺍرﺵﺍﻝ
marston	ﻡﺍﺭﺱﺕﻭﻥ
martel	ﻡﺍرﺕﻝ
martell	ﻡﺍﺭﺕﻝ
marten	ﻡﺍﺭﺕﻥ
martens	ﻡﺍﺭﺕیﻥﺯ
marthinus	ﻡﺍرﺕیﻥز
marti	ﻡﺍﺭﺕی
martijn	ﻡﺍرﺕیژﻥ
martijntje	ﻡﺍرﺕیژﻥﺕﺝ
martin	ﻡﺍرﺕیﻥ
martino	ﻡﺍﺭﺕیﻥﻭ
martins	ﻡﺍﺭﺕیﻥﺯ
martinsen	ﻡﺍﺭﺕیﻥﺱﻥ
martland	ﻡﺍﺭﺕﻝﻥﺩ
marttha	ﻡﺍرﺕﺍ
martyn	ﻡﺍﺭﺕیﻥ
martyntje	ﻡﺍرﺕیﻥﺕ
martz	ﻡﺍﺭﺕﺯ
marvin	ﻡﺍﺭﻭیﻥ
marwah	ﻡﺭﻭﺍﺡ
marwan	ﻡﺭﻭﺍﻥ
marwin	ﻡﺍﺭﻭیﻥ
marwood	ﻡﺍﺭﻭﻭﺩ
marx	ﻡﺍﺭکﺱ
marxen	ﻡﺍﺭکﺱﻥ
mary	ﻡﺍﺭی
marylynn	ﻡﺍﺭیﻝیﻥ
maryse	ﻡریﺱ
marytje	ﻡریﺕﺝ
marz	ﻡﺍﺭﺯ
marzec	ﻡﺍﺭﺯک
masaaki	ﻡﺍﺱﺍکی
masahiro	ﻡﺍﺱﺍﻩیﺭﻭ
masalkhi	ﻡﺱﺍﻝخی
masanao	ﻡﺍﺱﺍﻥﻭ
masao	ﻡﺍﺱﺍیﻭ
masaru	ﻡﺍﺱﺍﺭﺍ
masashi	ﻡﺍﺱﺍﺵی
masataka	ﻡﺍﺱﺍﺕﺍکﺍ
masato	ﻡﺍﺱﺍﺕﻭ
mascari	ﻡﺍﺱکﺍﺭی
mascias	ﻡﺍﺱکیﺍﺱ
mascotto	ﻡﺍﺱکﻭﺕﻭ
mase	ﻡﺍﺱ
masek	ﻡﺍﺱک
maser	ﻡﺍﺱر
mashburn	ﻡﺵﺏﺍﺭﻥ
mashtare	ﻡﺍﺵﺕیﺭ
maskell	ﻡﺍﺱکﻝ
masna	ﻡﺍﺱﻥﺍ
masnaa	ﻡﺍﺱﻥﺍ
masselli	ﻡﺍﺱﻝﻝی
masserman	ﻡﺍﺱﺭﻡﻥ
massey	ﻡﺍﺱی
massif	ﻡﺱیﻑ
massimi	ﻡﺍﺱیﻡی
massimo	ﻡﺍﺱیﻡﻭ
massios	ﻡﺱیﻭﺱ
masson	ﻡﺍﺱﻭﻥ
massoud	ﻡﺱﻉﻭﺩ
mast	ﻡﺱﺕ
mastan	ﻡﺱﺕﺍﻥ
master	ﻡﺱﺕر
masterov	ﻡﺱﺕرﻭﻭ
masters	ﻡﺱﺕﺭﺯ
masterson	ﻡﺱﺕرﺱﻭﻥ
masud	ﻡﺱﻉﻭﺩ
masuo	ﻡﺍﺱﻭ
mat	ﻡﺕ
mata	ﻡﺍﺕﺍ
matako	ﻡﺍﺕﺍکﻭ
matar	ﻡﺍﺕﺍﺭ
mateen	ﻡﺕیﻥ
matha	ﻡﺕﺍ
mathai	ﻡﺍﺕﺍی
mathar	ﻡﺍﺕر
matheis	ﻡﺍﺕیﺱ
matheson	ﻡﺕﺱﻭﻥ
mathew	ﻡﺕیﻭ
mathews	ﻡﺍﺕیﻭﺱ
mathias	ﻡﺍﺕیﺍﺱ
mathiesen	ﻡﺍﺕیﺱﻥ
mathieu	ﻡﺕیﻭ
mathisen	ﻡﺍﺕیﺱﻥ
mathur	ﻡﺍﺕﻭﺭ
matin	ﻡﺕیﻥ
matlin	ﻡﺕﻝیﻥ
maton	ﻡیﺕﻭﻥ
matrow	ﻡﺕﺭﻭ
mats	ﻡﺕﺱ
matson	ﻡﺕﺱﻭﻥ
matsuda	ﻡﺍﺕﺱﻭﺩﺍ
matsumoto	ﻡﺍﺕﺱﻭﻡﻭﺕﻭ
matt	ﻡﺕ
matthee	ﻡﺍﺕﺱی
matthews	ﻡﺍﺕیﻭﺱ
matthewson	ﻡﺕیﻭﺱﻭﻥ
matthys	ﻡﺍﺕیﺱ
mattingly	ﻡﺕیﻥگﻝی
mattis	ﻡﺍﺕیﺱ
mattson	ﻡﺍﺕﺱﻭﻥ
mattu	ﻡﺍﺕﻭ
matula	ﻡﺍﺕﻭﻝﺍ
matyas	ﻡﺕیﻭﺱ
mau	ﻡﺍﻭ
maud	ﻡﺍﺩ
mauer	ﻡﺍﻭﺭ
maufe	ﻡﺍﻭﻑ
maughan	ﻡﺍگﺍﻥ
maumee	ﻡﺍﻡی
maun	ﻡﺍﻭﻥ
maung	ﻡﺍﻭﻥگ
maupin	ﻡﺍﻭپیﻥ
mauri	ﻡﺍﺭی
maurice	ﻡﺍﻭریﺱ
mauro	ﻡﻭﺭﻭ
maurstad	ﻡﻭﺭﺱﺕﺍﺩ
maury	ﻡﺭی
mautino	ﻡﺍﺕیﻥﻭ
mawby	ﻡﺍﺏی
mawk	ﻡﺍک
mawson	ﻡﺍﺱﺍﻥ
maxfield	ﻡکﺱﻑیﻝﺩ
maxim	ﻡﺍکﺯیﻡ
maximilian	ﻡﺍکﺱیﻡیﻝیﺍﻥ
maxwell	ﻡکﺱﻭﻝ
maxwells	ﻡﺍکﺱﻭﻝ
may	ﻡی
mayan	ﻡﺍیﺍﻥ
mayank	ﻡﺍیﺍﻥک
maycock	ﻡیکک
mayeen	ﻡﺍیﻥ
mayfield	ﻡﺍیﻑیﻝﺩ
mayhar	ﻡیﻩﺍر
mayhugh	ﻡیﻩﺍگ
maynard	ﻡیﻥﺍﺭﺩ
mayne	ﻡیﻥ
mayo	ﻡیﻭ
mayr	ﻡﺍیﺭ
maysan	ﻡیﺙﺍﻥ
mayston	ﻡیﺱﺕﻭﻥ
maytag	ﻡﺍیﺕﺍگ
mazdeh	ﻡﺯﺩﻩ
maze	ﻡیﺯ
mazera	ﻡﺍﺯﺭﺍ
mbuya	ﺍﻡﺏﻭیﺍ
mcaleer	ﻡکﺍﻝیﺭ
mcardle	ﻡکﺍﺭﺩﻝ
mccalla	ﻡککﺍﻝﺍ
mccann	ﻡککﺍﻥ
mccarthy	ﻡککﺍﺭﺕی
mccarty	ﻡککﺍﺭﺕی
mccauley	کﺍﻭﻝی
mcclain	ﻡککﻝیﻥ
mccoll	ﻡککﻭﻝ
mcdaniel	ﻡکﺩﺍﻥیﻝ
mcdermott	ﻡکﺩﺭﻡﻭﺕ
mcdonald	ﻡکﺩﻭﻥﺍﻝﺩ
mcdougald	ﻡکﺩﻭگﺍﻝﺩ
mcdowell	ﻡکﺩﻭیﻝ
mcfarland	ﻡکﻑﺍﺭﻝﻥﺩ
mcfarlane	ﻡکﻑﺭﻝیﻥ
mcgavin	ﻡکگﺍﻭیﻥ
mcgeary	ﻡکگیﺭی
mcgee	ﻡکگی
mcgrath	ﻡکگﺭﺍﺕ
mcguire	ﻡکگﻭیﺭ
mcguirk	ﻡکگﻭیﺭک
mcininch	ﻡکیﻥیﻥچ
mcintosh	ﻡکیﻥﺕﺍﺵ
mckenna	ﻡککﻥﺍ
mckenney	ﻡککﻥی
mckenzie	ﻡککﻥﺯی
mclaren	ﻡکﻝﺍﺭﻥ
mclean	ﻡکﻝیﻥ
mclellan	ﻡکﻝیﻝﺍﻥ
mclernan	ﻡکﻝﺭﻥﺍﻥ
mcloughlin	ﻡکﻝﺍﻭﻝیﻥ
mcmahan	ﻡکﻡﺍﻩﺍﻥ
mcmahon	ﻡکﻡﺍﻩﻭﻥ
mcmanis	ﻡکﻡﺍﻥیﺱ
mcmanus	ﻡکﻡﺍﻥیﻭﺱ
mcmullen	ﻡکﻡﻭﻝﻥ
mcmullin	ﻡکﻡﻭﻝیﻥ
mcnutt	ﻡکﻥﺍﺕ
mcvoy	ﻡکﻭی
meachen	ﻡیچﻥ
meade	ﻡیﺩ
meadows	ﻡیﺩﺍﻭﺯ
meagher	ﻡیگﺭ
meahan	ﻡیﻩﺍﻥ
meaker	ﻡیکﺭ
meaney	ﻡیﻥی
means	ﻡیﻥﺯ
meara	ﻡیﺭﺍ
mearls	ﻡیرﻝﺱ
mears	ﻡیﺭﺯ
measat	ﻡیﺱﺍﺕ
mecca	ﻡکﺍ
med	ﻡﺩ
medalen	ﻡﺩﺍﻝﻥ
medawar	ﻡﺩﺍﻭﺭ
medd	ﻡیﺩ
medea	ﻡیﺩی
media	ﻡﺩیﺍ
median	ﻡﺩیﻥ
medina	ﻡﺩیﻥﺍ
medlin	ﻡﺩﻝیﻥ
mednick	ﻡﺩﻥیک
medrek	ﻡﺩﺭک
meechan	ﻡیچﺍﻥ
meehan	ﻡیﻩﺍﻥ
meek	ﻡیک
meekings	ﻡیکیﻥگ
meekins	ﻡیکیﻥﺯ
meeks	ﻡیکﺯ
meewes	ﻡیﻭز
mefford	ﻡﻑﻭﺭﺩ
meger	ﻡگﺭ
meglan	ﻡگﻝﺍﻥ
megyesi	ﻡگیﺱی
mehera	ﻡﻩرﺍ
mehrkens	ﻡﻩﺭکﻥﺯ
mehta	ﻡﺕﺍ
mei	ﻡی
meier	ﻡییﺭ
meighen	ﻡیگﻥ
meijer	ﻡیﺝﺭ
meindert	ﻡیﺍیﻥﺩرﺕ
meiners	ﻡیﻥﺭﺯ
mejia	ﻡﺝیﺍ
mekkah	ﻡککﺍﻩ
mel	ﻡﻝ
melander	ﻡﻝﺍﻥﺩﺭ
melanie	ﻡﻝﺍﻥی
melara	ﻡیﻝﺍﺭﺍ
melby	ﻡﻝﺏﺍی
melchers	ﻡﻝچﺭﺱ
melchior	ﻡﻝچیﺭ
meleedy	ﻡﻝیﺩی
melen	ﻡیﻝﻥ
melhart	ﻡﻝﻩﺍﺭﺕ
mella	ﻡﻝﺍ
mellin	ﻡﻝیﻥ
mellinger	ﻡﻝیﻥگﺭ
mellor	ﻡﻝﺭ
melman	ﻡیﻝﻡﺍﻥ
melo	ﻡﻝﻭ
meloon	ﻡﻝﻭﻥ
melton	ﻡﻝﺕﻥ
meltzer	ﻡﻝﺕﺯﺭ
menard	ﻡیﻥﺍﺭﺩ
mendell	ﻡﻥﺩﻝ
mendes	ﻡﻥﺩﺯ
mendoza	ﻡﻥﺩﻭﺯﺍ
mendyke	ﻡﻥﺩیک
menes	ﻡیﻥﺯ
menezes	ﻡﻥﺯﺱ
meng	ﻡﻥگ
menge	ﻡﻥگﻩ
menges	ﻡﻥگﺱ
menke	ﻡﻥک
menon	ﻡﻥﻭﻥ
menth	ﻡﻥﺕ
mentzer	ﻡﻥﺕﺯﺭ
menzel	ﻡﻥﺯﻝ
meranda	ﻡﺭﺍﻥﺩﺍ
mercer	ﻡﺭکﺭ
merchant	ﻡﺭکﻥﺕ
meredith	ﻡیﺭیﺩیﺕ
merginio	ﻡﺭﺝیﻥیﻭ
meritt	ﻡﺭیﺕ
merk	ﻡﺭک
merkel	ﻡﺭکﻝ
merkle	ﻡﺭکﻝی
merlino	ﻡﺭﻝیﻥﻭ
merolle	ﻡیﺭﻭﻝ
merrick	ﻡﺭیک
merricks	ﻡﺭیکﺱ
merrigan	ﻡﺭیگﺍﻥ
merrill	ﻡﺭیﻝ
merriman	ﻡﺭیﻡﺍﻥ
merry	ﻡری
mertalo	ﻡﺭﺕﺍﻝﻭ
mertens	ﻡﺭﺕﻥﺯ
merz	ﻡﺭﺯ
mesa	ﻡیﺱﺍ
mesander	ﻡﺱﺍﻥﺩﺭ
meskes	ﻡﺱکﺱ
mesler	ﻡﺱﻝر
messer	ﻡﺱﺭ
messinger	ﻡﺱیﻥگﺭ
metternich	ﻡﺕریﻥچ
metzger	ﻡﺕﺯگﺭ
metzing	ﻡﺕﺯیﻥگ
metzler	ﻡیﺕﺯﻝﺭ
meyer	ﻡیﺭ
meyers	ﻡییﺭﺱ
miao	ﻡیﺍﻭ
micha	ﻡیچﺍ
michael	ﻡیخﺍییﻝ
michaelis	ﻡیچﺍیﻝیﺱ
michalak	ﻡیکﺍﻝک
michel	ﻡیﺵﻝ
michele	ﻡیﺵﻝ
michelson	ﻡیﺵﻝﺱﻭﻥ
micheltjen	ﻡیچﻝﺕیﻥ
michiel	ﻡیچیﻝ
mickelson	ﻡیکﻝﺱﻭﻥ
mickhael	ﻡیکﺍییﻝ
micklem	ﻡیکﻝﻡ
mickna	ﻡیکﻥﺍ
micohn	ﻡﺍیکﻥ
middlebro	ﻡیﺩﻝﺏﺭﻭ
middleton	ﻡیﺩﻝﺕﻥ
miehe	ﻡییﻩ
mier	ﻡیﺭ
mierwa	ﻡیﺭﻭﺍ
might	ﻡﺍیﺕ
migliardi	ﻡیگﻝیﺍﺭﺩی
mignerey	ﻡیگﻥﺭی
migneron	ﻡیگﻥﺭﺍﻥ
miguel	ﻡیگﻭیﻝ
mihalek	ﻡیﻩﻝک
mihalick	ﻡیﻩﺍﻝیک
mika	ﻡیکﺍ
mikael	ﻡیکﺍیﻝ
mike	ﻡﺍیک
mikesell	ﻡﺍیکﺱﻝ
miket	ﻡیکﺕ
mikhail	ﻡیخﺍییﻝ
mikhaylov	ﻡیخﺍییﻝﻭﻑ
miki	ﻡیکی
mikkelsen	ﻡیکﻝﺱﻥ
mikki	ﻡیکی
miklos	ﻡیکﻝﺍﺱ
mikoss	ﻡیکﺍﺱ
mikulin	ﻡیکﺍﻝیﻥ
mikus	ﻡیکﺱ
milacic	ﻡیﻝﺍﺱیﺱ
milad	ﻡیﻝﺍﺩ
milam	ﻡیﻝﺍﻡ
milan	ﻡیﻝﺍﻥ
milberger	ﻡیﻝﺏﺭﺝﺭ
milbert	ﻡیﻝﺏﺭﺕ
milburn	ﻡیﻝﺏرﻥ
mildred	ﻡیﻝﺩﺭﺩ
milgram	ﻡیﻝگﺭﺍﻡ
mili	ﻡیﻝی
milind	ﻡیﻝیﻥﺩ
milko	ﻡیﻝکﻭ
milks	ﻡیﻝکﺱ
milky	ﻡیﻝکی
millan	ﻡیﻝﺍﻥ
millar	ﻡیﻝﺍﺭ
millard	ﻡیﻝﺍﺭﺩ
millen	ﻡیﻝﻥ
millennium	ﻡیﻝﻥیﻭﻡ
miller	ﻡیﻝﺭ
millett	ﻡیﻝﺕ
millham	ﻡیﻝﺍﻡ
milli	ﻡیﻝی
millians	ﻡیﻝیﺍﻥﺯ
millican	ﻡیﻝیکﻥ
millie	ﻡیﻝی
milligan	ﻡیﻝیگﺍﻥ
millman	ﻡیﻝﻡﺍﻥ
mills	ﻡیﻝﺯ
millward	ﻡیﻝﻭﺍرﺩ
milmoe	ﻡیﻝﻡﻭ
milne	ﻡﺍیﻝﻥ
milner	ﻡیﻝﻥﺭ
milnes	ﻡیﻝﻥﺱ
milnor	ﻡیﻝﻥﻭﺭ
milo	ﻡیﻝﻭ
milos	ﻡیﻝﻭﺱ
milt	ﻡیﻝﺕ
milton	ﻡیﻝﺕ﹀­ﻥ
milut	ﻡیﻝﻭﺕ
milward	ﻡیﻝﻭﺍﺭﺩ
mimas	ﻡیﻡﺍﺱ
mime	ﻡیﻡی
mimi	ﻡیﻡی
mimms	ﻡﺍیﻡﺯ
mina	ﻡیﻥﺍ
minamo	ﻡیﻥﺍﻡﻭ
minaret	ﻡیﻥﺍرﺕ
minarik	ﻡیﻥﺍﺭیک
mincer	ﻡیﻥﺱﺭ
mincey	ﻡیﻥﺱی
mindt	ﻡیﻥﺕ
miner	ﻡیﻥﺭ
mineral	ﻡیﻥﺭﺍﻝ
minerva	ﻡیﻥﺭﻭﺍ
minna	ﻡیﻥﺍ
minot	ﻡیﻥﻭﺕ
minqi	ﻡیﻥکی
minstrel	ﻡیﻥﺱﺕﺭﻝ
minter	ﻡیﻥﺕﺭ
minton	ﻡیﻥﺕﻭﻥ
mintz	ﻡیﻥﺕﺯ
minyard	ﻡیﻥیﺍﺭﺩ
mir	ﻡیﺭ
miraglia	ﻡیرﺍگﻝیﺍ
mirashi	ﻡیﺭﺵی
mire	ﻡﺍیﺭ
mirmak	ﻡیﺭﻡﺍک
mirti	ﻡیﺭﺕی
mirut	ﻡیﺭﻭﺕ
misik	ﻡیﺱیک
miskin	ﻡﺱکیﻥ
mislove	ﻡیﺱﻝﺍﻭ
misra	ﻡیﺱﺭﺍ
missel	ﻡﺍیﺱﻝ
mistry	ﻡیﺱﺕﺭی
mitchel	ﻡیﺕچﻝ
mitchell	ﻡیچﻝ
mitchem	ﻡیﺕچﻡ
mithal	ﻡیﺕﺍﻝ
mitham	ﻡﺍیﺕﻩﺍﻡ
mitnick	ﻡیﺕﻥیک
mito	ﻡیﺕﻭ
mitrovic	ﻡیﺕﺭﻭﻭیک
miura	ﻡیﺭﺍ
mix	ﻡیکﺱ
mize	ﻡیﺯ
mizera	ﻡیﺯیﺭﺍ
mkel	ﻡکﻝ
moaker	ﻡﻭکﺭ
mobasher	ﻡﺏﺍﺵر
mobasseri	ﻡﺏﺱﺭی
mobley	ﻡﻭﺏﻝی
mockridge	ﻡﺍکریﺝ
mod	ﻡﻭﺩ
moffat	ﻡﻭﻑﺍﺩ
moganti	ﻡﻭگﺍﻥﺕی
mogged	ﻡﺍگﺩ
moghrabi	ﻡﻕﺭﺏی
mohan	ﻡﻭﻩﺍﻥ
mohar	ﻡﻭﻩﺭ
mohr	ﻡﻩر
moile	ﻡﻭیﻝ
moisan	ﻡﻭﺍﺱﺍﻥ
moises	ﻡﻭیﺱﺱ
mok	ﻡﻭک
molaire	ﻡﻝﺍییﺭ
molander	ﻡﻭﻝﺍﻥﺩﺭ
molinari	ﻡﻭﻝیﻥﺍﺭی
moller	ﻡﻭﻝﺭ
molloy	ﻡﻭﻝﻭی
moloney	ﻡﻭﻝﻭﻥی
monack	ﻡﻭﻥﺍک
monagan	ﻡﻭﻥﺍگﺍﻥ
moncur	ﻡﻭﻥکﺍﺭ
mondanaro	ﻡﻭﻥﺩﺍﻥﺍﺭﻭ
mondfrans	ﻡﻭﻥﺩﻑﺭﺍﻥﺱ
mondor	ﻡﺍﻥﺩﺍﺭ
mondore	ﻡﻭﻥﺩﻭﺭ
money	ﻡﺍﻥی
monis	ﻡﻭﻥیﺱ
monitto	ﻡﻥیﺕﻭ
monk	ﻡﺍﻥک
monkey	ﻡﺍﻥکی
monkman	ﻡﺍﻥکﻡﻥ
monks	ﻡﺍﻥکﺱ
monolith	ﻡﻭﻥﻭﻝیﺕ
monroe	ﻡﻥﺭﻭ
monson	ﻡﺍﻥﺱﻥ
monster	ﻡﺍﻥﺱﺕﺭ
monta	ﻡﻭﻥﺕﺍ
montagu	ﻡﻭﻥﺕﺍگﻭ
montague	ﻡﻭﻥﺕگیﻭ
montanaro	ﻡﻭﻥﺕﺍﻥﺍﺭﻭ
montano	ﻡﻭﻥﺕﺍﻥﻭ
monteiro	ﻡﻭﻥﺕیﺭﻭ
montero	ﻡﻭﻥﺕﺭﻭ
montgomery	ﻡﻭﻥﺕگﻡﺭی
montijo	ﻡﻭﻥﺕیﺝﻭ
monton	ﻡﺍﻥﺕﻭﻥ
moody	ﻡﻭﺩی
moon	ﻡﻭﻥ
moore	ﻡﻭﺭ
moorhouse	ﻡﻭﺭﻩﺍﻭﺱ
moorman	ﻡﻭﺭﻡﺍﻥ
moosavi	ﻡﻭﺱﻭی
mooseface	ﻡﻭﺱﻑیﺱ
moqbara	ﻡﻕﺏﺭﻩ
moraine	ﻡﺍﺭیﻥ
moraines	ﻡﻭﺭﺍیﻥﺱ
morales	ﻡﻭﺭﺍﻝﺱ
moran	ﻡﻭﺭﺍﻥ
morando	ﻡﻭﺭﺍﻥﺩﻭ
morano	ﻡﻭﺭﺍﻥﻭ
moras	ﻡﻭﺭﺍﺱ
moravan	ﻡﻭﺭﺍﻭﺍﻥ
moray	ﻡﻭﺭﺍی
morch	ﻡﻭﺭچ
moreby	ﻡرﺏی
morehouse	ﻡﺭﻩﺍﻭﺱ
morel	ﻡﻭﺭﻝ
moreno	ﻡﻭﺭﻥﻭ
mores	ﻡﻭﺭﺱ
morey	ﻡﻭﺭی
morgan	ﻡﺭگﺍﻥ
morin	ﻡﻭﺭیﻥ
morison	ﻡﻭﺭیﺱﻭﻥ
morita	ﻡﻭﺭیﺕﺍ
morkel	ﻡﻭﺭکﻝ
morken	ﻡﻭﺭکﻥ
morlan	ﻡﻭﺭﻝﺍﻥ
morley	ﻡﻭﺭﻝی
morlidge	ﻡﻭﺭﻝیﺝ
morning	ﻡﻭﺭﻥیﻥگ
moroney	ﻡﻭﺭﻭﻥی
moroses	ﻡﻭرﻭﺱﺱ
morrell	ﻡﻭﺭﻝ
morrill	ﻡﻭﺭیﻝ
morris	ﻡﻭریﺱ
morrison	ﻡﺍﺭیﺱﻭﻥ
morriss	ﻡﻭﺭیﺱ
morrow	ﻡﺍرﻭ
morss	ﻡﻭﺭﺱ
mortier	ﻡﻭﺭﺕﺍیﺭ
mortimer	ﻡﻭﺭﺕیﻡﺭ
mortimore	ﻡﻭرﺕیﻡر
morton	ﻡﺭﺕﻥ
morville	ﻡﻭﺭﻭیﻝ
moses	ﻡﺱﺱ
moshier	ﻡﻭﺵیﺭ
mossburg	ﻡﺍﺱﺏﺭگ
mosses	ﻡﻭﺱﺯ
mossop	ﻡﻭﺱﻭپ
motor	ﻡﻭﺕﻭﺭ
motors	ﻡﻭﺕﻭﺭﺯ
mott	ﻡﻭﺕ
motta	ﻡﻭﺕﺍ
moudgill	ﻡﻭﺩگیﻝ
moulden	ﻡﺍﻝﺩﻥ
moulder	ﻡﻭﻝﺩر
mouli	ﻡﻭﻝی
moulk	ﻡﻭﻝک
moulton	ﻡﻭﻝﺕﻭﻥ
mount	ﻡﻭﻥﺕ
mountains	ﻡﺍﻥﺕﻥﺯ
mounts	ﻡﺍﻥﺕﺯ
mounzer	ﻡﻥﺯﺭ
moy	ﻡﻭی
moye	ﻡﻭی
moyer	ﻡﺍیﺭ
moynihan	ﻡﻭیﻥیﻩﺍﻥ
moziar	ﻡﻭﺯیﺍر
mozina	ﻡﻭﺯیﻥﺍ
mubarak	ﻡﺏﺍرک
much	ﻡﺍچ
mudge	ﻡﺍﺝ
mudie	ﻡﻭﺩی
mueller	ﻡﻭﺍﻝﺭ
muenzer	ﻡﻭﺍﻥﺯﺭ
muenzler	ﻡﻭﻥﺯﻝﺭ
muessig	ﻡﻭﺱیگ
muffin	ﻡﺍﻑیﻥ
muh	ﻡﻭ
muhamma	ﻡﺡﺍﻡﺍ
muharraq	ﻡﺡرک
muir	ﻡﻭیﺭ
muirden	ﻡﻭیرﺩﻥ
muise	ﻡﻭیﺯ
mukasa	ﻡﻭکﺍﺱﺍ
mularo	ﻡﻭﻝﺍﺭﻭ
mull	ﻡﺍﻝ
muller	ﻡﻭﻝﺭ
mulligan	ﻡﺍﻝیگﺍﻥ
mulrooney	ﻡﺍﻝﺭﻭﻥی
mulroy	ﻡﻭﻝرﻭی
mumford	ﻡﺍﻡﻑﻭرﺩ
mummert	ﻡﺍﻡﺭﺕ
mun	ﻡﻭﻥ
munch	ﻡﺍﻥخ
munday	ﻡﺍﻥﺩی
muniz	ﻡﻭﻥیﺯ
munkert	ﻡﺍﻥکﺭﺕ
muno	ﻡﺍﻥﻭ
munoz	ﻡﻭﻥﺍﺯ
munro	ﻡﺍﻥﺭﻭ
muns	ﻡﻭﻥﺱ
munsil	ﻡﺍﻥﺱیﻝ
munsinger	ﻡﺍﻥﺱیﻥگﺭ
mura	ﻡﻭﺭﺍ
murad	ﻡﻭﺭﺍﺩ
murali	ﻡﺍﺭﺍﻝی
muralt	ﻡﻭﺭﺍﻝﺕ
murata	ﻡﻭﺭﺕ
murdoch	ﻡﺍﺭﺩﻭچ
mureika	ﻡﻭریکﺍ
muren	ﻡﺍﺭﻥ
murie	ﻡﺍﺭیﻩ
murken	ﻡﺭکﻥ
murrell	ﻡﺍررﻝ
murthy	ﻡﻭﺭﺕی
mury	ﻡﺍﺭی
musa	ﻡﻭﺱی
muschall	ﻡﻭﺵﺍﻝ
muse	ﻡﻭﺱ
musella	ﻡﻭﺱﻝﺍ
mutiso	ﻡﻭﺕیﺱﻭ
mutt	ﻡﺍﺕ
muysson	ﻡیﻭﺱُﻥ
myer	ﻡﺍیﺭ
myers	ﻡیﺭﺯ
myiesha	ﻡیﺵﺍ
myreen	ﻡﺍیﺭﻥ
myrick	ﻡﺍیﺭیک
mystic	ﻡﺍیﺱﺕیک
myth	ﻡﺍیﺕ
nabatiye	ﻥﺏﺍﺕی
nadel	ﻥﺍﺩﻝ
nadig	ﻥﺍﺩیگ
nadkarni	ﻥﺩکﺍﺭﻥی
nadler	ﻥﺍﺩﻝﺭ
nadolny	ﻥﺍﺩﻭﻝﻥی
nafeeza	ﻥﺍﻑزﺍ
nagasaki	ﻥﺍگﺍﺱﺍکی
nagel	ﻥگﻝ
nager	ﻥﺍﺝﺭ
naggs	ﻥﺍگﺯ
nagy	ﻥگی
nahas	ﻥﺍﻩﺍﺱ
nahnah	ﻥﻩﻥﻩ
nahta	ﻥﻩﺕﺍ
nahum	ﻥﺍﻩﺍﻡ
naidoo	ﻥﺍیﺩﻭ
nair	ﻥیﺭ
najaf	ﻥﺝﺍﻑ
najiyah	ﻥﺍﺝیﺍﻩ
najran	ﻥﺝرﺍﻥ
najwa	ﻥﺝﻭﺍ
najya	ﻥﺍﺝیﺍ
nakagaki	ﻥﺍکﺍگﺍکی
nakashima	ﻥﺍکﺍﺵیﻡﺍ
nakasora	ﻥﺍکﺍﺱﻭﺭﺍ
nalos	ﻥﺍﻝﻭﺱ
namazi	ﻥﻡﺍﺯی
nambimadom	ﻥﺍﻡﺏیﻡیﺩﻭﻡ
nan	ﻥﺍﻥ
nancy	ﻥﺍﻥﺱی
nandwani	ﻥﺍﻥﺩﻭﺍﻥی
naphade	ﻥﻑیﺩ
napoli	ﻥپﻭﻝی
napolitano	ﻥﺍپﻭﻝیﺕﺍﻥﻭ
napora	ﻥپﻭﺭﺍ
nappa	ﻥﺍپﺍ
nappi	ﻥپی
napton	ﻥپﺕﻭﻥ
narad	ﻥﺍﺭﺍﺩ
nardi	ﻥﺍﺭﺩی
nardo	ﻥﺍﺭﺩﻭ
nardone	ﻥﺍﺭﺩﻥ
nareg	ﻥﺍرگ
narendra	ﻥﺍﺭﻥﺩﺭﺍ
naro	ﻥﺍﺭﻭ
narsavage	ﻥﺍﺭﺱﺍﻭﺍگ
nas	ﻥﺍﺱ
nashida	ﻥﺵیﺩﺍ
nashwa	ﻥﺵﻭﺍ
nasiha	ﻥﺱیﻩ
nasir	ﻥصیﺭ
nasira	ﻥﺱیرﺍ
nass	ﻥﺍﺱ
nassau	ﻥﺍﺱﺍﻭ
nathan	ﻥﺍﺕﺍﻥ
nathanson	ﻥﺍﺩﺍﻥﺱﻭﻥ
nathifa	ﻥطیﻑﺍ
nau	ﻥﺍﻭ
nauer	ﻥﺍﻭیﺭ
naunton	ﻥﺍﻥﺕﻭﻥ
navarra	ﻥﺍﻭﺍرﺍ
navarro	ﻥﺍﻭﺍﺭﻭ
navas	ﻥﺍﻭﺍﺱ
nave	ﻥﺍﻭ
naveen	ﻥﺍﻭیﻥ
navia	ﻥﺍﻭیﺍ
navis	ﻥﻭیﺱ
nawal	ﻥﺍﻭﺍﻝ
nawar	ﻥﺍﻭﺍر
nawaz	ﻥﻭﺍﺯ
nawrot	ﻥﺍﻭﺭﺕ
nayar	ﻥیﺭ
nayfeh	ﻥﺍیﻑﻩ
naylor	ﻥﺍیﻝﺭ
nazahah	ﻥزﺍﺡﺍ
nazaretian	ﻥﺍﺯﺍﺭیﺕیﺍﻥ
nazario	ﻥﺍﺯﺍﺭیﻭ
nazirah	ﻥزیرﺍ
near	ﻥیﺭ
nebel	ﻥﺏﻝ
nebres	ﻥﺏﺭﺱ
nedbal	ﻥﺩﺏﺍﻝ
neden	ﻥﺩﻥ
nedin	ﻥﺩیﻥ
nedved	ﻥﺩﻭﺩ
needles	ﻥیﺩﻝﺯ
neefjan	ﻥیﻑﺝﺍﻥ
neelmegh	ﻥیﻝﻡگ
neeltje	ﻥیﻝﺕﺝ
nefedow	ﻥﻑﺩﻭ
negative	ﻥگﺕیﻭ
negro	ﻥگرﻭ
neill	ﻥیﻝ
neilson	ﻥیﻝﺱﻭﻥ
neisen	ﻥیﺱﻥ
neri	ﻥﺭی
neron	ﻥرﻭﻥ
nery	ﻥﺭی
nesbitt	ﻥﺱﺏیﺕ
nesley	ﻥﺱﻝی
ness	ﻥیﺱ
nesterman	ﻥﺱﺕﺭﻡﺍﻥ
nestle	ﻥﺱﺕﻝﻩ
nestler	ﻥﺱﺕﻝﺭ
nethacker	ﻥﺕﺍکﺭ
netherton	ﻥﺕﺭﺕﻭﻥ
nettleship	ﻥﺕﻝﺵیپ
neuen	ﻥیﻭﺍﻥ
neufang	ﻥیﻭﻑﻥگ
neuhaus	ﻥﻩﺍﻭﺱ
neuman	ﻥیﻭﻡﺍﻥ
nevejans	ﻥﻭیﺝﺍﻥز
nevile	ﻥﻭﺍیﻝ
neville	ﻥﻭیﻝ
nevison	ﻥیﻭیﺱﻭﻥ
newark	ﻥیﻭﺍﺭک
newberry	ﻥیﻭﺏﺭی
newbery	ﻥیﻭﺏﺭی
newby	ﻥیﻭﺏﺍی
newcomb	ﻥییﻭکﺍﻡﺏ
newcombe	ﻥیﻭکﻡﺏﻩ
newell	ﻥییﻭیﻝ
newett	ﻥیﻭﻭﺕ
newington	ﻥیﻭییﻥگﺕﻭﻥ
newland	ﻥیﻭﻝﻥﺩ
newman	ﻥیﻭﻡﺍﻥ
newmeyer	ﻥیﻭﻡیﺭ
newquist	ﻥیﻭکﻭیﺱﺕ
newt	ﻥیﻭﺕ
newton	ﻥییﻭﺕﻥ
nibby	ﻥیﺏی
nic	ﻥیک
nichola	ﻥیکﻭﻝﺍ
nicholls	ﻥیکﻝﺯ
nichols	ﻥیچﻭﻝﺱ
nicholson	ﻥیکﻝﺱﻥ
nick	ﻥیک
nickel	ﻥیکﻝ
nickell	ﻥیکﻝ
nickelsen	ﻥیکﻝﺱﻥ
nickerson	ﻥیکﺭﺱﻭﻥ
nicki	ﻥیکی
nicko	ﻥکﻭ
nickolas	ﻥکﻭﻝﺱ
nickolay	ﻥیکﻭﻝی
niclas	ﻥیکﻝﺱ
nico	ﻥکﻭ
nicol	ﻥیکﻝ
nicolaes	ﻥیکﻝﺍﺱ
nicolai	ﻥیکﻭﻝی
nicolas	ﻥیکﺍﻝﺍﺱ
nicolaus	ﻥیکﻝﺍﺱ
nicole	ﻥیکﻝ
nicoll	ﻥیکﻭﻝ
nicolo	ﻥیکﻝﻭ
nidal	ﻥیﺩﺍﻝ
nider	ﻥیﺩﺭ
niek	ﻥیک
niekolaas	ﻥیکﻝﺍﺱ
niel	ﻥیﻝ
niels	ﻥیﻝﺯ
nielson	ﻥیﻝﺱﻥ
niemi	ﻥیﻡی
nien	ﻥیﻥ
niermann	ﻥﺍیﺭﻡﻥ
nigel	ﻥﺍیگﻝ
nigg	ﻥیگ
niggli	ﻥیگﻝی
night	ﻥﺍیﺕ
nigra	ﻥیگﺭﺍ
nigro	ﻥیگﺭﻭ
niguma	ﻥیگﻭﻡﺍ
nihalani	ﻥیﻩﺍﻝﺍﻥی
nik	ﻥیک
niki	ﻥیکی
nikki	ﻥیکی
niklas	ﻥکﻝﺍﺱ
niknaz	ﻥکﻥﺯ
niko	ﻥیکﻭ
nikolai	ﻥیکﻭﻝﺍی
nikolay	ﻥیکﻭﻝی
nikos	ﻥیکﺱ
niland	ﻥیﻝﻥﺩ
niles	ﻥﺍیﻝﺯ
nilesh	ﻥیﻝﺵ
nilse	ﻥیﻝﺱ
nilsen	ﻥﻝﺱﻥ
nimtz	ﻥیﻡﺕﺯ
nin	ﻥیﻥ
nina	ﻥﺍیﺍ
ninad	ﻥیﻥﺩ
ninawa	ﻥیﻥﺍﻭﺍ
ninedek	ﻥیﻥﺩک
ninja	ﻥیﻥﺝﺍ
ninnis	ﻥیﻥﺱ
nino	ﻥیﻥﻭ
ninoys	ﻥیﻥﻭیﺱ
ninstar	ﻥیﻥﺱﺕﺍﺭ
nipple	ﻥپﻝ
nippon	ﻥپﺍﻥ
nir	ﻥیر
nirad	ﻥیﺭﺩ
niss	ﻥیﺱ
nistler	ﻥیﺱﺕﻝﺭ
nitin	ﻥیﺕیﻥ
nix	ﻥﺍیکﺱ
nixon	ﻥیکﺱﻭﻥ
noda	ﻥﻭﺩﺍ
noel	ﻥﻭیﻝ
noko	ﻥﻭکﻭ
nolan	ﻥﻭﻝﺍﻥ
nolde	ﻥﻭﻝﺩ
nolf	ﻥﻭﻝﻑ
noorda	ﻥﻭﺭﺩﺍ
noorddorp	ﻥﻭرﺩرﺍپ
norby	ﻥﻭﺭﺏﺍی
norcott	ﻥﻭﺭکﺍﺕ
nordborg	ﻥﻭﺭﺩﺏﻭﺭگ
nordby	ﻥﻭﺭﺩﺏﺍی
nordenfelt	ﻥﺭﺩﻥﻑﻝﺕ
nordenstrom	ﻥﻭﺭﺩﻥﺱﺕﻭﺭﻡ
nordt	ﻥﻭﺭﺩﺕ
noren	ﻥﻭﺭﻥ
norha	ﻥﻭﺭﻩﺍ
normann	ﻥﻭﺭﻡﻥ
norquist	ﻥﻭﺭکﻭییﺱﺕ
norris	ﻥﺍﺭیﺱ
north	ﻥﻭﺭث
northcutt	ﻥﻭﺭﺕکﺍﺕ
northorpe	ﻥرﺕرﻭپ
northup	ﻥﻭرﺕﺍپ
northway	ﻥﻭﺭﺕﻭی
norup	ﻥﺭﻭپ
norwood	ﻥﻭﺭﻭﻭﺩ
nosack	ﻥﻭﺱﺍک
nose	ﻥﻭﺯ
nossum	ﻥﺱﻭﻡ
nostrand	ﻥﻭﺱﺕرﺍﻥﺩ
note	ﻥﻭﺕ
notz	ﻥﻭﺕﺯ
nova	ﻥﻭﺍ
novella	ﻥﻭﺍﻝﺍ
novello	ﻥﻭﻝﻭ
novick	ﻥﻭیک
novillo	ﻥﺍﻭیﻝﻭ
novosel	ﻥﻭﻭﺱﻝ
nowitz	ﻥﻭیﺕﺯ
noxon	ﻥﺍکﺱﻭﻥ
noya	ﻥﻭیﺍ
noyens	ﻥﻭیﻥﺯ
noyles	ﻥﻭیﻝﺱ
nuding	ﻥﻭﺩیﻥگ
nukala	ﻥﻭکﺍﻝﺍ
nunatak	ﻥﻭﻥﺍﺕﺍک
nunataks	ﻥﻭﻥﺍﺕﺍکﺯ
nunis	ﻥﻭﻥیﺱ
nunley	ﻥﺍﻥﻝی
nuri	ﻥﻭری
nurse	ﻥﺭﺱ
nutt	ﻥﺍﺕ
nutter	ﻥﺍﺕﺭ
nuzzo	ﻥﺍﺯﻭ
nyberg	ﻥﺍیﺏﺭگ
nye	ﻥﺍی
nyffeler	ﻥﺍیﻑﻝﺭ
nyikos	ﻥﺍیکﺱ
nyman	ﻥیﻡﺍﻥ
oakins	ﺍﻭکیﻥﺯ
oakley	ﺍکﻝی
oates	ﺍﻭﺕﺱ
obadja	ﺍﺏﺍﺝﺍ
obbingem	ﺍﺏیﻥگﻡ
oberdorfer	ﺍﻭﺏﺭﺩﻭﺭﻑﺭ
oberheim	ﺍﻭﺏﺭﻩیﻡ
oberholz	ﺍﻭﺏﺭﻩﻭﻝﺯ
oberle	ﺍﺏﺭﻝ
oberreuter	ﺍﺏﺭﻭﺕﺭ
obertas	ﺍﻭﺏﺭﺕﺍﺱ
obrien	ﺍﺏﺭیﻥ
obrist	ﺍﻭﺏﺭیﺱﺕ
obst	ﺍﺏﺱﺕ
obstgarten	ﺍﺏﺱﺕگﺍﺭﺕﻥ
ochs	ﺍﻭچﺯ
ocker	ﺍﻭکﺭ
odds	ﺍﺩﺯ
odegard	ﺍﻭﺩگﺍﺭﺩ
odell	ﺍﺩﻝ
odonnell	ﺍﺩﺍﻥﻝ
odriscoll	ﺍﺩریﺱکﻭﻝ
odum	ﺍﻭﺩیﻭﻡ
odwak	ﺍﻭﺩﻭﺍک
odyniec	ﺍﻭﺩیﻥیﺱ
oetje	ﺍیﺕﺝ
oeycke	ﺍیک
office	ﺍﻑیﺱ
officer	ﺍﻑیﺱﺭ
ogawa	ﺍﻭگﺍﻭﺍ
ogborn	ﺍگﺏرﻥ
ogbuefi	ﺍﻭگﺏﻭﺍﻑی
ogden	ﺍگﺩﻥ
ogilvie	ﺍﻭگیﻝیﻭ
ohliger	ﺍﻭﻩﻝیگر
ohlund	ﺍﻩﻝﺍﻥﺩ
ohm	ﺍﻩﻡ
ohmaki	ﺍﻭﻡﺍکی
ohman	ﺍﻩﻡﻥ
ohmann	ﺍﻩﻡﺍﻥ
ohrman	ﺍﻭﻩﺭﻡﻥ
oickle	ﺍیکﻝ
ojaste	ﺍﺝﺍﺱﺕ
ojeda	ﺍﺝﺩﺍ
oke	ﺍک
okuda	ﺍکﻭﺩﺍ
olah	ﺍﻭﻝﺍ
olav	ﺍﻝﺍﻭ
olds	ﺍﻝﺩﺯ
ole	ﺍﻭﻝی
olea	ﺍﻝی
oleinik	ﺍﻝیﻥیک
olematon	ﺍﻝﻡﺍﺕﻭﻥ
olguin	ﺍﻝگﺍیﻥ
olhsson	ﺍﻝﺱﻥ
olin	ﺍﻝیﻥ
oliva	ﺍﻝیﻭﺍ
oliveira	ﺍﻝیﻭﺭیﺍ
oliveto	ﺍﻝیﻭﺕﻭ
olivie	ﺍﻭﻝیﻭیﻩ
olivier	ﺍﻭﻝیﻭیﺭ
olli	ﺍﻭﻝی
olnaes	ﺍﻝﻥﺍیﺱ
olney	ﺍﻝﻥی
olsen	ﺍﻝﺱﻥ
olsson	ﺍﻝﺱﺍﻥ
oltz	ﺍﻝﺕﺯ
omaggio	ﺍﻡﺍگیﻭ
omen	ﺍﻭﻡﻥ
omerov	ﺍﻡﺭﻭ
ommer	ﺍﻭﻡﺭ
oneal	ﺍﻥیﻝ
oneill	ﺍﻥیﻝ
oner	ﺍﻥﺭ
onesty	ﺍﻭﻥﺱﺕی
ong	ﺍﻭﻥگ
onosko	ﺍﻭﻥﻭﺱکﻭ
onwere	ﺍﻥﻭر
oostenbrink	ﺍﻭﺱﺕﻥﺏﺭﺍیﻥک
oostendorp	ﺍﻭﺱﺕﻥﺩﻭﺭپ
opalko	ﺍپﺍکﻭ
opdahl	ﺍﻭپﺩﺍﻝ
opiate	ﺍﻭپیﺕ
oppedal	ﺍپیﺩﺍﻝ
oram	ﺍﺭﺍﻡ
orban	ﺍﻭﺭﺏﻥ
orbi	ﺍﺭﺏی
orchard	ﺍرچﺍرﺩ
ordona	ﺍرﺩﻥﺍ
ore	ﺍﻭﺭ
oregan	ﺍﺭگﺍﻥ
orem	ﺍﻭﺭﻡ
orfanakis	ﺍﺭﻑﺍﻥﺍکیﺱ
organ	ﺍﺭگﺍﻥ
orgar	ﺍﺭگﺍﺭ
orhan	ﺍﻭﺭﻩﺍﻥ
orhun	ﺍﻭﺭﻩﺍﻥ
oriental	ﺍﻭﺭیﻥﺕﺍﻝ
original	ﺍﺭیﺝیﻥﺍﻝ
orin	ﺍﺭیﻥ
orio	ﺍریﻭ
orion	ﺍﻭﺭیﻭﻥ
oriordan	ﺍﻭﺭیﻭﺭﺩﺍﻥ
orkney	ﺍﻭﺭکﻥی
orleans	ﺍﻭﺭﻝیﻥﺯ
orman	ﺍﻭرﻡﺍﻥ
ormesporden	ﺍﻭﺭﻡﺱپﻭﺭﺩﻥ
ormond	ﺍﺭﻡﺍﻥﺩ
orne	ﺍﻭﺭﻥ
ornen	ﺍﺭﻥﻥ
orourke	ﺍﺭﺍﺭکﻩ
orpheus	ﺍﻭﺭﻑیﻭﺱ
orrell	ﺍﺭﻝ
ortiz	ﺍﺭﺕیﺯ
ortlip	ﺍﺭﺕﻝیپ
orue	ﺍﻭﺭﻭ
orval	ﺍﺭﻭﺍﻝ
orville	ﺍﻭﺭﻭیﻝ
osborn	ﺍﺯﺏرﻥ
osborne	ﺍزﺏﻭرﻥ
oseas	ﺍﻭﺱیﺯ
osen	ﺍﻭﺱﻥ
oshall	ﺍﻭﺵﺍﻝ
oshrin	ﺍﻭﺵﺭیﻥ
osku	ﺍﺱکﻭ
osland	ﺍﺱﻝﻥﺩ
osowski	ﺍﺱﻭﺱکی
ossi	ﺍﻭﺱی
ostby	ﺍﺱﺕﺏﺍی
osterhoudt	ﺍﺱﺕرﻩﻭﺕ
ostliche	ﺍﻭﺱﺕﻝیچ
ostman	ﺍﻭﺱﺕﻡﺍﻥ
ostrander	ﺍﺱﺕرﺍﻥﺩر
oswald	ﺍﺱﻭﺍﻝﺩ
ota	ﺍﺕﺍ
otaguro	ﺍﻭﺕﺍگﻭﺭﻭ
otello	ﺍﻭﺕﻝﻭ
otha	ﺍﺕﺍ
othman	ﻉثﻡﺍﻥ
otis	ﺍﻭﺕیﺱ
otmar	ﺍﺕﻡﺍﺭ
oto	ﺍﺕﻭ
ottello	ﺍﻭﺕﻝﻭ
otter	ﺍﺕﺭ
ottinger	ﺍﻭﺕیﻥگﺭ
ottmar	ﺍﺕﻡﺍر
otto	ﺍﺕﻭ
ottolini	ﺍﻭﺕﻭﻝیﻥی
ouadi	ﺍﻭﺍﺩی
oude	ﺍیﺩ
oudedelft	ﺍﺩﺩﻝﺕ
oudekirk	ﺍﺩکریک
oued	ﺍﻭﺍﺩ
ouedraogo	ﺍﻭﺩﺭگﻭ
ougouag	ﺍﻭﻕﻭﺍﻕ
ouk	ﺍﻭک
ould	ﺍﻝﺩ
ourida	ﺍﺭیﺩﺍ
oursler	ﺍﻭﺭﺱﻝﺭ
outer	ﺍﺕﺭ
ouzounis	ﺍﻭﺯﻭﻥیﺱ
overdal	ﺍﻭﻭﺭﺩﺍﻝ
overpeck	ﺍﻭﻭﺭپک
overton	ﺍﻭرﺕﻭﻥ
owchar	ﺍﻭچﺍﺭ
owen	ﺍﻭیﻥ
owens	ﺍﻭﺱﻥﺯ
owl	ﺍﻭﻝ
oxford	ﺍکﺱﻑﻭرﺩ
oxton	ﺍﻭکﺱﺕﻭﻥ
oxwell	ﺍﻭکﺱﻭﻝ
oyarce	ﺍﻭیﺍﺭﺱ
ozer	ﺍﺯر
ozgur	ﺍﻭﺯگﻭﺭ
ozmen	ﺍﻭﺯﻡﻥ
pablo	پﺍﺏﻝﻭ
pace	پیﺱ
pachiano	پﺍچیﺍﻥﻭ
pacholke	پﺍچﻭﻝکﻩ
pacific	پﺍﺱیﻑیک
paciolla	پﺍکیﻭﻝﺍ
pack	پک
packard	پﺍکﺍﺭﺩ
packer	پکﺭ
padial	پﺍﺩیﺍﻝ
padilla	پﺍﺩیﻝﺍ
padovani	پﺩﻭﻭﺍﻥی
padua	پﺍﺩﻭﺍ
pagan	پﺍﺝﺍﻥ
page	پیﺝ
pagel	پﺍگﻝ
pagett	پگﺕ
pagliaro	پﺍگﻝییﺍﺭﻭ
pai	پﺍی
paiani	پیﻥی
paiement	پیﻡﻥﺕ
painter	پیﻥﺕﺭ
pais	پیﺱ
paizis	پیﺯﺱ
pajerek	پﺝﺭک
pajunen	پﺍﺝﻭﻥﻥ
pak	پک
pakala	پﺍکﺍﻝﺍ
paks	پﺍکﺱ
pal	پﺍﻝ
palagyi	پﺍﻝﺍگی
palaio	پﻝیﻭ
palermo	پﺍﻝﺭﻡﻭ
paley	پﺍﻝی
palfrey	پﺍﻝﻑری
pallack	پﺍﻝﺍک
pallis	پﺍﻝیﺱ
palmen	پﺍﻝﻡﻥ
palmert	پﺍﻝﻡﺭﺕ
palo	پﺍﻝﻭ
palumbo	پﺍﻝﻭﻡﺏﻭ
pam	پﺍﻡ
pan	پﺍﻥ
panagos	پﺍﻥﺍگﺱ
panas	پﺍﻥﺍﺱ
panda	پﺍﻥﺩﺍ
pandian	پﺍﻥﺩیﺍﻥ
pandit	پﺍﻥﺩیﺕ
pandolfino	پﺍﻥﺩﻭﻝﻑیﻥﻭ
pandya	پﻥﺩیﺍ
pane	پیﻥ
panfil	پﺍﻥﻑیﻝ
pang	پﺍﻥگ
panico	پﺍﻥیکﻭ
panks	پﺍﻥکﺱ
pannon	پﺍﻥﻭﻥ
panon	پﺍﻥﻥ
pant	پﺍﻥﺕ
panton	پﻥﺕﻭﻥ
panvalkar	پﺍﻥﻭﺍﻝکﺭ
paolella	پﺍیﻭﻝﻝﺍ
papay	پﺍپﺍی
pape	پیپ
paplaskas	پﺍپﻝﺍﺱکﺍﺱ
papp	پﺍپ
pappalardo	پﺍپﺍﻝﺍﺭﺩﻭ
paradise	پﺭﺩیﺱ
parakh	پﺍﺭﺍک
parayil	پﺍﺭﺍیﻝ
pardes	پﺍﺭﺩﺯ
pardi	پﺍﺭﺩی
pardington	پﺍریﻥگﺕﻭﻥ
parent	پﺭﻥﺕ
parham	پﺍﺭﻩﺍﻡ
pariente	پﺭیﻥﺕ
paris	پﺍﺭیﺱ
parisi	پﺍﺭیﺱی
parker	پﺍﺭکﺭ
parkin	پﺍﺭکیﻥ
parks	پﺍﺭکﺯ
parkyn	پﺍﺭکیﻥ
parmar	پﺍﺭﻡﺍﺭ
parnass	پﺍﺭﻥﺱ
parr	پﺍر
parra	پﺍﺭﺍ
parratt	پﺍﺭﺍﺕ
parrone	پﺭﻭﻥ
parry	پﺍﺭی
parsley	پﺍﺭﺱﻝی
parsloe	پﺍرﺱﻝﻭ
parson	پﺍﺭﺱﻥ
parsons	پﺍرﺱﺍﻥز
partee	پﺍﺭﺕی
partington	پﺍﺕیﻥگﺕﻭﻥ
parton	پﺍﺭﺕﻭﻥ
partos	پﺍﺭﺕﻭﺱ
partridge	پﺍرﺕریﺝ
parvin	پﺭﻭیﻥ
pasalidis	پﺍﺱﺍﻝیﺩیﺱ
pascal	پﺍﺱکﺍﻝ
pasco	پﺍﺱکﻭ
pass	پﺍﺱ
passage	پﺱیﺝ
passier	پﺍﺱیﺭ
pastor	پﺍﺱﺕﻭر
pastore	پﺍﺱﺕﻭﺭ
pat	پﺕ
pataky	پﺍﺕﺍکی
patch	پچ
patel	پﺍﺕﻝ
patella	پﺕﻝﺍ
paterson	پﺍﺕرﺱﻭﻥ
patetta	پﺍﺕﺕﺍ
pathak	پﺍﺕﺍک
pathyil	پﺕیﻝ
pati	پﺕی
patience	پیﺵﻥﺱ
patkar	پﺕکﺭ
patocchi	پﺍﺕﻭچی
patric	پﺍﺕﺭیک
patrice	پﺍﺕﺭیﺱ
patricia	پﺍﺕﺭیﺱیﺍ
patricio	پﺍﺕریﺱیﻭ
patrick	پﺍﺕﺭیک
patrik	پﺍﺕﺭیک
patrizio	پﺍﺕﺭیﺯیﻭ
patroclus	پﺍﺕﺭﻭکﻝﻭﺱ
patsy	پﺕﺱی
patt	پﺕ
patten	پﺍﺕﻥ
patterson	پﺍﺕﺭﺱﻭﻥ
patti	پﺕی
pattis	پﺍﺕیﺱ
patton	پﺍﺕﻥ
patty	پﺕی
patuxent	پﺍﺕﻭکﺱﻥﺕ
paula	پﺍیﻭﻝﻭ
paulin	پﺍﻝیﻥ
paulo	پﺍیﻭﻝﻭ
paulse	پﺍﻝﺯ
paulsen	پﺍﻝﺱﻥ
paulson	پﺍیﻭﻝﺱﻭﻥ
paultje	پﺍیﻭﺕﻩ
paulus	پﺍﻝﻭﺱ
pautler	پﺍﻭﺕﻝﺭ
pavlik	پﺍﻭﻝیک
pavol	پﺍﻭﻝ
pax	پﺍکﺱ
paxton	پکﺱﺕﻭﻥ
payette	پیﺕ
paylyntie	پیﻝیﻥﺕی
payne	پیﻥ
paynton	پیﻥﺕﻥ
paysan	پیﺱﺍﻥ
payton	پﺍیﺕﻭﻥ
peabody	پیﺏﺍﺩی
peacock	پیکک
peade	پیﺩ
peak	پیک
peaks	پیکﺯ
pearce	پیﺭﺱ
pearl	پیﺭﻝ
pearlman	پیﺭﻝﻡﺍﻥ
pearman	پیﺭﻡﻥ
pearse	پیرﺱ
pearsen	پیﺭﺱﻥ
pearson	پیرﺱﻥ
peart	پیﺭﺕ
peasah	پیﺱﺍﻩ
pease	پیﺱ
peat	پیﺕ
pecenko	پﺱﻥکﻭ
peckman	پکﻡﻥ
peden	پﺩﻥ
pedersen	پﺩﺭﺱﻥ
pedram	پﺩﺭﺍﻡ
peed	پیﺩ
pegg	پگ
pegram	پگﺭﺍﻡ
peil	پیﻝ
peipp	پیپ
pelham	پﻝﻩﺍﻡ
pelich	پﻝیچ
pelkie	پﻝکی
pellant	پﻝﺍﻥﺕ
peller	پﻝﺭ
pelligrini	پﻝیگﺭیﻥی
peloso	پیﻝﺍﺯﻭ
pelphrey	پﻝﻑﺭی
pelt	پﻝﺕ
peltonen	پﻝﺕﻥﻥ
pemberry	پیﻡﺏری
pemberton	پﻡﺏﺭﺕﻭﻥ
pena	پیﻥﺍ
pence	پﻥﺱ
peng	پﻥگ
penington	پﻥیﻥگﺕﻭﻥ
pennebaker	پﻥﺏﺍکﺭ
penner	پﻥﺭ
penniman	پﻥیﻡﺍﻥ
pennington	پﻥیﻥگﺕﻭﻥ
penny	پﻥی
pensak	پﻥﺱﺍک
pepe	پپﻩ
pepin	پپیﻥ
pepperberg	پیپﺭﺏﺭگ
percival	پﺭﺱیﻭﺍﻝ
perdikis	پﺭﺩیکیﺱ
perdue	پرﺩﻭ
pereckas	پﺭکﺍﺱ
pereira	پیﺭیﺭﺍ
perel	پﺭﻝ
perelman	پرﻝﻡﺍﻥ
perez	پیﺭیﺯ
pering	پﺭیﻥگ
perini	پﺭیﻥی
perkins	پرکیﻥز
perler	پﺭﻝﺭ
perley	پﺭﻝی
perlman	پﺭﻝﻡﺍﻥ
perpk	پﺭپک
perrault	پﺭﺍﻝﺕ
perrin	پریﻥ
perry	پﺭی
persechini	پرﺱچیﻥی
person	پرﺱﻭﻥ
perusse	پﺭﺍﺱ
pery	پﺭی
perzl	پرﺯﻝ
peskin	پﺱکیﻥ
petch	پﺕچ
pete	پیﺕ
peter	پیﺕﺭ
peterman	پیﺕﺭﻡﻥ
petermann	پیﺕﺭﻡﻥ
peters	پیﺕﺭ
petersen	پیﺕرﺱﻥ
peterson	پیﺕﺭﺱﻭﻥ
petersson	پیﺕﺭﺱﻭﻥ
petit	پﻭﺕیﺕ
petite	پﻭﺕیﺕ
petitjean	پﺕیﺕﺝیﻥ
petitte	پﺕیﺕ
petlock	پﺕﻝﺍک
petrecca	پﺕرکﺍ
petrel	پﺕرﻝ
petren	پﺕﺭﻥ
petrich	پﺕﺭیچ
petro	پﺕﺭﻭ
petronella	پﺕرﻭﻥﻝﺍ
petrotta	پﺕرﻭﺕﺍ
petrov	پﺕﺭﻭﻑ
petrovich	پﺕﺭﻭیچ
petrow	پیﺕﺭﻭ
petry	پﺕﺭی
pettibone	پیﺕیﺏﻭﻥ
petto	پﺕﻭ
petty	پﺕی
petzold	پﺕﺯﻭﻝﺩ
pezaris	پﺯﺍﺭﺍیﺱ
phi	ﻑی
phiaxay	ﻑیﺍکﺱی
phil	ﻑیﻝ
philip	ﻑیﻝیپ
philippe	ﻑیﻝیپ
philips	ﻑیﻝیپﺱ
phill	ﻑیﻝ
phillip	ﻑیﻝیپ
philpot	ﻑیﻝپﺍﺕ
phils	ﻑیﻝﺯ
phipps	ﻑیپﺱ
phiroze	ﻑیﺭﻭﺯ
phlux	ﻑیﻝﺍکﺱ
phoenix	ﻑﻭﺍﻥیکﺱ
phoque	ﻑﻭکﻭ
phrink	ﻑﺭیﻥک
phua	پﺍﻭ
phuong	ﻑﺍﻥگ
phylos	ﻑیﻝﻭﺱ
piacentini	پیﺍﺱﻥﺕیﻥی
piatek	پیﺍﺕک
picano	پیکﺍﻥﻭ
picard	پیکﺍﺭﺩ
picasso	پیکﺍﺱﻭ
piccolboni	پیکﻭﻝﺏﻥی
piche	پیﺵﻩ
pickap	پیکﺍپ
pickard	پیکﺍﺭﺩ
pickel	پیکﻝ
pickett	پیکﺕ
pickles	پیکﻝﺱ
pickrell	پیکﺭﻝ
pickup	پیکﺍپ
pieck	پیک
piedmont	پیﺩﻡﻭﻥﺕ
pieetr	پییر
pieper	پیپﺭ
pier	پیﺭ
pieri	پییﺭی
piero	پیﺭﻭ
piers	پیﺭﺱ
pierson	پیﺭﺱﻥ
piet	پیﺕ
pieter	پیﺕر
pieternelly	پیﺕرﻥﻝی
pietje	پیﺍﺕﺝی
pigman	پیگﻡﻥ
pike	پیک
pikelner	پیکﻝﻥﺭ
pikus	پیکﺍﺱ
pilato	پیﻝﺍﺕﻭ
pilewski	پیﻝﻭﺱکی
pilhofer	پیﻝﻩﺍﻑﺭ
pillar	پیﻝﺍﺭ
pillars	پیﻝﺍﺭﺯ
pillay	پیﻝی
pillsbury	پیﻝیﺱﻥﺭی
pilvio	پیﻝﻭیﻭ
pina	پیﻥﺍ
pincelli	پیﻥﺱﻝی
pinchas	پیﻥچﺍﺯ
pinchbeck	پیﻥچﺏک
pinchera	پیﻥچﺭﺍ
pinckard	پیﻥکﺍرﺩ
pindar	پیﻥﺩﺍﺭ
pinedo	پیﻥﺩﻭ
piner	پیﻥر
pines	پﺍیﻥﺯ
pinette	پیﻥﺕﻩ
ping	پیﻥگ
pingel	پیﻥگﻝ
pingenot	پیﻥگﻥﻭﺕ
pingleton	پیﻥگﻝﺕﻥ
pinkert	پیﻥکﺭﺕ
pinkerton	پیﻥکﺭﺕﻥ
pinkham	پیﻥخﺍﻡ
pinkowitz	پیﻥکﻭﻭیﺕﺯ
pinku	پیﻥکﻭ
pinky	پیﻥکی
pinnacle	پیﻥﺍکﻝ
pinnow	پیﻥﻭ
pino	پیﻥﻭ
pins	پیﻥﺯ
pinson	پیﻥﺱﻥ
pinter	پیﻥﺕﺭ
pinto	پیﻥﺕﻭ
pinton	پیﻥﺕﻭﻥ
pinyan	پیﻥیﺍﻥ
piomelli	پیﻭﻡﻝی
pion	پیﻭﻥ
pioneers	پیﻭﻥیرﺱ
piotr	پیﻭﺕﺭ
piper	پﺍیپﺭ
pipgras	پیپگﺭﺍﺱ
piponi	پیپﻭﻥی
piran	پیﺭﺍﻥ
pirani	پیﺭﺍﻥی
pirard	پیﺭﺍﺭﺩ
pirawat	پیﺭﺍﻭﺍﺕ
pirazzi	پیرﺍﺯی
pirkko	پیﺭکﻭ
pirmann	پیرﻡﺍﻥ
piroz	پیﺭﻭﺯ
pistun	پیﺱﺕﻭﻥ
pitha	پیﺕﺍ
pitkow	پیﺕکﻭ
pitre	پﺍیﺕﺭ
pitts	پیﺕﺱ
pivnick	پیﻭﻥیک
piyush	پیﻭﺵ
piziali	پیﺯیﺍﻝی
pizolato	پیﺯﻭﻝیﺕﻭ
pizza	پیﺯﺍ
pizzi	پیﺯی
pizzini	پیﺯیﻥی
plack	پﻝﺍک
plain	پﻝیﻥ
plaine	پﻝیﻥ
plamen	پﻝﺍﻡﻥ
plante	پﻝﻥﺕﻩ
plapp	پﻝﺍپ
plastino	پﻝﺍﺱﺕیﻥﻭ
plat	پﻝﺕ
plate	پﻝیﺕ
plateau	پﻝﺍﺕیﻭ
platform	پﻝﺍﺕﻑﻭﺭﻡ
plath	پﻝﺍﺕ
plato	پﻝﺍﺕﻭ
pleasants	پﻝیﺯﻥﺕﺯ
pledger	پﻝﺩﺝﺭ
plencner	پﻝﻥکﻥﺭ
pletcher	پﻝﺕچﺭ
plinskin	پﻝیﻥﺱکیﻥ
pliske	پﻝیﺱک
pliskin	پﻝیﺱکیﻥ
ploehn	پﻝﻭﻩﻥ
plonski	پﻝﺍﻥﺱکی
plotkin	پﻝﺍﺕکیﻥ
plott	پﻝﺍﺕ
ploudre	پﻝﻭر
plumb	پﻝﺍﻡﺏ
plummer	پﻝﺍﻡﺭ
plunk	پﻝﺍﻥک
plutchak	پﻝﺍﺕچک
plyler	پﻝﺍیﺭ
poblete	پﺍﺏﻝﺕ
pogosyan	پﻭگﻭﺱیﺍﻥ
poh	پﻭﻩ
pohar	پﻭﻩﺍﺭ
pohl	پﻭﻩﻝ
point	پﻭیﻥﺕ
pointon	پﻭیﻥﺕﻭﻥ
poirier	پیﺭیﺭ
poisl	پﻭیﺱﻝ
poitras	پﻭیﺕرﺍﺱ
pokorny	پﻭکﻭﺭﻥی
poland	پﻭﻝﻥﺩ
polant	پﻭﻝﻥﺕ
polen	پﻭﻝﻥ
poling	پﻭﻝیﻥگ
polis	پﻭﻝیﺱ
politte	پﻭﻝیﺕ
polk	پﻭﻝک
pollack	پﻭﻝﺍک
pollen	پﻭﻝﻥ
polowin	پﻭﻝﻭﻭیﻥ
polsky	پﺍﻝﺱکی
polson	پﻭﻝﺱﻥ
ponder	پﺍﻥﺩﺭ
ponds	پﺍﻥﺩﺯ
pontius	پﺍﻥﺕیﻭﺱ
pool	پﻭﻝ
poole	پﻭﻝ
poore	پﻭﺭ
poosala	پﻭﺱﺍﻝﺍ
poot	پﻭﺕ
popa	پﻭپﺍ
popat	پﻭپﺍﺕ
popli	پﺍپﻝی
popovic	پﺍپﻭیک
popp	پﻭپ
poppen	پﺍپﻥ
popper	پﺍپر
poppleton	پﺍپﻝﺕﻭﻥ
porcino	پﺭﺱیﻥﻭ
porco	پﻭﺭکﻭ
porrat	پﻭﺭﺍﺕ
port	پﻭﺭﺕ
porterfield	پﻭﺭﺕﺭﻑیﻝﺩ
portillo	پﻭﺭﺕیﻝﻭ
portnoy	پﻭﺭﺕﻥﻭی
posen	پﻭﺱﻥ
posius	پﻭﺯیﻭﺱ
poso	پﻭﺱﻭ
post	پﺱﺕ
postill	پﻭﺱﺕیﻝ
postma	پﺱﺕﻡﺍ
potter	پﺍﺕﺭ
potts	پﺍﺕﺱ
poulakos	پﻭﻝﺍکﻭﺱ
poulin	پﻭﻝیﻥ
poulos	پﻭﻝﺱ
poulsen	پﺍﻭﻝﺱﻥ
poulter	پﻭﻝﺕﺭ
poutre	پﻭﺕﺭی
pouw	پﺍﻭﻭ
powell	پﺍﻭﻝ
powers	پﺍﻭرﺯ
powles	پﺍﻭﻝﺱ
poynting	پﻭیﻥﺕیﻥگ
prado	پﺭﺍﺩﻭ
prael	پﺭﺍیﻝ
prager	پﺭگﺭ
pragides	پرگیﺩﺱ
prahl	پﺭﺍﻩﻝ
praktikum	پﺭﺍکﺕیکﻭﻡ
prall	پﺭﺍﻝ
pram	پﺭﺍﻡ
pramod	پﺭﺍﻡﻭﺩ
pranav	پﺭﺍﻥﺍﻭ
pranay	پرﺍﻥﺍﻭ
prang	پرﺍﻥگ
pranke	پﺭﺍﻥک
prasad	پﺭﺍﺱﺍﺩ
prasana	پﺭﺍﺱﺍﻥﺍ
prasen	پﺭﺍﺱﻥ
prashant	پﺭﺍﺵﺍﻥﺕ
pratap	پﺭﺍﺕپ
pratchett	پﺭﺍچﺕ
prateek	پﺭﺍﺕیک
prates	پﺭﺍﺕﺱ
pratik	پرﺍﺕیک
pratiksh	پﺭﺍﺕیکﺵ
pratt	پﺭﺍﺕ
prattico	پﺭﺍﺕیکﻭ
pratts	پﺭﺍﺕﺱ
pratul	پﺭﺍﺕﻭﻝ
praveen	پﺭﺍﻭیﻥ
pravil	پﺭﺍﻭیﻝ
prayaga	پﺭﺍیﺍگﺍ
preben	پﺭﺏﻥ
preble	پﺭیﺏﻝ
prech	پﺭچ
precious	پﺭیﺵﺱ
predrag	پریﺩرگ
preedy	پﺭیﺩی
preeti	پﺭیﺕی
pregler	پﺭیگﻝﺭ
prehn	پﺭﻩﻥ
preis	پﺭیﺱ
preisler	پﺭیﺱﻝﺭ
prejean	پﺭیﺝیﻥ
prem	پﺭﻡ
premack	پﺭیﻡﺍک
premal	پﺭﻡﺍﻝ
prentice	پﺭیﻥﺕیﺱ
press	پﺭﺱ
prestero	پﺭﺱﺕﺭﻭ
presto	پرﺱﺕﻭ
preston	پﺭیﺱﺕﻭﻥ
prestrud	پﺭﺱﺕﺭﻭﺩ
prettyman	پریﺕیﻡﻥ
preuss	پﺭیﻭﺱ
prevallet	پریﻭﺍﻝﺕ
prevost	پﺭیﻭﺱﺕ
pribe	پﺭﺍیﺏ
pribyl	پریﺏیﻝ
pricing	پﺭیﺱیﻥگ
prickett	پﺭیکﺕ
prickly	پﺭیکﻝی
priest	پﺭیﺱﺕ
priestley	پﺭیﺱﺕﻝی
priestly	پﺭیﺱﺕﻝی
priluck	پریﻝﻭک
prime	پﺭﺍیﻡ
primeau	پﺭیﻡﻭ
primero	پﺭیﻡﺭﻭ
primus	پﺭیﻡیﻭﺱ
prince	پﺭیﻥﺱ
princess	پریﻥﺱﺱ
princeton	پریﻥﺱﺕﻭﻥ
prior	پﺭیﻭﺭ
priotti	پﺭییﻭﺕی
priscilla	پﺭیﺱیﻝﺍ
prisco	پﺭیﺱکﻭ
pritchard	ریچﺍرﺩ
pritchett	پﺭیچﺕ
pritish	پﺭیﺕیﺵ
pritz	پﺭیﺕﺯ
private	پﺭﺍیﻭیﺕ
priven	پﺭﺍیﻭﻥ
priya	پﺭیﺍ
proctor	پﺭﺍکﺕﻭﺭ
progetto	پﺭﻭگﺕﻭ
projet	پﺭﻭﺝﺕ
promontory	پﺭﻭﻡﻭﻥﺕﻭﺭی
prong	پﺭﺍﻥگ
prongs	پﺭﺍﻥگﺱ
proos	پﻭﺭﻭﺱ
propes	پﺭﻭپﺱ
prothero	پﺭﻭﺕﺭﻭ
protus	پﺭﻭﺕﻭﺱ
provan	پﺭﻭﺍﻥ
providakes	پرﻭﻭیﺩیکﺱ
provo	پﺭﻭﻭ
provost	پﺭﻭﻭﺱﺕ
prowell	پﺭﺍﻭﻝ
proy	پرﻭی
pruemmer	پﺭﻭﺍﻡﺭ
prupis	پﺭﺍپیﺱ
prush	پﺭﺍﺵ
prusik	پﺭﻭﺱیک
pruss	پﺭﻭﺱ
pruy	پﺭﻭی
pryor	پﺭیﻭﺭ
psycho	پﺱیکﻭ
psyko	ﺱﺍیکﻭ
puah	پﻭﺍ
puckett	پﺍکﺕ
puelma	پﻭﺍﻝﻡﺍ
puga	پﻭگﺍ
pugh	پیﻭ
pugliese	پﺍگﻝیﺱ
pugsley	پﺍگﺱﻝی
puha	پﻭﻩﺍ
puhan	پﻭﻩﺍﻥ
pui	پییﻭ
pulford	پﺍﻝﻑﻭﺭﺩ
pulgar	پﻭﻝگﺍﺭ
pulido	پﺍﻝیﺩﻭ
pulley	پﺍﻝی
pulliam	پﻭﻝییﺍﻡ
puma	پﻭﻡﺍ
pumfrey	پﺍﻡﻑری
puna	پﻭﻥﺍ
punjabi	پﺍﻥﺝﺍﺏی
punnoose	پﻭﻥﻭﺯ
punton	پﻭﻥﺕﻭﻥ
punzelt	پﺍﻥﺯﻝﺕ
puolakka	پﻝﺍکﺍ
puppie	پﻭپی
purahoo	پﻭﺭﺍﻩﻭ
puranik	پﻭﺭﺍﻥیک
purcell	پﺍﺭﺱﻝ
purchase	پﺭچیﺱ
purewal	پﻭرﻭﺍﻝ
purinton	پیﻭﺭیﻥﺕﻥ
purnell	پﺭﻥﻝ
pursell	پﺭﺱﻝ
purshottam	پﺭﺵﺍﺕﺕﺍﻡ
pursley	پﺭﺱﻝی
purvis	پﺭﻭیﺱ
puryear	پﻭﺭیﺭ
putkonen	پﻭﺕکﻭﻥﻥ
putnick	پﺍﺕﻥیک
putz	پﻭﺕﺯ
puusaari	پﻭﺱﺍﺭی
pyers	پﺍیﺭﺱ
pyle	پﺍیﻝ
pylestone	پیﻝﺱﺕﻥ
pype	پﺍیپ
pyramid	پیﺭﺍﻡیﺩ
pytlik	پیﺕﻝیک
qadir	کﺩیر
qadira	کﺩیرﺍ
qadisiyah	کﺩیﺱیﺍ
qasim	کﺱیﻡ
qitarah	کیﺕﺍرﺍ
quackenboss	کﻭکﻥﺏﺍﺱ
quainton	کﻭییﻥﺕﻭﻥ
quale	کییﻭﺍﻝ
quartzite	کﻭﺍﺭﺕﺯیﺕﻩ
quasar	کﻭثﺭ
quasim	کﺱیﻡ
quast	کﻭیﺱﺕ
quatrain	کﻭﺍﺕﺭیﻥ
qubilah	کﻭﺏیﻝﺍ
qudamah	کﻭﺩﺍﻡﺍ
que	کﻭیی
quel	کﻭیﻝ
quemada	کﻭیﻡﺍﺩﺍ
quesada	کﻭﺱﺍﺩﺍ
quezon	کیﻭﺯﻭﻥ
quickle	کﻭییکﻝ
quigley	کﻭییگﻝی
quilici	کﻭﺍیﻝیﺱی
quillin	کﻭییﻝیﻥ
quin	کﻭیﻥ
quinby	کﻭﺍﻥﺏﺍی
quinlan	کﻭییﻥﻝﻥ
quinn	کﻭیﻥ
quinnan	کﻭییﻥﺍﻥ
quint	کﻭیﻥﺕ
quintana	کﻭیﻥﺕﺍﻥﺍ
quintanar	کﻭییﻥﺕﺍﻥﺍﺭ
quist	کﻭییﺱﺕ
quitt	کﻭییﺕ
quixote	کﻭیکﺱﺕ
qun	کﺍﻥ
qunaytirah	کﻥیﺕرﺍﻩ
quoc	کﻭک
quock	کیﻭک
quodling	کﺍﻭﺩﻝیﻥگ
raba	ﺭﺍﺏﺍ
rabab	رﺏﺍﺏ
rabbit	رﺏیﺕ
rabel	ﺭﺍﺏﻝ
rabenau	ﺭﺍﺏﻥﺍﻭ
rabiah	رﺍﺏیﻉﻩ
rabkin	ﺭﺍﺏکیﻥ
raboel	ﺭﺍﺏﻭیﻝ
rabold	ﺭﺍﺏﻝﺩ
raby	ﺭﺍﺏی
racecar	ﺭیﺱکﺍﺭ
rachael	ﺭﺍچﻝ
rachel	ﺭﺍﺵﻝ
racho	ﺭﺍکﻭ
racicot	ﺭﺍکیکﻭﺕ
rad	ﺭﺍﺩ
radajkin	رﺍﺩﺍﺝکیﻥ
radbone	رﺍﺩﺏﻭﻥ
radboud	ﺭﺍﺩﺏﻭﺩ
radenburch	ریﺩﻥﺏرچ
radenburgarebroke	ریﺩﻥﺏرگیرﺏرﻭک
radenburgerabroek	ریﺩﻥﺏرگیرﺏرﺍک
rader	ﺭﺍﺩﺭ
radev	ﺭﺍﺩیﻭ
radeyah	رﺍﺩیﺍﻩ
radford	رﺍﺩﻑرﺩ
radha	ﺭﺍﺩﻩﺍ
radhika	ﺭﺍﺩﻩیکﺍ
radig	ﺭﺍﺩیﻥگ
radov	ﺭﺍﺩﻭﻑ
radwa	رﺍﺩﻭﺍ
rafa	رﺍﻑﺍ
rafael	ﺭﺍﻑیﻝ
rafal	ﺭﺍﻑﺍﻝ
rafalko	ﺭﺍﻑﺍﻝکﻭ
rafalski	ﺭﺍﻑﺍﻝﺱکی
rafat	ﺭﻑﻉﺕ
raffel	رﺍﻑﻝ
raffin	ﺭﺍﻑیﻥ
rafi	ﺭﺍﻑی
rafique	ﺭﺍﻑیکیﻭ
raftis	رﺍﻑﺕیﺱ
ragan	ﺭیگﺍﻥ
ragas	ﺭﺍگﺍﺯ
ragatz	ﺭﺍگﺍﺕﺯ
raghd	رﻍﺩ
ragland	ﺭﺍگﻝﻥﺩ
ragle	ﺭﺍگﻝ
ragnar	ﺭﺍگﻥﺍﺭ
ragnarsson	ﺭﺍگﻥﺍﺭﺱﻭﻥ
ragnemalm	رﺍگﻥﻡﺍﻝﻡ
ragnhild	ﺭﺍگﻥﻩیﺩ
ragsdale	ﺭﺍگﺱﺩیﻝ
rahardjo	ﺭﺍﻩﺍﺭﺝﻭ
rahi	ﺭﺍﻩی
rahim	ﺭﺡیﻡ
rahimah	رﺡیﻡﺍﻩ
rahul	ﺭﺍﻩﻭﻝ
rai	ﺭﺍی
raicer	ﺭیﺱﺭ
raidah	ریﺩﺍ
raile	ﺭﺍیﻝی
railsback	ﺭیﻝﺱﺏک
railway	ﺭﺍیﻝﻭی
raimond	ﺭیﻡﻭﻥﺩ
raimund	ﺭیﻡﻭﻥﺩ
rain	ﺭیﻥ
rainald	ﺭیﻥﺍﻝﺩ
rainey	ﺭیﻥی
rainford	ریﻥﻑﻭرﺩ
raistlin	ﺭﺍیﺱﺕﻝیﻥ
raivo	ﺭیﻭﻭ
raiyze	رﺍیﺯﻩ
raizel	ﺭﺍیﺯﻝ
raj	ﺭﺍﺝ
raja	رﺍﺝﺍ
rajan	رﺍﺝﺍﻥ
rajas	ﺭﺝﺍﺱ
rajat	ﺭﺝﺍﺕ
rajcher	ﺭﺍﺝچﺭ
rajeev	ﺭﺍﺝیﻭ
rajender	ﺭﺍﺝﻥﺩﺭ
rajendra	ﺭﺍﺝﻥﺩﺭﺍ
rajendran	رﺍﺝﻥﺩرﺍﻥ
raju	ﺭﺍﺝﻭ
rakita	ﺭﺍکیﺕﺍ
ralf	ﺭﺍﻝﻑ
ralph	ﺭﺍﻝﻑ
ralphe	رﺍﻝﻑ
ralston	رﺍﻝﺱﺕﻭﻥ
ram	ﺭﺍﻡ
rama	ﺭﺍﻡﺍ
ramani	ﺭﺍﻡﺍﻥی
rambo	ﺭﺍﻡﺏﻭ
ramdas	ﺭﺍﻡﺩﺍﺱ
ramer	ﺭﺍﻡﺭ
ramesh	ﺭﺍﻡﺵ
ramez	ﺭﺍﻡﺯ
rami	ﺭﺍﻡی
ramin	رﺍﻡیﻥ
ramirez	ﺭﺍﻡیﺭﺯ
ramiro	ﺭﺍﻡیﺭﻭ
ramm	ﺭﺍﻡ
ramos	ﺭﺍﻡﻭﺱ
rampling	ﺭﻡپﻝیﻥگ
ramsay	رﺍﻡﺱی
ramsey	ﺭﺍﻡﺱی
ramthun	ﺭﺍﻡﺕﺍﻥ
rana	رﺍﻥﺍ
randal	ﺭﺍﻥﺩﺍﻝ
randell	ﺭﺍﻥﺩﻝ
rander	ﺭﺍﻥﺩﺭ
randhol	ﺭﻥﺩﻩﻝ
randle	رﺍﺩﻝ
randolph	رﺍﻥﺩﻭﻝﻑ
randy	ﺭﻥﺩی
rane	ﺭیﻥ
range	ﺭﻥگ
rankine	ﺭﻥکیﻥ
rannou	ﺭﺍﻥﻭ
ransom	رﻥﺱﻭﻡ
ranta	ﺭﺍﻥﺕﺍ
ranu	ﺭﺍﻥیﻭ
rao	ﺭﺍیﻭ
raoult	ﺭﺍﻭﻝﺕ
raqqah	رککﺍﻩ
rasalingam	ﺭﺱﻝیﻥگﺍﻡ
raschke	ﺭﺍﺵکﻩ
rasha	رﺍﺵﺍ
rashed	ﺭﺍﺵﺩ
rashid	ﺭﺍﺵیﺩ
raskin	ﺭﺍﺱکیﻥ
raso	ﺭﺍﺱﻭ
rastin	ﺭﺍﺱﺕیﻥ
rasu	ﺭﺍﺱﻭ
rasul	ﺭﺱﻭﻝ
rat	ﺭﺕ
ratanvel	ﺭﺍﺕﺍﻥﻭﻝ
ratcliffe	ﺭﺕکﻝیﻑ
rath	ﺭﺍث
ratsaby	ﺭﺍﺕﺱﺍﺏی
rattray	ﺭﺍﺕﺭﺍی
rauh	ﺭﺍﻭ
rauser	رﺍﻭﺱر
rautiala	ﺭﺍیﻭﺕیﺍﻝﺍ
ravey	ﺭﺍﻭی
ravi	ﺭﺍﻭی
ravindran	ﺭﺍﻭیﻥﺩﺭﺍﻥ
ravine	رﺍﻭﺍیﻥ
ravis	رﺍﻭیﺱ
rawdah	رﺍﻭﺩﺍ
rawdon	ﺭﺍیﻭﺩﺍﻥ
rawiyah	رﺍﻭیﺍﻩ
rawlings	ﺭﺍیﻭﻝیﻥگﺯ
rawlins	رﺍﻭﻝیﻥﺱ
ray	ﺭی
raybould	ﺭیﺏﻭﻝﺩ
rayburn	ﺭیﺏﺭﻥ
rayer	ﺭییﺭ
rayle	ﺭﺍیﻝﻩ
raymond	ﺭیﻡﻥﺩ
rayner	ﺭﺍیﻥﺭ
raynesford	ریﻥﺱﻑرﺩ
rayya	رییﺍ
razdan	ﺭﺍﺯﺩﺍﻥ
razmara	رﺍﺯﻡرﺍ
razorback	ﺭﺍﺯﻭﺭﺏک
rbeis	ﺭﺏیﺱ
read	ﺭیﺩ
reade	ریﺩ
reagle	ریگﻝﻩ
reamy	ﺭیﻡی
reap	ریپ
reardon	ﺭیﺭﺩﺍﻥ
rears	ﺭیﺭﺯ
reaser	ﺭیﺱﺭ
reasor	ﺭیﺱﻭﺭ
reavis	ﺭیﻭیﺱ
reavy	ﺭیﻭی
reback	ﺭیﺏک
reboso	ﺭﺏﻭﺱﻭ
rechelle	ﺭﺵﻝ
reckdahl	ﺭکﺩﺍﻝ
reda	ﺭیﺩﺍ
reddy	ﺭﺩی
redfield	ﺭﺩﻑیﻝﺩ
redhill	ﺭﺩﻩیﻝ
redin	ریﺩیﻥ
redlus	ﺭﺩﻝﻭﺱ
redman	ﺭﺩﻡﻥ
redmill	ﺭﺩﻡیﻝ
redmond	ﺭﺩﻡﺍﻥﺩ
reece	ریﺱ
reed	ﺭییﺩ
reedy	ریﺩی
reef	ریﻑ
reenalda	ریﻥﺍﻝﺩﺍ
rees	ریﺯ
reese	ﺭیﺯ
reetz	ﺭیﺕﺯ
refsnes	ﺭﻑﺱﻥﺱ
refson	ﺭﻑﺱﻭﻥ
reg	ﺭﺝ
regard	ﺭیگﺍﺭﺩ
reginald	رگیﻥﺍﻝﺩ
rehan	ریﺡﺍﻥ
rehling	ﺭﻩﻝیﻥگ
reid	ﺭیﺩ
reidy	ﺭیﺩی
reierson	ﺭیﺭﺱﻭﻥ
reiland	ﺭیﻝﻥﺩ
reilley	ﺭیﻝی
reimer	ریﻡر
reinders	ﺭیﻥﺩﺭﺯ
reindert	ریﻥﺩرﺕ
reinhart	ریﻥﻩﺍرﺕ
reininger	ریﻥیﻥگر
reinold	ﺭیﻥﻭﻝﺩ
reinolda	ریﻥﻝﺩﺍ
reirdan	ریرﺩﺍﻥ
reise	ﺭیﺱ
reiser	ﺭیﺯﺭ
reisner	ﺭیﺱﻥﺭ
reiss	ﺭیﺱ
reissner	ﺭیﺱﻥﺭ
reiter	ﺭیﺕﺭ
reksten	ﺭکﺱﺕﻥ
remde	ﺭﻡﺩ
remlinger	ﺭﻡﻝیﻥگﺭ
rempfer	ﺭﻡﻑﺭ
remy	ﺭﻡی
ren	رﻥ
renault	ﺭﻥﺍﻝﺕ
renee	رﻥی
rennebarth	ﺭﻥﺏﺍﺭﺕ
renvoise	ﺭﻥﻭیﺱ
renze	ﺭﻥﺯ
renzland	ﺭﻥﺯﻝﻥﺩ
reodique	ﺭیﺩیگ
repenning	ﺭپﻥیﻥگ
replogle	ﺭپﻝﺍگﻝ
repp	ﺭپ
republic	ﺭیپﺍﺏﻝیک
research	ﺭیﺱﺭچ
resele	ﺭﺱﻝ
resnick	ﺭیﺱﻥیک
resolveert	رزﻭﻝﻭرﺕ
resonate	ﺭﺱﻭﻥﺍﺕ
rest	ﺭﺱﺕ
resyntje	رزیﻥﺕ
retzer	ﺭیﺕﺯﺭ
reuber	ﺭیﻭﺏﺭ
reuter	ﺭیﻭﺕﺭ
revelo	ﺭﻭﻝﻭ
revuluri	ﺭﻭﻭﻝﻭﺭی
rey	ﺭی
reyden	ﺭیﺩﻥ
reyes	ﺭیﺱ
reynolds	ﺭیﻥﺍﻝﺩﺯ
reynoldson	ﺭیﻥﻭﻝﺩﺱﻭﻥ
rheni	رﻥی
rhine	ریﻥ
ribar	ﺭیﺏﺍﺭ
ribeiro	ﺭیﺏیﺭﻭ
ribner	ﺭیﻥﺭ
richar	ﺭیچﺍﺭ
richardson	ریچﺍرﺩﺱﻥ
richau	ﺭیچﺍﻭ
richbourg	ﺭیچﺏﻭﺭگ
richer	ﺭیچﺭ
richey	ﺭیچی
richmann	ﺭیچﻡﻥ
richmond	ﺭیچﻡﻭﻥﺩ
richter	ریچﺕر
rick	ﺭیک
rickard	ﺭیکﺍﺭﺩ
ricker	ﺭیکﺭ
rickert	ﺭیکﺭﺕ
ricketts	ﺭیکﺕﺯ
ricky	ﺭیکی
rida	ریﺩﺍ
ridd	ریﺩ
riddle	ﺭیﺩﻝ
rider	ﺭﺍیﺩﺭ
ridge	ﺭیگ
riedel	ﺭﺍیﺩﻝ
riehle	ﺭیﻩﻝ
riemens	ﺭیﻡﻥﺯ
riemers	ﺭیﻡﺭﺱ
rienks	ﺭییﻥکﺱ
riepe	ﺭﺍیپ
riese	ﺭیﺱ
riessen	ﺭییﺱﻥ
riffle	ﺭﺍیﻑﻝ
rifkind	ﺭیﻑکﺍیﻥﺩ
riggs	ﺭیگﺯ
rights	ﺭﺍیﺕﺯ
rigler	ﺭیگﻝﺭ
rigo	ﺭیگﻭ
rihana	ریﺡﺍﻥﺍ
rijckloff	ریچﻝﻑ
rijswijk	ریﺝﺱﻭیک
riley	ریﻝی
rim	ﺭیﻡ
rimek	ﺭیﻡک
rimoni	ﺭﻡﻭﻥی
rimple	ریﻡپﻝ
rindner	ﺭیﻥﺩﻥﺭ
rinehart	ریﻥیﻩﺍرﺕ
ring	ﺭیﻥگ
ringenalda	ریﻥگﻥﺍﻝﺩﺍ
ringuest	ﺭیﻥگﺱﺕ
ringwood	ﺭیﻥگﻭﻭﺩ
rinker	ﺭیﻥکﺭ
rinn	ﺭیﻥ
rinne	ﺭیﻥﻩ
riolo	ﺭیﻭﻝﻭ
riopka	ﺭیﻭپکﺍ
riordon	ﺭیﺭﺩﺍﻥ
rippel	ﺭیپﻝ
rischar	ﺭیﺵﺍﺭ
risel	ﺭﺍیﺱﻝ
rishah	ﺭیﺵﺍﻩ
risk	ریﺱک
risley	ﺭیﺱﻝی
risto	ﺭیﺱﺕﻭ
rita	ﺭیﺕﺍ
ritchie	ﺭیچی
ritsgert	ریﺕزگرﺕ
ritter	ﺭیﺕﺭ
rittle	ﺭیﺕﻝ
rittweger	ﺭیﺕﻭگﺭ
rivas	ﺭیﻭﺍﺱ
river	ﺭیﻭﺭ
rivest	ﺭیﻭﺱﺕ
riviera	ﺭیﻭیﺭ
rixon	ﺭیکﺱﻭﻥ
riyad	رییﺍﺩ
rizvi	ﺭیﺯﻭی
roa	ﺭﻭ
roach	ﺭﻭچ
roads	ﺭﻭﺩﺯ
roar	ﺭﻭﺭ
roarty	رﻭﺕی
roath	ﺭﻭﺕ
robb	ﺭﺍﺏ
robbie	ﺭﺍﺏی
robbin	ﺭﺍﺏیﻥ
robbins	ﺭﻭﺏیﻥﺯ
robbs	ﺭﺍﺏﺱ
robby	ﺭﺍﺏی
roberge	ﺭﻭﺏﺭﺝ
robert	ﺭﺍﺏﺭﺕ
roberta	ﺭﻭﺏﺭﺕﺍ
roberto	ﺭﻭﺏﺭﺕﻭ
roberts	ﺭﺍﺏﺭﺕﺯ
robertshaw	رﺍﺏرﺕﺵﺍﻭ
robertson	ﺭﺍﺏﺭﺕﺱﻥ
robertsson	ﺭﺍﺏﺭﺕﺱﻭﻥ
robey	ﺭﺍﺏی
robideaux	ﺭﺍﺏیﺩیﺍکﺱ
robijn	ﺭﺍﺏیﺝﻥ
robillard	ﺭﻭﺏیﻝﺍﺭﺩ
robins	رﺍﺏیﻥﺯ
robinson	ﺭﺍﺏیﻥﺱﻥ
robison	رﺍﺏیﺱﻥ
roboz	ﺭﻭﺏﻭﺯ
rocca	ﺭﻭکﺍ
roch	ﺭﺍک
roche	ﺭﻭچ
rochkind	رﺍچکیﻥﺩ
rock	رﺍک
rocke	رﺍک
rockel	ﺭﺍکﻝ
rockwell	ﺭﺍکﻭﻝ
rodberg	ﺭﺍﺩﺏﺭگ
roder	ﺭﺍﺩﺭ
roderick	ﺭﺩﺭیک
rodgers	ﺭﺍﺝﺭﺯ
rodman	ﺭﺍﺩﻡﻥ
rodrigue	ﺭﻭﺩﺭیگﻭ
rodriguez	ﺭﻭﺩﺭیگﺯ
roe	ﺭﻭ
roeber	ﺭﻭﺏﺭ
roebuck	ﺭیﺏﺍک
roeder	رﻭﺩر
roedolf	ریﺩﻝﻑ
roehr	ﺭﻭﻩﺭ
roehrig	ﺭﺍﻩﺭیگ
roemer	ﺭﺍﻡﺭ
roepcke	ﺭﻭیپک
roesner	ﺭﻭﺍﺯﻥﺭ
roessler	رﻭیﺱﻝر
roff	ﺭﺍﻑ
rogalsky	ﺭﻭگﺍﻝﺱکی
rogan	رﻭگﺍﻥ
roger	ﺭگﺭ
rognerud	ﺭﺍگﻥﺭﺩ
rogoff	ﺭﺍﺝﻑ
rogoza	ﺭﻭگﻭﺯﺍ
rohbeck	ﺭﺍﻩﺏک
rohde	ﺭﻭﺩ
rohleder	ﺭﻭﻩﻝﺩﺭ
rohm	ﺭﻭﻩﻡ
rohn	ﺭﺍﻥ
rohrer	ﺭﺍﻩﺭﺭ
roimata	ﺭﻭیﻡﺍﺕﺍ
rojas	ﺭﺍﺝﺱ
rokicki	ﺭﻭکیکی
roland	ﺭﻭﻝﻥﺩ
roldan	ﺭﻭﻝﺩﺍﻥ
rolfe	رﺍﻝﻑ
rolff	ﺭﻭﻝﻑ
rolison	ﺭﻭﻝیﺱﻭﻥ
roll	ﺭﻭﻝ
rollin	ﺭﺍﻝیﻥ
rollins	ﺭﺍﻝیﻥﺯ
rolls	رﻭﻝﺯ
romanchik	ﺭﻡﻥچیک
romanelli	رﻭﻡﺍﻥﻝی
romano	رﻭﻡﺍﻥﻭ
romans	ﺭﻡﻥﺱ
romero	ﺭﻭﻡیﻭ
romig	ﺭﻭﻡیگ
rommel	ﺭﻭﻡﻝ
ron	ﺭﺍﻥ
ronald	ﺭﻭﻥﺍﻝﺩ
ronda	ﺭﻭﻥﺩﺍ
rondane	ﺭﻭﻥﺩیﻥ
ronde	ﺭﻭﻥﺩﻩ
ronit	ﺭﻭﻥیﺕ
ronkin	ﺭﺍﻥکیﻥ
ronne	ﺭﺍﻥ
ronnie	ﺭﺍﻥی
ronny	ﺭﺍﻥی
rontgen	ﺭﺍﻥﺕگﻥ
rony	ﺭﺍﻥی
rood	ﺭﻭﺩ
roode	ﺭﻭﺩ
roodenburg	رﻭﺩﻥﺏرگ
rookery	ﺭﻭکﺭی
rooks	ﺭﻭکﺯ
rooney	ﺭﻭﻥی
roosevelt	رﻭزﻭﻝﺕ
root	ﺭﻭﺕ
rootes	ﺭﻭﺕﺱ
roots	رﻭﺕﺱ
rooyen	ﺭﻭیﻥ
ropebrake	ﺭﺍپﺏﺭیک
roper	ﺭﺍپﺭ
roquemore	رکﻭیﻡﻭر
rory	ﺭﻭﺭی
rosa	ﺭﻭﺱﺍ
rosaire	ﺭﻭﺯیﺭ
rosalyn	ﺭﻭﺱﺍﻝیﻥ
rosana	ﺭﻭﺱﺍﻥﺍ
rosanna	رﻭﺱﺍﻥﺍ
rosanova	ﺭﻭﺱﺍﻥﻭﺍ
rosario	ﺭﻭﺯﺍﺭیﻭ
roscoe	ﺭﻭکﻭ
rosella	ﺭﻭﺱﻝﺍ
rosemary	ﺭﻭﺯﻡﺍﺭی
rosen	ﺭﻭﺯﻥ
rosenblatt	ﺭﻭﺱﻥﺏﻝﺍﺕ
rosencrans	ﺭﺯﻥکﺭﺍﻥﺱ
rosendale	رﺍﺱﻥﺩیﻝ
rosenfelder	ﺭﻭﺯﻥﻑﻝﺩﺭ
rosenheim	ﺭﻭﺯﻥﻩیﻡ
rosenjack	ﺭﻭﺯﻥﺝک
rosenlof	ﺭﺯﻥﻝﻑ
rosenman	ﺭﺍﺱﻥﻡﺍﻥ
rosenthal	ﺭﻭﺯﻥﺕﺍﻝ
rosham	ﺭﻭﺵﺍﻡ
rosie	ﺭﻭﺯی
rosita	ﺭﻭﺯیﺕﺍ
roskens	رﻭﺱکﻥﺱ
roslin	ﺭﻭﺯﻝیﻥ
roslyn	ﺭﻭﺱﻝیﻥ
rospach	رﻭﺱپﺍچ
rosselin	ﺭﻭﺱﻝیﻥ
rossen	ﺭﺍﺯﻥ
rosser	ﺭﻭﺱﺭ
rossiter	ﺭﻭﺱیﺕﺭ
rossmeissl	ﺭﺯﻡیﺱﻝ
rossner	ﺭﻭﺱﻥﺭ
rosson	ﺭﻭﺱﻭﻥ
rossum	ﺭﺍﺱﻭﻡ
rostad	ﺭﻭﺱﺕﺍﺩ
roston	ﺭﺍﺱﺕﻥ
rostrom	ﺭﺍﺱﺕﺭﺍﻡ
rosu	ﺭﻭﺱﻭ
roth	ﺭﺍث
rothe	ﺭﻭﺕ
rothera	ﺭﺍﺕﺭﺍ
rothman	رﺍﺕﻡﻥ
rotiala	ﺭﻭﺱیﺍﻝﺍ
rotz	ﺭﻭﺕﺯ
rouen	ﺭﻭیﻥ
rougeaux	رﺍگیﻭکﺱ
roughton	ﺭﺍگﺕﺍﻥ
roukan	رﻭکﺍﻥ
roullin	ﺭﻭﻝیﻥ
roumfort	ﺭﻭﻡﻑﻭﺭﺕ
round	رﻭﻥﺩ
roundel	ﺭﻭﻥﺩﻝ
rountree	ﺭﻭﻥﺕﺭی
rourke	ﺭﺍﺭک
rouse	ﺭﺍﻭﺱ
roush	ﺭﻭﺵ
rousseau	رﻭﺱیﻭ
rout	ﺭﺍﻭﺕ
route	ﺭﻭﺕ
routh	ﺭﻭث
roux	ﺭﺍکﺱ
rov	ﺭﺍﻭ
rover	رﺍﻭر
roving	ﺭﺍﻭیﻥگ
rovner	ﺭﺍﻭﻥﺭ
row	رﻭ
rowan	ﺭﻭﺍﻥ
rowbottom	ﺭﺍﻭﺏﺍﺕﻡ
rowell	رﺍﻭﻝ
rowett	ﺭﻭﺕ
rowland	رﺍﻭﻝﻥﺩ
rowles	ﺭﻭﻝﺱ
roworth	ﺭﺍﻭﺭﺕ
rowsome	ﺭﻭﺱﺍﻡ
roxanna	ﺭﻭکﺱﺍﻥﺍ
roxanne	ﺭﻭکﺱﺍﻥ
roxsan	ﺭﻭکﺱﺍﻥ
roy	ﺭﻭی
royappa	ﺭﻭیﺍپﺍ
royce	ﺭﺍیﺱ
royden	ﺭﻭیﺩﻥ
royle	ﺭﻭیﻝ
royse	ﺭﻭیﺱ
roytenberg	ﺭﻭیﺕﻥﺏﺭگ
roze	ﺭﻭﺯ
rozenbaum	رﻭﺯﻥﺏﺍﻭﻡ
rozier	ﺭﻭﺯیﺭ
rubb	ﺭﺍﺏ
ruben	ﺭﺍﺏﻥ
rubin	ﺭﺍﺏیﻥ
rubino	رﺍﺏیﻥﻭ
ruckle	ﺭﺍکﻝ
ruckman	رﺍکﻡﻥ
ruddy	ﺭﺍﺩی
rudewig	ﺭﺍﺩﻭیگ
rudley	ﺭﺍﺩﻝی
rudnick	ﺭﺍﺩﻥیک
rudolphus	رﺍﺩﻭﻝﻑﺱ
rudramuni	ﺭﺍﺩﺭﺍﻡﻭﻥی
rue	ﺭﻭ
rueden	ﺭﻭیﺩﻥ
ruediger	رﺍﺩیﺝر
rueger	رﺍﺝر
ruehr	ﺭﻭﻩﺭ
rueter	ﺭﻭﺍﺕﺭ
ruey	ﺭﻭﺍی
ruff	رﺍﻑ
ruffin	رﺍﻑیﻥ
ruffner	ﺭﺍﻑﻥﺭ
ruffus	رﺍﻑﻭﺱ
ruiz	رﻭز
rukan	رﺍکﻭﻥ
ruley	رﻭﻝی
rumble	ﺭﺍﻡﺏﻝ
rump	رﺍﻡپ
rumph	ﺭﻭﻡﻑ
rumple	ﺭﺍﻡپﻝ
rumsey	ﺭﺍﻡﺯی
rund	رﺍﻥﺩ
rundle	ﺭﺍﻥﺩﻝ
runeson	ﺭیﻭﻥﺱﻭﻥ
runner	ﺭﺍﻥﺭ
runyan	رﺍﻥیﺍﻥ
rupe	ﺭﻭپ
rupert	ﺭﻭپﺭﺕ
rusbasan	ﺭﺍﺱﺏﺱﻥ
rush	ﺭﺍﺵ
rushforth	ﺭﺍﺱﻑﻭﺭﺩ
rusk	ﺭﺍﺱک
ruspini	ﺭﺍﺱپیﻥی
russ	ﺭﺍﺱ
russel	رﺍﺱﻝ
russo	ﺭﺍﺱﻭ
rust	ﺭﺍﺱﺕ
rusty	ﺭﺍﺱﺕی
ruta	رﻭﺕﺍ
rutabaga	ﺭﻭﺕﺍﺏﺍگﺍ
rutgert	رﺍﺕگرﺕ
ruth	ﺭﺍث
rutherford	ﺭﺍﺕﺭﻑﻭﺭﺩ
rutks	ﺭﺍﺕکﺱ
rutman	ﺭﻭﺕﻡﻥ
rya	ﺭیﺍ
rybicki	ﺭیﺏیکی
rybolt	ﺭﺍیﺏﻝﺕ
ryden	ﺭﺍیﺩﻥ
rydland	ﺭیﺩﻝ»¥ﺩ
ryherd	ﺭیﻩﺭﺩ
rykaa	ریکﺍ
rymill	ریﻡیﻝ
rymon	ﺭیﻡﻭﻥ
rynders	ﺭیﻥﺩﺭﺱ
rysavy	ﺭیﺱﺍﻭی
rysdam	ریﺱﺩﺍﻡ
rysling	ﺭیﺱﻝیﻥگ
ryu	ﺭیﻭ
rywalt	ریﻭﺍﻝﺕ
ryzman	ﺭﺍیﺯﻡﻥ
rzepela	ﺭﺯپﻝﺍ
saartje	ﺱرﺝﻩ
sabine	ﺱﺍﺏیﻥ
sabini	ﺱﺍﺏیﻥی
sabirah	ﺱﺏیرﺍﻩ
sabourin	ﺱﺍﺏﻭﺭیﻥ
sabra	ﺱﺏرﺍ
sackett	ﺱکﺕ
sacks	ﺱﺍکﺱ
sackton	ﺱﺍکﺕﻥ
saddique	ﺱﺍﺩیک
sadgrove	ﺱﺍگرﻭ
sadira	ﺱﺩیرﺍ
sadler	ﺱﺍﺩﻝﺭ
sadow	ﺱﺍﺩﻭ
safoutin	ﺱﺍﻑﺕیﻥ
sagady	ﺱﺝﺍﺩی
sage	ﺱیگ
sahara	ﺱﺍﺡﺍرﺍ
sahasi	ﺱﺍﻩﺍﺱی
sahib	ﺱﻩیﺏ
sahl	ﺱﻩﻝ
sahni	ﺱﻩﻥی
sahr	ﺱﺍﺭ
said	ﺱﻉیﺩ
saida	ﺱیﺩﺍ
saidi	ﺱﻉیﺩی
sailer	ﺱیﻝر
saint	ﺱﻥﺕ
sakamoto	ﺱﺍکﺍﻡﻭﺕﻭ
sakaue	ﺱﺍکﺍیﻭ
sakinah	ﺱکیﻥﻩ
saklad	ﺱﺍکﻝﺍﺩ
saklani	ﺱکﻝﺍﻥی
sakr	ﺱﺍکﺭ
salahaddin	ﺱﻝﺍیﺩیﻥ
salanne	ﺱﺍﻝیﻥ
salay	ﺱﺍﻝﺍی
saley	ﺱیﻝی
salfi	ﺱﻝﻑی
salgueiro	ﺱﺍﻝگﻭﺭﻭ
salian	ﺱﺍﻝیﺍﻥ
sallach	ﺱﺍﻝﺍچ
salma	ﺱﻝﻡی
salman	ﺱﻝﻡﺍﻥ
salmi	ﺱﺍﻝﻡی
salo	ﺱﺍﻝﻭ
salste	ﺱﺍﻝﺱﺕﻩ
salter	ﺱﺍﻝﺕﺭ
saltzman	ﺱﺍﻝﺕﺯﻡﻥ
salva	ﺱﺍﻝﻭﺍ
salvado	ﺱﺍﻝﻭﺍﺩﻭ
salvador	ﺱﺍﻭﺍﺩﻭر
salwa	ﺱﻝﻭﺍ
salzberg	ﺱﺍﻝﺯﺏﺭگ
salzman	ﺱﺍﻝﺯﻡﻥ
sam	ﺱﻡ
samah	ﺱﺍﻡﺍﻩ
samanta	ﺱﺍﻡﺍﻥﺕﺍ
samblanx	ﺱﻡﺏﻝﻥکﺱ
sambolec	ﺱﺍﻡﺏﻭﻝیک
samec	ﺱﺍﻡک
sameer	ﺱﺍﻡﺭ
sameh	ﺱﺍﻡﻩ
samel	ﺱﺍﻡﻝ
samien	ثﻡیﻥ
samir	ﺱﻡیﺭ
samira	ﺙﻡیرﺍ
samirah	ﺙﻡیرﻩ
samma	ﺙﻡﺍ
samman	ﺱﺍﻡﺍﻥ
sammer	ﺱﺍﻡﺭ
samosky	ﺱﺍﻡﻭﺱکی
sample	ﺱﻡپﻝ
sams	ﺱﺍﻡﺯ
samsel	ﺱﻡﺱﻝ
samson	ﺱﺍﻡﺱﻭﻥ
samuel	ﺱﺍﻡﻭیﻝ
samuels	ﺱﺍﻡﻭﻝﺱ
sana	ﺙﻥﺍ
sanborn	ﺱﺍﻥﺏﻭرﻥ
sancese	ﺱﺍﻥﺱﺱ
sand	ﺱﺍﻥﺩ
sandell	ﺱﻥﺩﻝ
sanders	ﺱﺍﻥﺩﺭﺯ
sanderson	ﺱﺍﻥﺩﺭﺱﻭﻥ
sandford	ﺱﻥﺩﻑﻭﺭﺩ
sandhu	ﺱﺍﻥﺩﻩﻭ
sandie	ﺱﻥﺩی
sandman	ﺱﺍﻥﺩﻡﺍﻥ
sandra	ﺱﻥﺩﺭﺍ
sandvik	ﺱﻥﺩﻭیک
sandy	ﺱﻥﺩی
sane	ﺱیﻥ
sang	ﺱﺍﻥگ
sangal	ﺱﻥگﺍﻝ
sangho	ﺱﺍﻥگﻭ
sangster	ﺱﺍﻥﺝﺱﺕﺭ
sannella	ﺱﺍﻥﻝﺍ
sanner	ﺱﺍﻥﺭ
sannertje	ﺱﺍﻥرﺕ
sanov	ﺱﺍﻥﻭ
sansburn	ﺱﺍﻥزﺏﻭرﻥ
sansing	ﺱﺍﻥﺱیﻥگ
santa	ﺱﺍﻥﺕﺍ
santana	ﺱﺍﻥﺕﺍﻥﺍ
santee	ﺱﺍﻥﺕی
santiago	ﺱﻥﺕیﺍگﻭ
santic	ﺱﺍﻥﺕیک
santini	ﺱﺍﻥﺕیﻥی
santje	ﺱﺍﻥﺕ
santo	ﺱﺍﻥﺕﻭ
santos	ﺱﺍﻥﺕﻭﺱ
santucci	ﺱﺍﻥﺕﻭﺱی
sanwalka	ﺱﺍﻥﻭﺍﻝکﺍ
sarab	ﺱﺭﺍﺏ
saranen	ﺱﺍﺭﺍﻥﻥ
sarathy	ﺱﺍﺭﺍﺕی
sarda	ﺱﺍرﺩﺍ
sardar	ﺱﺭﺩﺍﺭ
sardegna	ﺱﺍﺭﺩگﻥﺍ
sardo	ﺱﺍﺭﺩﻭ
sare	ﺱیﺭ
sarkes	ﺱﺍرکیﺱ
sarkies	ﺱﺍﺭکیﺱ
sarna	ﺱﺍﺭﻥﺍ
sarrett	ﺱﺍﺭﺕ
sarwate	ﺱﺍﺭﻭﺍﺕﻩ
sasamori	ﺱﺍﺱﺍﻡﻭری
saslav	ﺱﺍﺱﻝﺍﻭ
sassenheim	ﺱیزﻥﻩیﻡ
sassone	ﺱﺍﺱﻭﻥ
sasze	ﺱﺍزﻩ
sather	ﺱﺍﺕﺭ
sato	ﺱﺍﺕﻭ
satoshi	ﺱﺍﺕﻭﺵی
satur	ﺱﺍﺕﻭﺭ
sauer	ﺱﺍﻭیﺭ
saukh	ﺱﺍک
saul	ﺱﺍﻭﻝ
sauls	ﺱﺍﻭﻝﺯ
saunders	ﺱﺍﻥﺩرز
sauriol	ﺱﺍﺭیﻭﻝ
sauter	ﺱﺍﻭﺕﺭ
sauther	ﺱﺍﻭﺕﺭ
savage	ﺱﺍﻭیﺝ
savaram	ﺱﺍﻭﺍﺭﺍﻡ
savasta	ﺱﺍﻭﺍﺱﺕﺍ
savel	ﺱﺍﻭﻝ
savetz	ﺱﺍﻭﺕﺯ
savin	ﺱﺍﻭیﻥ
saviz	ﺱﺍﻭیﺯ
savoy	ﺱﺍﻭﻭی
sawad	ﺱﺍﻭﺍﺩ
sawan	ﺱﺍﻭﺍﻥ
sawchuk	ﺱﺍچک
sawdey	ﺱﺍﻭﺩی
sawford	ﺱﺍﻭﻑﺭﺩ
sawsan	ﺱﺍﺱﺍﻥ
sawyer	ﺱﺍیﻭیﺭ
saxe	ﺱﺍکﺱ
saxena	ﺱﺍکﺱﻥﺍ
saxnem	ﺱکﺱﻥﻡ
saxon	ﺱﺍکﺱﻭﻥ
sayer	ﺱیﺭ
sayre	ﺱیﺭ
scallen	ﺍﺱکﺍﻝﻥ
scally	ﺍﺱکﺍﻝی
scanlan	ﺍﺱکﺍﻥﻝﺍﻥ
scanlin	ﺍﺱکﺍﻥﻝیﻥ
scanlon	ﺱکﻥﻝﻭﻥ
scannell	ﺍﺱکﺍﻥیﻝ
scarce	ﺍﺱکﺍﺭﺱ
scarp	ﺍﺱکﺍﺭپ
scearce	ﺍﺱکیﺭﺱ
schabus	ﺵﺍﺏﻭﺱ
schafer	ﺵﺍﻑﺭ
schagen	چﺍگﻥ
scheepen	چیپﻥ
schermerhorn	چرﻡرﻩﻭرﻥ
scherwich	چرﻭیچ
schipleda	چیپﻝﺩﺍ
schipluiden	چیپﻝﻭیﺩﻥ
schmeer	ﺵﻡیﺭ
schmidt	ﺍﺵﻡیﺕ
schnel	ﺍﺵﻥﻝ
schofield	ﺍﺱچﺍﻑیﻝﺩ
scholtz	ﺵﻭﻝﺕﺯ
scholz	ﺵﻭﻝﺯ
schon	ﺵﻭﻥ
schoo	ﺵﻭ
schut	ﺵﺍﺕ
schuyler	چﻭیﻝر
sciandra	ﺱیﺍﻥﺩﺭﺍ
sco	ﺍﺱکﻭ
scoggins	ﺍﺱکﺍگیﻥﺯ
scollick	ﺍﺱکﺍﻝیک
sconner	ﺍﺱکﺍﻥر
scorer	ﺍﺱکﻭﺭﺭ
scotia	ﺍﺱکﺍﺕیﺍ
scotto	ﺍﺱکﺍﺕﻭ
scotty	ﺍﺱکﺍﺕی
scoular	ﺍﺱکﻭﻝﺍﺭ
scowling	ﺍﺱکﻭﻝیﻥگ
scranton	ﺍﺱکرﺍﻥﺕﻭﻥ
screech	ﺍﺱکﺭیچ
screve	ﺍﺱکﺭیﻭ
scribbling	ﺍﺱکﺭیﺏﻝیﻥگ
scribner	ﺍﺱکﺭیﺏﻥﺭ
scris	ﺍﺱکﺭیﺱ
scrivano	ﺍﺱکیﺭیﻭﺍﻥﻭ
scrivens	ﺍﺱکﺭیﻭﻥﺯ
scrub	ﺍﺱکﺭﺍﺏ
scrubey	کرﻭﺏی
scruggs	ﺍﺱکﺭﻭگﺱ
scudds	ﺍﺱکﺍﺩﺯ
sculingleke	ﺍﺱکﺍﻝیﻥگﻝیکﻩ
scull	ﺍﺱکﺍﻝ
scully	ﺍﺱکﻭﻝی
seal	ﺱیﻝ
sealer	ﺱیﻝر
seales	ﺱیﻝﺯ
seals	ﺱیﻝﺯ
seaman	ﺱیﻡﻥ
seamounts	ﺱیﻡﻭﻥﺕﺱ
seamus	ﺱیﻡﻭﺱ
sean	ﺱیﻥ
seanagh	ﺱیﻥیگ
seanain	ﺱیﻥﺍیﻥ
seanna	ﺱیﻥﺍ
searchnet	ﺱیﺭچﻥﺕ
seavy	ﺱیﻭی
seawood	ﺱیﻭﻭﺩ
sebastiaen	ﺱپﺍﺱﺕیﻥ
sebastian	ﺱﺏﺍﺱﺕیﻥ
sebesta	ﺱﺏﺱﺕﺍ
sebolt	ﺱیﺏﻝﺕ
sebree	ﺱﺏﺭی
sechrest	ﺱیچرﺱﺕ
security	ﺱکیﻭﺭیﺕی
seda	ﺱﺩﺍ
sedai	ﺱﺩﺍی
sedore	ﺱﺩﻭﺭ
sedvall	ﺱﺩﻭﺍﻝ
see	ﺱی
seebacher	ﺱیﺏﺍچﺭ
seed	ﺱیﺩ
seedman	ﺱیﺩﻡﻥ
seeds	ﺱیﺩﺯ
seeley	ﺱیﻝی
seely	ﺱیﻝی
seelye	ﺱیﻝی
seeney	ﺱیﻥی
seenu	ﺱیﻥﻭ
seese	ﺱیﺱ
seewald	ﺱیﻭﺍﻝﺩ
seewei	ﺱیﻭی
segal	ﺱگﺍﻝ
segura	ﺱگﻭﺭﺍ
seh	ﺱﺡ
sehr	ﺱﻩﺭ
sehyo	ﺱﻩیﻭ
seibel	ﺱیﺏﻝ
seibl	ﺱیﺏﻝ
seibold	ﺱیﺏﻝﺩ
seid	ﺱیﺩ
seidl	ﺱیﺩﻝ
seil	ﺱیﻝ
seipel	ﺱیپﻝ
seiyu	ﺱیﻭ
sekar	ﺱکﺍﺭ
sekora	ﺱیکﺍﺭﻭ
sela	ﺱیﻝﺍ
selberg	ﺱﻝﺏﺭگ
selcuk	ﺱﻝکﻭک
selena	ﺱﻝﻥﺍ
selim	ﺱﻝیﻡ
selima	ﺱﻝیﻡﺍ
selina	ﺱﻝیﻥﺍ
sell	ﺱﻝ
selleck	ﺱﻝک
sellin	ﺱﻝیﻥ
sells	ﺱﻝﺯ
selman	ﺱﻝﻡﻥ
selway	ﺱﻝﻭی
selwood	ﺱیﻝﻭﺩ
seman	ﺱیﻡﻥ
semele	ﺱﻡﻝی
semir	ﺱﻡیﺭ
semiz	ﺱﻡیﺯ
semonche	ﺱﻡﻭﻥچ
semotiuk	ﺱﻡﻭﺕیﻭک
sen	ﺱﻥ
sena	ﺱﻥﺍ
sendhil	ﺱﻥﺩﻩیﻝ
senftleben	ﺱﻥﻑﺕﻝیﺏﻥ
seng	ﺱﻥگ
sengmany	ﺱﻥگﻡﺍﻥی
sengupta	ﺱﻥگﻭپﺕﺍ
senner	ﺱیﻥﺭ
sensor	ﺱﻥﺱﻭر
seo	ﺱیﻭ
sepehr	ﺱپﻩﺭ
sepinwall	ﺱپیﻥﻭﺍﻝ
seppanen	ﺱپﺍﻥﻥ
seppy	ﺱپی
seputis	ﺍﺱپﻭﺕیﺱ
sequeira	ﺱکﻭیﺭﺍ
serafin	ﺱیﺭﺍﻑیﻥ
sercan	ﺱﺭکﺍﻥ
serchay	ﺱرچﺍی
serel	ﺱﺭﻝ
sergio	ﺱﺭﺝیﻭ
serhir	ﺱﺭﻩیﺭ
serhire	ﺱرﻩیرﻩ
serpent	ﺱﺭپﻥﺕ
serres	ﺱیﺭﺱ
serrone	ﺱیﺭﻭﻥ
servadei	ﺱﺭﻭﺍﺩی
servis	ﺱﺭﻭیﺱ
seshadri	ﺱﺵﺍﺩﺭی
sethurajan	ﺱﺕﻩﻭﺭﺍﺝﺍﻥ
sethuraman	ﺱﺕﻭﺭﺍﻡﺍﻥ
seto	ﺱیﺕﻭ
settle	ﺱﺕﻝ
seuffert	ﺱیﻭﻑﺭﺕ
seurer	ﺱﺭﺭ
sevanick	ﺱﻭﺍﻥیک
seven	ﺱﻭﻥ
severin	ﺱﻭﺭیﻥ
severn	ﺱﻭﺭﻥ
severson	ﺱﻭﺭﺱﻭﻥ
sewell	ﺱیﻭﻝ
sexton	ﺱکﺱﺕﻥ
seydel	ﺱیﺩﻝ
seytie	ﺱیﺕ
sha	ﺵﺍ
shabwah	ﺵﺍﺏﻭﻩ
shachat	ﺵﺍچﺍﺕ
shackelford	ﺵﺍکﻝﻑﻭرﺩ
shadha	ﺵﺍﺩﻩﺍ
shadiyah	ﺵﺍﺩیﺍﻩ
shadow	ﺵﺩﻭ
shaker	ﺵیکﺭ
shakespeare	ﺵکﺱپیﺭ
shakira	ﺵکیرﺍ
shakya	ﺵﺍکیﺍ
shalette	ﺵﺍﻝیﺕ
shaligram	ﺵﺍﻝیگﺭﺍﻡ
shallcross	ﺵﺍﻝکﺭﺍﺱ
shalom	ﺵﺍﻝﻭﻡ
shamas	ﺵﺍﻡﺍﺱ
shamat	ﺵﻡﺍﺕ
shambat	ﺵﺍﻡﺏﺍﺕ
shambhu	ﺵﻡﺏﻩﻭ
shames	ﺵیﻡﺯ
shamim	ﺵﻡیﻡ
shamir	ﺵﺍﻡیﺭ
shamis	ﺵﻡیﺱ
shan	ﺵﺍﻥ
shand	ﺵﻥﺩ
shane	ﺵیﻥ
shank	ﺵﺍﻥک
shankar	ﺵﺍﻥکﺍﺭ
shanker	ﺵﺍﻥکﺭ
shanks	ﺵﺍﻥکﺱ
shapero	ﺵﺍپﺭﻭ
shapir	ﺵپیﺭ
shapira	ﺵپیرﺍ
shar	ﺵﺍﺭ
shardlow	ﺵﺍﺭﺩﻝﻭ
share	ﺵیﺭ
sharen	ﺵﺍرﻥ
sharf	ﺵﺍﺭﻑ
shari	ﺵﺍﺭی
sharif	ﺵریط
shark	ﺵﺭک
sharknas	ﺵﺍﺭکﻥﺍﺱ
sharks	ﺵﺭکﺱ
sharl	ﺵﺍﺭﻝ
sharlee	ﺵﺍﺭﻝی
sharock	ﺵﺍﺭﻭک
sharon	ﺵﺍرﻭﻥ
sharov	ﺵﺍﺭﻭ
shartzer	ﺵﺍﺭﺕﺯﺭ
sharvari	ﺵﺭﻭﺍﺭی
shaul	ﺵﺍﻭﻝ
shawn	ﺵﺍﻭﻥ
shea	ﺵی
shead	ﺵیﺩ
sheaffer	ﺵیﻑر
shearer	ﺵیﺭﺭ
shebanek	ﺵﺏﻥک
shebby	ﺵﺏی
shebert	ﺵﺏﺭﺕ
sheckman	ﺵکﻡﺍﻥ
shecter	ﺵﺱﺕر
sheehan	ﺵیﻩﺍﻥ
sheehy	ﺵیﻩی
sheep	ﺵیپ
sheer	ﺵیﺭ
sheerin	ﺵریﻥ
sheets	ﺵیﺕﺯ
shef	ﺵﻑ
sheffield	ﺵﻑیﻝﺩ
sheik	ﺵیک
shein	ﺵیﻥ
sheipe	ﺵپ
shekar	ﺵکﺍﺭ
shel	ﺵﻝ
sheldon	ﺵیﻝﺩﻥ
shelf	ﺵﻝﻑ
sheller	ﺵﻝﺭ
shelley	ﺵیﻝی
shelly	ﺵﻝی
shelmidi	ﺵﻝﻡیﺩی
shelton	ﺵﻝﺕﻭﻥ
shen	ﺵﻥ
shenan	ﺵﻥﺍﻥ
shenfeng	ﺵﻥﻑﻥگ
sheng	ﺵﻥگ
shenghun	ﺵﻥﻕﺍﻥ
shenkiat	ﺵﻥکیﺍﺕ
shenkin	ﺵﻥکیﻥ
shenoy	ﺵیﻥﻭی
shepherd	ﺵﻑﺭﺩ
sheppard	ﺵپﺍﺭﺩ
sherer	ﺵﺭﺭ
sheri	ﺵﺭی
sheriff	ﺵریﻑ
sherline	ﺵرﻝﺍیﻥ
sherlock	ﺵرﻝﻭک
sherman	ﺵﺭﻡﺍﻥ
sherred	ﺵرﺩ
sherriff	ﺵریﻑ
sherry	ﺵﺭی
sherwin	ﺵرﻭیﻥ
sherwood	ﺵﺭﻭﻭﺩ
shetland	ﺵﺕﻝﻥﺩ
shetler	ﺵﺕﻝﺭ
shetline	ﺵﺕﻝﺍیﻥ
shetron	ﺵیﺕﺭﺍﻥ
shevchuck	ﺵﻭچﺍک
sheyn	ﺵیﻥ
shiang	ﺵیﺍﻥگ
shidler	ﺵیﺩﻝﺭ
shields	ﺵیﻝﺩﺯ
shilling	ﺵﻝیﻥگ
shima	ﺵیﻡﺍ
shimayah	ﺵیﻡﺍیﻩ
shimeall	ﺵیﻡﻝ
shimon	ﺵیﻡﻥ
shin	ﺵیﻥ
shing	ﺵیﻥگ
shipman	ﺵیپﻡﻥ
shirai	ﺵیﺭﺍی
shirley	ﺵیﺭﻝی
shiyekar	ﺵیکﺍﺭ
shlaes	ﺵﻝﺍیﺯ
shlomit	ﺵﻝﻭﻡیﺕ
shnitman	ﺍﺵﻥیﺕﻡﺍﻥ
sho	ﺵﻭ
shockey	ﺵﺍکی
shokrai	ﺵکﺭﺍی
shoring	ﺵﺭیﻥگ
shortell	ﺵﻭﺭﺕﻝ
shorten	ﺵﻭﺭﺕﻥ
shoshana	ﺵﻭﺵﺍﻥﺍ
shoshani	ﺵﺵﺍﻥی
shostak	ﺵﺍﺱﺕک
shostek	ﺵﻭﺱﺕک
shotton	ﺵﺍﺕﻭﻥ
shoulder	ﺵﻭﻝﺩﺭ
shoun	ﺵﻭﻥ
shoup	ﺵﻭپ
shrestha	ﺵﺭﺱﺕﺍ
shriver	ﺵﺭیﻭﺭ
shrom	ﺵرﻭﻡ
shryne	ﺵﺭﺍیﻥﻩ
shtiegman	ﺍﺵﺕیگﻡﻥ
shub	ﺵﺍﺏ
shudes	ﺵﻭﺩﺯ
shue	ﺵﻭ
shuff	ﺵﺍﻑ
shuford	ﺵﻭﻑﻭرﺩ
shugrue	ﺵﺍگﺭﻭ
shuh	ﺵﺍﻩ
shuholm	ﺵﺍﻩﻭﻝﻡ
shukla	ﺵﺍکﻝﺍ
shulah	ﺵﻉﻝﻩ
shulga	ﺵﺍﻝگﺍ
shulman	ﺵﺍﻝﻡﺍﻥ
shultz	ﺵﺍﻝﺕﺯ
shum	ﺵﺍﻡ
shumaker	ﺵﺍﻡﺍکﺭ
shuman	ﺵﺍﻡﻥ
shun	ﺵﺍﻥ
shunkui	ﺵﻭﻥکﻭی
shunnar	ﺵﺍﻥﻥﺍر
shurtz	ﺵﻭﺭﺕﺯ
shushen	ﺵﺍﺵﻥ
shutt	ﺵﺍﺕ
shuyler	ﺵﻭیﻝﺭ
siang	ﺱیﺍﻥگ
siano	ﺱیﺍﻥﻭ
sibley	ﺱیﺏﻝی
sickles	ﺱیکﻝﺱ
sicolo	ﺱیکﻭﻝﻭ
sidler	ﺱیﺩﻝﺭ
sidor	ﺱیﺩﻭﺭ
sieber	ﺱیﺏﺭ
siebert	ﺱیﺏﺭﺕ
siegal	ﺱیگﺍﻝ
siegel	ﺱیگﻝ
siegert	ﺱییگرﺕ
siegl	ﺱیگﻝ
siegman	ﺱیگﻡﻥ
siejko	ﺱیﺝکﻭ
sieker	ﺱیکﺭ
siembab	ﺱیﻡﺏﺍﺏ
siemonsen	ﺱیﻡﻭﻥﺱﻥ
sienko	ﺱیﻥکﻭ
siering	ﺱیﺭیﻥگ
sierra	ﺱیﺭﺍ
sierwald	ﺵﻭرﻭﺍﻝﺩ
siever	ﺱیﻭﺭ
siew	ﺱیﻭ
sigman	ﺱیگﻡﻥ
sigmon	ﺱیگﻡﻥ
sigmund	ﺱیگﻡﻭﻥﺩ
sihsobhon	ﺱیﻩﺱﻭﺏﻩﻭﻥ
sijmen	ﺱیگﻡﻥ
sikes	ﺱﺍیکﺱ
sikora	ﺱیکﻭﺭﺍ
sikorski	ﺱیکﻭﺭﺱکی
silikon	ﺱیﻝکﻭﻥ
silk	ﺱیﻝک
silva	ﺱیﻝﻭﺍ
silver	ﺱیﻝﻭﺭ
silverberg	ﺱیﻝﻭﺭﺏﺭگ
silverman	ﺱیﻝﻭﺭﻡﻥ
silverthorne	ﺱیﻝﻭﺭﺕﻭﺭﻥ
silverwood	ﺱیﻝﻭﺭﻭﺩ
silvester	ﺱیﻝﻭﺱﺕﺭ
silvey	ﺱیﻝﻭی
silvia	ﺱیﻝﻭیﺍ
silvio	ﺱیﻝﻭیﻭ
silvo	ﺱیﻝﻭ
silvonen	ﺱیﻝﻭﻥﻥ
simard	ﺱیﻡﺍﺭﺩ
simcik	ﺱیﻡﺱیک
simcoe	ﺱیﻡکﻭ
simen	ﺱیﻡﻥ
simeon	ﺱیﻡیﻭﻥ
simer	ﺱیﻡﺭ
simicich	ﺱﻡﺱچ
siming	ﺱیﻡیﻥگ
simko	ﺱﺍیﻡکﻭ
simler	ﺱیﻡﻝﺭ
simmer	ﺱیﻡﺭ
simmonds	ﺱیﻡﻥﺩﺱ
simmons	ﺱیﻡﻥز
simms	ﺱیﺱﺯ
simo	ﺱیﻡﻭ
simona	ﺱیﻡﻭﻥﺍ
simonds	ﺱیﻡﻭﻥﺩﺱ
simonie	ﺱیﻡﻭﻥﻩ
simons	ﺱیﻡﻭﻥﺯ
simonson	ﺱیﻡﺱﻭﻥ
simoom	ﺱیﻡﻭﻡ
simplicity	ﺱیﻡپﻝیﺱیﺕی
simpson	ﺱیپﺱﻭﻥ
sims	ﺱیﻡﺱ
sin	ﺱیﻥ
sinan	ﺱیﻥﺍﻥ
sinclair	ﺱیﻥکﻝﺍیﺭ
sindelman	ﺱیﻥﺩﻝﻡﻥ
sindre	ﺱیﻥﺩﺭﻩ
sinead	ﺱیﻥیﺩ
sinemorets	ﺱیﻥﻡﻭﺭیﺕﺱ
sing	ﺱیﻥگ
singleton	ﺱیگﻝﺕﻭﻥ
sinibaldi	ﺱیﻥیﺏﺍﻝﺩی
sipe	ﺱﺍیپ
sipple	ﺱیپﻝ
sipriano	ﺱیپﺭیﺍﻥﻭ
siqi	ﺱیکی
sir	ﺱﺭ
sircombe	ﺱﺭکﺍﻡﺏ
siren	ﺱیرﻥ
sires	ﺱیﺭﺱ
sirois	ﺱیﺭﻭیﺯ
sirucka	ﺱیﺭﻭکﺍ
sisira	ﺱیﺱیﺭﺍ
sisk	ﺱیﺱک
sita	ﺱیﺕﺍ
sitao	ﺱیﺕﺍﻭ
sites	ﺱیﺕﺱ
sitrah	ﺱیﺕرﺍ
sittler	ﺱیﺕﻝﺭ
siu	ﺱیﻭ
siuuirdingelant	ﺱییﻭﺍیرﺩیﻥگﻝﻥﺕ
siva	ﺱیﻭﺍ
sivier	ﺱیﻭیر
sjarel	ﺍﺱﺝرﻝ
skahan	ﺍﺱکﺍﻩﺍﻥ
skar	ﺍﺱکﺍر
skari	ﺍﺱکﺍﺭی
skartsis	ﺍﺱکﺍﺭﺕﺱیﺱ
skaven	ﺍﺱکﺍﻭﻥ
skaya	ﺍﺱکﺍیﺍ
skean	ﺍﺱکیﻥ
skee	ﺍﺱکی
skeete	ﺍﺱکیﺕ
skeeter	ﺍﺱکیﺕﺭ
skeeve	ﺍﺱکیﻭ
skelton	ﺍﺱکﻝﺕﻥ
skep	ﺍﺱکپ
skerries	ﺍﺱکﺭﺍیﺯ
skerry	ﺍﺱکﺭی
skew	ﺍﺱکﻭ
skiba	ﺍﺱکیﺏﺍ
skiena	ﺍﺱکیﻥﺍ
skiles	ﺍﺱکیﻝﺱ
skinner	ﺍﺱکیﻥﺭ
skip	ﺍﺱکیپ
skippy	ﺍﺱکیپی
sklower	ﺍﺱکﻝﻭیﺭ
skogen	ﺍﺱکﻭگﺍﻥ
sky	ﺍﺱکﺍی
slabotnen	ﺍﺱﻝﺏﻭﺕﻥﻥ
slack	ﺍﺱﻝک
slade	ﺍﺱﻝیﺩ
slagle	ﺍﺱﻝﺍگﻝ
slak	ﺍﺱﻝک
slan	ﺍﺱﻝﺍﻥ
slangsvold	ﺍﺱﻝﻥگﺯﻭﺍﻝﺩ
slankard	ﺍﺱﻝﺍﻥکﺍﺭﺩ
slash	ﺍﺱﻝﺵ
slashing	ﺍﺱﻝﺵیﻥگ
slate	ﺍﺱﻝیﺕی
slattery	ﺍﺱﻝﺍﺕﺭی
slave	ﺍﺱﻝیﻭ
slavenburg	ﺍﺱﻝﺍﻭﻥﺏﺭگ
slavin	ﺍﺱﻝﺍﻭیﻥ
slawomir	ﺍﺱﻝﺍﻭﻡیﺯ
slayer	ﺍﺱﻝﺍیر
sledd	ﺍﺱﻝﺩ
sledge	ﺱﻝﺝ
sleegers	ﺍﺱﻝیگﺭﺯ
sleep	ﺍﺱﻝیپ
sleeper	ﺍﺱﻝیپﺭ
sletten	ﺍﺱﻝﺕﻥ
slim	ﺱﻝیﻡ
slimane	ﺍﺱﻝیﻡﺍﻥ
slippery	ﺱﻝیپﺭی
sliupas	ﺍﺱﻝیﻭپﺍﺱ
sloan	ﺍﺱﻝﺍﻥ
sloane	ﺱﻝﻭﻥ
slocum	ﺍﺱﻝﻭکﺍﻡ
sloma	ﺍﺱﻝﻭﻡﺍ
sloman	ﺍﺱﻝﻭﻡﻥ
slone	ﺍﺱﻝﺍﻥ
slootweg	ﺍﺱﻝﻭﺕﻭگ
slootz	ﺍﺱﻝﻭﺕﺯ
slope	ﺍﺱﻝپ
slothouber	ﺍﺱﻝﺍﺕﻭﺏﺭ
slotkin	ﺍﺱﻝﺍﺕکیﻥ
slovak	ﺱﻝﻭﻭک
sluka	ﺍﺱﻝﻭکﺍ
slumkey	ﺱﻝﺍﻡکی
slut	ﺱﻝﺍﺕ
sly	ﺱﻝﺍی
slyke	ﺍﺱﻝﺍیک
smakovane	ﺱﻡکﻭﻭﻥ
small	ﺍﺱﻡﺍﻝ
smallbone	ﺍﺱﻡﺍﻝﺏﻥ
smallen	ﺍﺱﻡﺍﻝﻥ
smalley	ﺍﺱﻡﺍﻝی
smargon	ﺍﺱﻡﺍﺭگﻥ
smart	ﺍﺱﻡﺍﺭﺕ
smead	ﺍﺱﻡیﺩ
smeall	ﺍﺱﻡیﻝ
smedley	ﺍﺱﻡﺩﻝی
smeds	ﺍﺱﺩﺱ
smikla	ﺍﺱﻡیکﻝﺍ
smith	ﺍﺱﻡیﺕ
smiths	ﺍﺱﻡیﺕﺯ
smithson	ﺍﺱﻡیﺕﺱﻭﻥ
smitley	ﺱﻡیﺕﻝی
smits	ﺍﺱﻡیﺕﺯ
smode	ﺍﺱﻡﻭﺩ
smoky	ﺍﺱﻡﻭکی
smolen	ﺍﺱﻡﻝﻥ
smolik	ﺍﺱﻡﻭﻝیک
smolin	ﺍﺱﻡﻭﻝیﻥ
smooth	ﺍﺱﻡﻭﺕ
smulders	ﺍﺱﻡﺍﻝﺩرﺱ
smull	ﺍﺱﻡﺍﻝ
smurf	ﺍﺱﻡﺍﺭﻑ
smyley	ﺍﺱﻡیﻝی
smyth	ﺍﺱﻡیﺕ
snail	ﺍﺱﻥیﻝ
sneed	ﺍﺱﻥیﺩ
snehal	ﺱﻥﻩﺍﻝ
sneissel	ﺍﺱﻥیﺱﻝ
snel	ﺍﺱﻥﻝ
snell	ﺍﺱﻥﻝ
snelling	ﺍﺱﻥﻝیﻥگ
snively	ﺍﺱﻥیﻭﻝی
snoddy	ﺍﺱﻥﻭﺩی
snorri	ﺱﻥﻭﺭی
snotoa	ﺱﻥﻭﺕﻭ
snow	ﺍﺱﻥﻭ
snowden	ﺍﺱﻥﻭﺩﻥ
snowfield	ﺍﺱﻥﻭﻑیﻝﺩ
snowy	ﺍﺱﻥﻭﻭی
snug	ﺍﺱﻥﺍگ
sobek	ﺱﻭﺏک
sobhan	ﺱﺏﺡﺍﻥ
sobotka	ﺱﻭﺏﻭﺕکﺍ
social	ﺱﻭﺵﺍﻝ
socialism	ﺱﻭﺵﺍﻝیﺯﻡ
society	ﺱﻭﺱﺍیﺕی
socrates	ﺱﺍکریﺕﺯ
soderblom	ﺱﺍﺩﺭﺏﻝﺍﻡ
soffel	ﺱﻭﻑﻝ
soft	ﺱﺍﻑﺕ
software	ﺱﺍﻑﺕﻭﺭ
sogen	ﺱﻭگﻥ
soha	ﺱﻭﻩﺍ
sohm	ﺱﻭﻩﻡ
soholt	ﺱﻭﻩﻭﻝﺕ
sohrab	ﺱﻩﺭﺍﺏ
sokol	ﺱﻭکﻭﻝ
sol	ﺱﻭﻝ
solak	ﺱﺍﻝک
solar	ﺱﻭﻝﺍﺭ
solberg	ﺱﻝﺏﺭگ
sold	ﺱﻭﻝﺩ
soldani	ﺱﻭﻝﺩﺍﻥی
solek	ﺱﻭﻝک
solenberg	ﺱﻝﻥﺏرگ
soli	ﺱﻭﻝی
solis	ﺱﻭﻝیﺱ
solitario	ﺱﺍﻝیﺕﻭریﻭ
sollas	ﺱﺍﻝﺍﺱ
solo	ﺱﻭﻝﻭ
solomon	ﺱﺍﻝﻭﻡﻥ
solon	ﺱﺍﻝﻥ
solovay	ﺱﻭﻝﻭﻭی
solovier	ﺱﻭﻝﻭیﺭ
solvay	ﺱﻭﻝﻭی
solway	ﺱﻭﻝﻭی
somalingam	ﺱﻭﻡﺍﻝیﻥگﺍﻡ
somani	ﺱﻭﻡﺍﻥی
somashekar	ﺱﻭﻡﺍﺵیکﺍﺭ
some	ﺱﺍﻡ
someren	ﺱﻡﺭﻥ
somero	ﺱﺍﻡﺭﻭ
somers	ﺱﺍﻡرﺯ
somerville	ﺱﻭﻡﺭﻭیﻝ
somesh	ﺱﺍﻡﺵ
something	ﺱﺍﻡﺕیﻥگ
somjee	ﺱﻭﻡﺝی
somlyo	ﺱﻡﻝیﻭ
sommerfeld	ﺱﺍﻡﺭﻑﻝﺩ
sommi	ﺱﺍﻡی
sompop	ﺱﻭﻡپﻭپ
somvay	ﺱﻭﻡﻭی
son	ﺱﺍﻥ
sone	ﺱﻭﻥ
song	ﺱﺍﻥگ
songer	ﺱﻭﻥگﺭ
songerwala	ﺱﻭﻥگﺭﻭﺍﻝﺍ
songie	ﺱﻭﻥﺝی
songkran	ﺱﻭﻥگکﺭﻥ
soni	ﺱﻭﻥی
sonia	ﺱﻭﻥیﺍ
sonic	ﺱﻭﻥیک
sonja	ﺱﻭﻥﺝﺍ
sonny	ﺱﻭﻥی
sony	ﺱﻭﻥی
sonya	ﺱﻭﻥیﺍ
soo	ﺱﻭ
sopan	ﺱﻭپﻥ
sor	ﺱﻭﺭ
sorab	ﺱﻭﺭﺍﺏ
sorabh	ﺱﻭﺭﺍﺏ
sorc	ﺱﻭﺭک
sore	ﺱﻭﺭ
soren	ﺱﻭﺭﻥ
sorensen	ﺱﻭﺭﻥﺱﻥ
sorin	ﺱﻭﺭیﻥ
sorrel	ﺱﻭﺭﻝ
sorsby	ﺱﻭرﺱﺏی
sorvali	ﺱﻭﺭﻭﺍﻝی
sother	ﺱﻭﺕر
sotilas	ﺱﻭﻝیﺕﺍﺱ
soto	ﺱﻭﺕﻭ
sou	ﺱﻭ
soubyran	ﺱﻭﺏیﺭﺍﻥ
soucek	ﺱﻭکک
soudan	ﺱﻭﺩﺍﻥ
souders	ﺱﻭﺩﺭﺯ
soumen	ﺱﻭﻡﻥ
sound	ﺱﺍﻭﻥﺩ
source	ﺱﻭﺭﺱ
sousa	ﺱﻭﺱﻩ
south	ﺱﺍﺕ
sowder	ﺱﻭﺩﺭ
soyack	ﺱﻭیﺍک
sozo	ﺱﻭﺯﻭ
spaarndam	ﺍﺱپﺍرﺩﺍﻡ
spacek	ﺍﺱپیﺱیک
spaet	ﺍﺱپﺍیﺕ
spafford	ﺍﺱپﻑﻭرﺩ
spagnola	ﺍﺱپﺍگﻥﻭﻝﺍ
spangler	ﺍﺱپﺍﻥگﻝﺭ
sparks	ﺍﺱپﺍﺭکﺱ
sparrow	ﺍﺱپﺍﺭﻭ
spas	ﺍﺱپﺍﺱ
spatafora	ﺍﺱپﺍﺕﺍﻑﻭﺭﺍ
spath	ﺍﺱپﺍﺕ
spatz	ﺍﺱپﺍﺕﺯ
spaulding	ﺍﺱپﺍﻭﻝﺩیﻥگ
spear	ﺍﺱپیﺭ
spearing	ﺍﺱپیﺭیﻥگ
spears	ﺍﺱپیﺭﺯ
speden	ﺍﺱپیﺩﻥ
speelmon	ﺍﺱپیﻝﻡﻥ
speer	ﺍﺱپیﺭ
spelman	ﺍﺱپﻝﻡﻥ
spence	ﺍﺱپﻥﺱ
spencer	ﺍﺱپﻥﺱﺭ
spero	ﺍﺱپیﺭﻭ
spertus	ﺍﺱپرﺕﻭﺱ
sphar	ﺍﺱﻑﺍﺭ
spider	ﺍﺱپﺍیﺩﺭ
spiders	ﺍﺱپﺍیﺩﺭﺯ
spiers	ﺍﺱپیﺭﺯ
spies	ﺍﺱپﺍیﺯ
spikes	ﺍﺱپﺍیکﺱ
spillman	ﺍﺱپیﻝﻡﻥ
spillner	ﺍﺱپیﻝﻥر
spinak	ﺍﺱپیﻥﺍک
spindler	ﺍﺱپیﻥﺩﻝﺭ
spindrift	ﺍﺱپیﻥﺩﺭیﻑﺕ
spine	ﺍﺱپیﻥ
spinelli	ﺍﺱپیﻥﻝی
spinning	ﺍﺱپﺍیﻥیﻥگ
spires	ﺍﺱپﺍیﺭﺯ
spiro	ﺍﺱپیﺭﻭ
spiros	ﺍﺱپیﺭﺍﺱ
spisak	ﺍﺱپیﺱﺍک
spit	ﺍﺱپیﺕ
spitzer	ﺍﺱپیﺕﺯﺭ
spivak	ﺍﺱپیﻭﺍک
splaine	ﺍﺱپﻝیﻥ
spleid	ﺍﺱپﻝیﺩ
spliid	ﺍﺱپﻝیﺩ
splinter	ﺍﺱپﻝیﻥﺕﺭ
spolarich	ﺍﺱپﻭﻝﺍﺭیخ
sporay	ﺍﺱپﻭﺭی
spota	ﺍﺱپﻭﺕﺍ
spotswood	ﺍﺱپﺍﺕﺱﻭﻭﺩ
spousta	ﺍﺱپﻭﺱﺕﺍ
sprag	ﺍﺱپﺭﺍگ
springer	ﺱپﺭیﻥگﺭ
springfield	ﺍﺱپریﻥگﻑیﻝﺩ
sproat	ﺍﺱپﺭﻭﺕ
spur	ﺍﺱپﺍﺭ
squier	ﺍﺱکﻭیﺭ
squire	ﺍﺱکﻭﺍیﺭ
squirrel	ﺍﺱکﻭﺍیﺭﻝ
stabell	ﺍﺱﺕیﺏﻝ
stacey	ﺍﺱﺕیﺱی
stachnik	ﺍﺱﺕچﻥیک
stack	ﺍﺱﺕک
stackhouse	ﺍﺱﺕکﻩﻭﺱ
stacy	ﺍﺱﺕیﺱی
stadler	ﺍﺱﺕﺩﻝﺭ
staffan	ﺍﺱﺕﻑﺍﻥ
stafford	ﺍﺱﺕﺍﻑﻭﺭﺩ
stagg	ﺍﺱﺕﺍگ
staggers	ﺍﺱﺕیگﺭﺱ
stailey	ﺍﺱﺕیﻝی
staines	ﺍﺱﺕیﻥﺯ
stakoff	ﺍﺱﺕﺍکﻭﻑ
staley	ﺍﺱﺕﺍﻝی
stam	ﺍﺱﺕﺍﻡ
stamber	ﺍﺱﺕﻡﺏر
stampf	ﺱﺕﻡﻑ
stan	ﺍﺱﺕﻥ
stancomb	ﺍﺱﺕﻥکﺍﻡﺏ
standerfer	ﺍﺱﺕﺍﻥﺩﺭﻑﺭ
stanford	ﺍﺱﺕﻥﻑﺭﺩ
stangier	ﺍﺱﺕﺍﻥگیﺭ
stanley	ﺍﺱﺕﻥﻝی
stansell	ﺍﺱﺕﻥﺱﻝ
stanton	ﺍﺱﺕﺍﻥﺕﻭﻥ
staples	ﺍﺱﺕیپﻝﺯ
stapleton	ﺍﺱﺕﺍپﻝﺕﻭﻥ
starbuck	ﺍﺱﺕﺍﺭﺏﺍک
starcher	ﺍﺱﺕﺍﺭچﺭ
starfish	ﺍﺱﺕﺍﺭﻑیﺵ
staringer	ﺍﺱﺕﺍﺭیﻥگﺭ
stark	ﺍﺱﺕﺍﺭک
starkey	ﺍﺱﺕﺍﺭکی
starr	ﺍﺱﺕﺍﺭ
stars	ﺍﺱﺕﺍﺭﺯ
start	ﺍﺱﺕﺍﺭﺕ
startled	ﺍﺱﺕﺍﺭﺕﻝﺩ
startz	ﺍﺱﺕﺍﺭﺕﺯ
stas	ﺍﺱﺕﺍﺱ
state	ﺍﺱﺕیﺕ
statham	ﺍﺱﺕﺍﺕﻡ
static	ﺍﺱﺕﺍﺕیک
staton	ﺍﺱﺕیﺕﻭﻥ
stavers	ﺍﺱﺕیﻭﺭﺯ
stead	ﺍﺱﺕیﺩ
stealer	ﺍﺱﺕیﻝﺭ
stearn	ﺍﺱﺕیﺭﻥ
stearns	ﺍﺱﺕیﺭﻥﺯ
stec	ﺍﺱﺕک
stedina	ﺍﺱﺕﺩیﻥﺍ
stedman	ﺍﺱﺕﺩﻡﻥ
steed	ﺍﺱﺕیﺩ
steel	ﺍﺱﺕیﻝ
steele	ﺍﺱﺕیﻝ
steen	ﺍﺱﺕیﻥ
steentje	ﺍﺱﺕیﺝﻩ
steep	ﺍﺱﺕیپ
stefan	ﺍﺱﺕﻑﺍﻥ
stefano	ﺍﺱﺕﻑﺍﻥﻭ
steffen	ﺍﺱﺕﻑﻥ
stegen	ﺍﺱﺕگﻥ
steins	ﺍﺱﺕیﻥﺯ
stelly	ﺍﺱﺕﻝی
stenberg	ﺍﺱﺕیﻥﺏﺭگ
stenfort	ﺍﺱﺕﻥﻑﻭﺭﺕ
stenger	ﺍﺱﺕﻥﺝﺭ
stensrud	ﺍﺱﺕﻥﺱﺭﺍﺩ
step	ﺍﺱﺕپ
stephane	ﺍﺱﺕﻑﺍﻥ
stephanus	ﺍﺱﺕﻑﺍﻥز
stephens	ﺍﺱﺕﻑﻥﺯ
stephenson	ﺍﺱﺕﻑﻥﺱﻭﻥ
stepke	ﺍﺱﺕپک
stepken	ﺍﺱﺕپکﻥ
steriti	ﺍﺱﺕﺭیﺕی
sterling	ﺍﺱﺕﺭﻝیﻥگ
sterne	ﺍﺱﺕﺭﻥ
sterner	ﺍﺱﺕرﻥر
steve	ﺍﺱﺕیﻭ
steven	ﺍﺱﺕیﻭﻥ
stevens	ﺍﺱﺕیﻭﻥﺯ
stevenson	ﺍﺱﺕیﻭﻥﺱﻭﻥ
steves	ﺍﺱﺕیﻭﺯ
stevie	ﺍﺱﺕیﻭ
stew	ﺍﺱﺕﻭ
steward	ﺍﺱﺕﻭﺍﺭﺩ
stewart	ﺍﺱﺕﻭﺍﺭﺕ
stewartson	ﺍﺱﺕﻭﺍﺭﺕﺱﻭﻥ
stian	ﺍﺱﺕیﻥ
stiansen	ﺍﺱﺕیﺍﻥﺱﻥ
stich	ﺍﺱﺕیچ
stickelman	ﺍﺱﺕیکﻝﻡﻥ
stickle	ﺍﺱﺕیکﻝ
stieber	ﺍﺱﺕیﺏﺭ
stiening	ﺍﺱﺕیﻥیﻥگ
stig	ﺍﺱﺕیگ
stigberg	ﺍﺱﺕیگﺏﺭگ
stijntje	ﺍﺱﺕیﺝﻥﺕﺝ
stiles	ﺍﺱﺕیﻝﺯ
still	ﺍﺱﺕیﻝ
stineman	ﺍﺱﺕﺍیﻥﻡﻥ
stingray	ﺍﺱﺕیﻥگری
stirling	ﺍﺱﺕﺭﻝیﻥگ
stith	ﺍﺱﺕیﺕ
stobert	ﺍﺱﺕﺍﺏﺭﺕ
stock	ﺍﺱﺕﻭک
stockman	ﺍﺱﺕﺍکﻡﻥ
stocks	ﺍﺱﺕﺍکﺱ
stockslager	ﺍﺱﺕﺍکﺱﻝﺍﺝﺭ
stockton	ﺍﺱﺕﺍکﺕﻭﻥ
stockwell	ﺍﺱﺕﻭکﻭﻝ
stodola	ﺍﺱﺕﻭﺩﻭﻝﺍ
stokes	ﺍﺱﺕﺍکﺯ
stoklas	ﺍﺱﺕﻭکﻝﺍﺱ
stoler	ﺍﺱﺕﻝﺭ
stoller	ﺍﺱﺕﻭﻝﺭ
stolte	ﺍﺱﻭﻝﺕ
stonebridge	ﺍﺱﺕﻭﻥﺏﺭﺍیﺝ
stoney	ﺍﺱﺕﻭﻥی
stookey	ﺍﺱﺕﻭکی
store	ﺍﺱﺕﻭﺭ
storer	ﺍﺱﺕﻭﺭﺭ
storey	ﺍﺱﺕﻭﺭی
storga	ﺍﺱﺕﻭﺭگﺍ
stork	ﺍﺱﺕﻭرک
storleer	ﺍﺱﺕﻭﺭﻝیﺭ
storm	ﺍﺱﺕﻭرﻡ
storms	ﺍﺱﺕﻭﺭﻡﺯ
stot	ﺍﺱﺕﺍﺕ
stovall	ﺍﺱﺕﻭﻭﺍﻝ
stowbridge	ﺍﺱﺕﻭﺏﺭیﺝ
stowell	ﺍﺱﺕﻭﻝ
stox	ﺍﺱﺕﻭکﺱ
strader	ﺍﺱﺕﺭﺍﺩﺭ
strait	ﺍﺱﺕﺭیﺕ
strand	ﺍﺱﺕﺭﻥﺩ
strasheim	ﺍﺱﺕﺭﺍﺵیﻡ
strath	ﺍﺱﺕﺭﺍﺕ
straub	ﺍﺱﺕﺭﺍﻭﺏ
strawberry	ﺍﺱﺕرﺍﺏری
strawbridge	ﺍﺱﺕﺭﺍﺏﺭیﺝ
strayhorn	ﺍﺱﺕریﻩﻭرﻥ
stream	ﺍﺱﺕﺭیﻡ
streater	ﺱﺕﺭیﺕﺭ
streefland	ﺍﺱﺕﺭﻑﻝﻥﺩ
street	ﺱﺕریﺕ
streeter	ﺍﺱﺕﺭیﺕﺭ
streich	ﺍﺱﺕﺭیخ
strickland	ﺍﺱریکﻝﻥﺩ
strider	ﺍﺱﺕﺭیﺩﺭ
striebel	ﺍﺱﺕﺭیﺏﻝ
stringer	ﺍﺱﺕﺭیﻥگﺭ
strini	ﺍﺱﺕﺭیﻥی
strock	ﺍﺱﺕﺭﺍک
strommer	ﺍﺱﺕﺭﺍﻡﺭ
strong	ﺍﺱﺕﺭﺍﻥگ
strope	ﺍﺱﺕﺭﺍپ
strouss	ﺍﺱﺕﺭﻭﺱ
stroustrup	ﺍﺱﺕﺭﻭﺱﺕﺭﺍپ
stroyan	ﺍﺱﺕﺭیﺍﻥ
struckman	ﺍﺱﺕﺭﺍکﻡﻥ
strum	ﺍﺱﺕﺭﻭﻡ
stuart	ﺍﺱﺕﻭﺍرﺕ
stubbs	ﺍﺱﺕﺍﺏﺯ
stuckey	ﺍﺱﺕﺍکی
stud	ﺍﺱﺕﺍﺩ
stude	ﺍﺱﺕﺍﺩ
student	ﺍﺱﺕیﻭﺩﻥﺕ
stuplich	ﺍﺱﺕﺍپﻝیچ
sturges	ﺍﺱﺕﺍﺭگﺱ
sturgill	ﺍﺱﺕﺍﺭگیﻝ
sturim	ﺍﺱﺕﻭﺭیﻡ
sturluson	ﺱﺕﺍﺭﻝﻭﺯﻥ
sturm	ﺍﺱﺕﻭرﻡ
stutz	ﺍﺱﺕﺍﺯ
stutzman	ﺍﺱﺕﺍﺕﺯﻡﻥ
styles	ﺍﺱﺕﺍیﻝﺯ
styntie	ﺍﺱﺕیﻥﺕی
subglacial	ﺱﺍﺏگﻝﺍﺵیﺍﻝ
subhasish	ﺱﺍﺏﻩﺍﺱیﺵ
subhendu	ﺱﻭﺏﻩﺍﻥﺩﻭ
sublette	ﺱﺍﺏﻝﺕ
subramaniam	ﺱﺍﺏﺭﺍﻡﺍﻥیﺍﻡ
subramanian	ﺱﺍﺏﺭﺍﻡﺍﻥیﺍﻥ
subtense	ﺱﺍﺏﺕﻥﺱ
sucgang	ﺱﺍکگﺍﻥگ
suchan	ﺱﻭچﺍﻥ
sucia	ﺱﻭﺵیﺍ
sudan	ﺱﻭﺩﺍﻥ
sudare	ﺱﻭﺩیﺭ
sudarmo	ﺱﻭﺩﺍﺭﻡﻭ
sudarshan	ﺱﻭﺩﺍﺭﺵﺍﻥ
sudip	ﺱﻭﺩیپ
sudipto	ﺱﻭﺩیپﺕﻭ
sudupe	ﺱﺍﺩیﻭپ
sue	ﺱﻭ
suffield	ﺱﺍﻑیﻝﺩ
suga	ﺱﺍگﺍ
sugai	ﺱﺍگﺍیی
sugarloaf	ﺵﻭگﺭﻝﻑ
sugars	ﺱﺍگﺍﺭﺱ
suggs	ﺱﺍگﺯ
sugiono	ﺱﻭگیﻥﻭ
suh	ﺱﻭﻩ
suhas	ﺱﻭﻩﺍﺱ
sukumar	ﺱﻭکﻭﻡﺍﺭ
sulaymaniyah	ﺱﻝیﻡﺍﻥیﻩ
sullivan	ﺱﺍﻝیﻭﺍﻥ
sully	ﺱﺍﻝی
sulphide	ﺱﻭﻝﻑﺍیﺩ
sulphur	ﺱﻭﻝﻑﻭﺭ
sultan	ﺱﻭﻝﺕﺍﻥ
suman	ﺱﻭﻡﺍﻥ
sumanta	ﺱﺍﻡﺍﻥﺕﺍ
sumanth	ﺱﺍﻡﺍﻥﺕﺍ
sumehra	ﺱﺍﻡرﺍ
sumgin	ﺱﺍﻡگیﻥ
sumit	ﺱﺍﻡیﺕ
sumita	ﺱﺍﻡیﺕﺍ
sumitro	ﺱﺍﻡیﺕﺭﻭ
summerall	ﺱﺍﻡﺭﺍﻝ
summers	ﺱﺍﻡﺭﺯ
summit	ﺱﺍﻡیﺕ
sumon	ﺱﺍﻡﻭﻥ
sumrall	ﺱﺍﻡﺭﺍﻝ
sun	ﺱﺍﻥ
suna	ﺱﻭﻥﺍ
sunando	ﺱﺍﻥﺍﻥﺩﻭ
sundar	ﺱﺍﻥﺩﺍﺭ
sundara	ﺱﺍﻥﺩﺍﺭﺍ
sundaram	ﺱﺍﻥﺩﺭﺍﻡ
sunday	ﺱﺍﻥﺩی
sundelin	ﺱﺍﻥﺩﻝیﻥ
sundin	ﺱﺍﻥﺩیﻥ
sune	ﺱیﻭﻥ
suneer	ﺱﺍﻥیر
suneet	ﺱﺍﻥیﺕ
sunfix	ﺱﺍﻥﻑیکﺱ
sung	ﺱیﻭﻥگ
sungold	ﺱﺍﻥگﻝﺩ
sunil	ﺱییﻭﻥیﻝ
sunk	ﺱﺍﻥک
sunken	ﺱﺍﻥکﻥ
sunker	ﺱﺍﻥکﺭ
sunley	ﺱﺍﻥﻝی
sunni	ﺱﺍﻥی
sunnucks	ﺱﺍﻥﺍکﺱ
sunny	ﺱﺍﻥی
sunondo	ﺱﺍﻥﻭﻥﺩﻭ
sunrise	ﺱﺍﻥﺭﺍیﺯ
sunrong	ﺱﺍﻥﺭﺍﻥگ
sunset	ﺱﺍﻥﺱﺕ
sunshine	ﺱﺍﻥﺵﺍیﻥ
sup	ﺱﺍپ
supanee	ﺱﻭپﺍﻥی
supik	ﺱﻭپیک
supnik	ﺱپﻥیک
supratic	ﺱﻭپﺭﺍﺕیک
supriyo	ﺱﻭپﺭیﻭ
suraj	ﺱﻭﺭﺍﺝ
surana	ﺱﻭﺭﺍﻥﺍ
surinder	ﺱﻭﺭیﻥﺩﺭ
survey	ﺱﺭﻭی
susa	ﺱﻭﺱﺍ
susan	ﺱﻭﺯﺍﻥ
susarla	ﺱﻭﺱﺍﺭﻝﺍ
susarrey	ﺱﻭﺱﺍﺭی
sushil	ﺱﻭﺵیﻝ
sushim	ﺱﻭﺵیﻡ
sushkin	ﺱﺍﺵکیﻥ
susie	ﺱﻭﺯی
suska	ﺱﺍﺱکﺍ
suskind	ﺱﻭﺱکیﻥﺩ
sussman	ﺱﺍﺱﻡﻥ
sustik	ﺱﺍﺱﺕیک
suter	ﺱﺍﺕﺭ
sutherland	ﺱﺍﺕرﻝﻥﺩ
sutkus	ﺱﺍﺕکﺍﺱ
sutphen	ﺱﺍﺕﻑیﻥ
sutter	ﺱﻭﺕﺭ
sutton	ﺱﺍﺕﻥ
suture	ﺱﺍچﺭ
suwayda	ﺱﻭیﺩﺍ
suwito	ﺱﻭیﺕﻭ
suzio	ﺱﺍﺯیﻭ
suzy	ﺱﻭﺯی
swa	ﺱﻭﺍ
swag	ﺱﻭگ
swagato	ﺱﻭﺍگﺍﺕﻭ
swallow	ﺱیﻭﺍﻝﻭ
swami	ﺱﻭﺍﻡی
swamp	ﺱﻭﻡپ
swan	ﺱﻭﺍﻥ
swany	ﺍﺱﻭﺍﻥﺍی
swart	ﺱﻭﺍﺭﺕ
swartz	ﺱﻭﺍﺭﺕﺯ
swash	ﺱﻭﺍﺵ
swearingin	ﺱﻭﺍﺭیﻥگیﻥ
swearman	ﺱﻭﺍﺭﻡﻥ
swee	ﺱﻭیی
sweeney	ﺱﻭییﻥی
sweeny	ﺱﻭﺍﻥی
sweet	ﺱﻭیﺕ
swensen	ﺱﻭﻥﺱﻥ
swenson	ﺱﻭﻥﺱﻭﻥ
swingler	ﺱﻭیﻥگﻝﺭ
swink	ﺱﻭییﻥک
swinnerton	ﺱﻭیﻥﺭﺕﻭﻥ
swisher	ﺍﺱﻭیﺵﺭ
switenky	ﺱﻭیﺕﻥکی
swonger	ﺍﺱﻭﻥگﺭ
sydney	ﺱیﺩﻥی
sylvan	ﺱیﻝﻭﺍﻥ
sylvia	ﺱیﻝﻭیﺍ
syme	ﺱﺍیﻡ
symington	ﺱیﻡیﻥگﺕﻭﻥ
symons	ﺱیﻡﻭﻥﺯ
sync	ﺱیﻥک
systems	ﺱیﺱﺕﻡﺯ
sytje	ﺱیﺕﺝ
taatje	ﺕﺍﺕ
table	ﺕیﺏﻝ
tack	ﺕک
taco	ﺕﺍکﻭ
tad	ﺕﺍﺩ
taffe	ﺕﺍﻑﻩ
taffone	ﺕﺍﻑﻭﻥ
tafur	ﺕﺍﻑﻭﺭ
tagle	ﺕگﻝ
tahara	ﺕﺍﻩﺍﺭﺍ
tahirah	طﺍﻩریﻩﺍ
tahoun	ﺕﺍﻩﻭﻥ
tai	ﺕﺍی
taitano	ﺕﺍیﺕﺍﻥﻭ
taizz	ﺕیز
taka	ﺕﺍکﺍ
takasaki	ﺕﺍکﺍﺱﺍکی
taki	ﺕﺍکی
takiyah	ﺕکیﺍﻩ
talarico	ﺕﺍﻝﺍریکﻭ
talbert	ﺕﻝﺏﺭﺕ
talboys	ﺕﺍﻝﺏﻭیز
talcott	ﺕﺍﻝکﻭﺕ
talib	طﻝیﺏ
talla	ﺕﺍﻝﺍ
tallen	ﺕﺍﻝﻥ
tallent	ﺕﻝﻥﺕ
talman	ﺕﺍﻝﻡﻥ
talmy	ﺕﺍﻝﻡی
tam	ﺕﺍﻡ
tamai	ﺕﺍﻡﺍی
tamburri	ﺕﻡﺏﺭی
tamir	ﺕﻡیر
tammana	ﺕﺍﻡﺍﻥﺍ
tampas	ﺕﺍﻡپﺍﺱ
tanak	ﺕﺍﻥﺍک
tanaka	ﺕﺍﻥﺍکﺍ
tandiary	ﺕﻥﺩیﺭی
tang	ﺕﺍﻥگ
tanis	ﺕﺍﻥیﺱ
tanneken	ﺕﺍﻥِکﻥ
tanner	ﺕﺍﻥر
tanton	ﺕﺍﻥﺕﻭﻥ
tants	ﺕﻥﺕﺱ
tanwar	ﺕﻥﻭﺭ
tapio	ﺕﺍپیﻭ
tappin	ﺕﺍپیﻥ
taraldsen	ﺕﺍﺭﺍﻝﺩﺱﻥ
taraz	ﺕﺭﺍﺯ
tardell	ﺕﺍﺭﺩﻝ
tarplin	ﺕﺍﺭپﻝیﻥ
tarr	ﺕﺍﺭ
tarub	طرﻭﺏ
tasaka	ﺕﺍﺱﺍکﺍ
tasdeler	ﺕﺍﺱﺩیﻝﺭ
tat	ﺕﺍﺕ
tatari	ﺕﺍﺕﺍﺭی
tatby	ﺕﺍﺕﺏﺍی
taterway	ﺕﺍﺕﺭﻭی
tatsuo	ﺕﺍﺕﺱﻭ
tattam	ﺕﺍﺕﺍﻡ
tavares	ﺕﺍﻭﺍﺭﺱ
tavernini	ﺕﺍﻭﺭﻥیﻥی
tay	ﺕی
taylor	ﺕیﻝﻭر
teague	ﺕیگﻭ
tean	ﺕیﻥ
teche	ﺕک
technologies	ﺕکﻥﻭﻝﻭﺝیﺯ
teck	ﺕک
teeling	ﺕیﻝیﻥگ
teeth	ﺕیﺕ
teeuw	ﺕییﻭ
teeuwis	ﺕییﻭﻭیﺱ
tehan	ﺕیﻩﺍﻥ
teig	ﺕیگ
telfer	ﺕﻝﻑﺭ
tell	ﺕﻝ
teller	ﺕﻝﺭ
tello	ﺕﻝﻝﻭ
telmer	ﺕﻝﻡر
tempest	ﺕﻡپﺱﺕ
templar	ﺕﻡپﻝﺭ
templin	ﺕﻡپﻝیﻥ
tempore	ﺕﻡپﻭر
tenaya	ﺕﻥﺍیﺍ
tenaza	ﺕﻥﺍﺯﺍ
tener	ﺕﻥﺭ
teng	ﺕﻥگ
tennebo	ﺕﻥﺏﻭ
tennyson	ﺕﻥیﺱﺍﻥ
tenorio	ﺕﻥﻭﺭیﻭ
tenpo	ﺕﻥپﻭ
tent	ﺕﻥﺕ
tenterhooks	ﺕﻥﺕرﻩﻭکﺱ
tepesch	ﺕیپﺵ
teplitz	ﺕپﻝیﺕﺯ
teppo	ﺕپﻭ
teresa	ﺕﺭﺱﺍ
terminal	ﺕﺭﻡیﻥﺍﻝ
tern	ﺕﺭﻥ
ternes	ﺕﺭﻥﺱ
terningen	ﺕﺭﻥیﻥگﻥ
ternyck	ﺕﺭﻥیک
terra	ﺕرﺍ
terrada	ﺕﺭﺍﺩﺍ
terrapin	ﺕﺭﺍپیﻥ
terrapod	ﺕرﺍپﺩ
terrell	ﺕﺭﻝ
terrence	ﺕﺭﻥﺱﻩ
terri	ﺕﺭی
terrible	ﺕﺭیﺏﻝ
territory	ﺕﺭیﺕﻭﺭی
terror	ﺕﺭﻭﺭ
terry	ﺕﺭی
tertene	ﺕﺭﺕﻥﻩ
teruel	ﺕﺭﻭﻝ
teruhiko	ﺕﺭﻭﻩیکﻭ
terwilliger	ﺕﺭﻭیﻝیگﺭ
tesink	ﺕﺱیﻥک
teskey	ﺕﺱکی
tesla	ﺕﺱﻝﺍ
tesler	ﺕﺱﻝﺭ
tesluk	ﺕﺱﻝﺍک
tess	ﺕﺱ
tessa	ﺕﺱﺍ
tessner	ﺕﺱﻥﺭ
testa	ﺕﺱﺕﺍ
tester	ﺕﺱﺕﺭ
tetervin	ﺕﺕﺭﻭیﻥ
tetrad	ﺕﺕﺭﺍﺩ
tetro	ﺕﺕﺭﻭ
tetsuto	ﺕﺕﺱﻭﺕﻭ
teuben	ﺕیﻭﺏﻥ
teuber	ﺕیﻭﺏر
teun	ﺕیﻭﻥ
teunis	ﺕیﻭﻥیﺱ
teuntje	ﺕیﻭﻥیﻩ
teusink	ﺕﻭﺱیﻥک
tewari	ﺕﻭﺍﺭی
tewie	ﺕﻭیﻩ
tex	ﺕکﺱ
teynton	ﺕیﻥﺕﻥ
thabit	طﺏیﺏ
thalberg	ﺕﺍﻝﺏﺭگ
thallmayer	ﺕﺍﻝﻡﺍیﺭ
tham	ﺕﺍﻡ
thana	ﺕﺍﻥﺍ
thao	ﺕﺍیﻭ
thapa	ﺕﺍپﺍ
thara	ﺕﺍرﺍ
tharpe	ﺕﺍﺭپﻩ
thayer	ﺕﺍیﺭ
thedell	ﺕﺩﻝ
theis	ﺕیﺯ
thelander	ﺕﻝﺍﻥﺩﺭ
thelen	ﺕیﻝﻥ
theobald	ﺕیﻭﺏﺍﻝﺩ
theodore	ﺕیﻭﺩر
theroux	ﺕیﺭﻭکﺱ
theunis	ﺕیﻭﻥیﺱ
thielges	ﺕیﻝگﺱ
thierry	ﺕری
thilo	ﺕیﻝﻭ
tho	ﺕﻭ
thom	ﺕﺍﻡ
thomas	ﺕﻭﻡﺍﺱ
thommesen	ﺕﺍﻡﺱﻥ
thompson	ﺕﺍﻡپﺱﻥ
thomsen	ﺕﺍﻡﺱﻭﻥ
thong	ﺕﻭﻥگ
thor	ﺕﻭر
thoresen	ﺕﻭﺭیﺱﻥ
thorn	ﺕﻭﺭﻥ
thornley	ﺕﻭﺭﻥﻝی
thorpe	ﺕﻭﺭپ
thorson	ﺕﺍﺭﺱﻭﻥ
thorud	ﺕﻭﺭﺍﺩ
thorup	ﺕﻭﺭﻭپ
threston	ﺕﺭﺱﺕﻭﻥ
throop	ﺕﺭﻭپ
thrower	ﺕرﻭﺍر
thulen	ﺕییﻭﻝﻥ
thulin	ﺕﻭﻝیﻥ
thumb	ﺕﺍﻡﺏ
thur	ﺕﻭﺭ
thurayya	ﺕﻭریﺍ
thurlede	ﺕرﺩ
thurlo	ﺕﺭﻝﻭ
thurman	ﺕﻭﺭﻡﻥ
thurn	ﺕﺍﺭﻥ
tiak	ﺕیﺍک
tian	ﺕیﺍﻥ
tice	ﺕﺍیﺱ
tiebout	ﺕیﺏﺍﺕ
tiede	ﺕیﺩ
tielemans	ﺕیﻝﻡﺍﻥﺱ
tien	ﺕیﻥ
tientje	ﺕیﻡﺕﺝ
tierie	ﺕری
tierney	ﺕیﺭﻥی
tifford	ﺕیﻑﻭﺭﺩ
tiits	ﺕیﺕﺱ
tijmen	ﺕیﺝﻡﻥ
tijs	ﺕیﺝﺱ
tilbury	ﺕیﻝﺏری
tilden	ﺕیﻝﺩﻥ
tilgner	ﺕیﻝگﻥﺭ
tiller	ﺕیﻝﺭ
tillman	ﺕیﻝﻡﺍﻥ
tillotson	ﺕیﻝﻭﺕﺱﺍﻥ
tim	ﺕیﻡ
timbol	ﺕیﻡﺏﻭﻝ
timian	ﺕیﻡیﺍﻥ
timko	ﺕیﻡکﻭ
timmerman	ﺕیﻡرﻡﺍﻥ
timmins	ﺕیﻡیﻥﺯ
timonin	ﺕیﻡﻭﻥیﻥ
timothy	ﺕیﻡﻭﺕی
tin	ﺕیﻥ
tina	ﺕیﻥﺍ
tindall	ﺕیﻥﺩﺍﻝ
tine	ﺕﺍیﻥ
ting	ﺕیﻥگ
tingley	ﺕیﻥگﻝی
tingli	ﺕیﻥگﻝی
tinney	ﺕﻥی
tino	ﺕیﻥﻭ
tinsel	ﺕیﻥﺱﻝ
tinsley	ﺕیﻥﺱﻝی
tiny	ﺕیﻥی
tio	ﺕیﻭ
tioga	ﺕیﻭگﺍ
tippi	ﺕیپی
tippu	ﺕیپﻭ
tirza	ﺕیﺭﺯﺍ
tisza	ﺕیﺱﺯﺍ
titcomb	ﺕیﺕکﺍﻡ
titmus	ﺕیﺕﻡﺍﺱ
titz	ﺕیﺕﺯ
tobe	ﺕﻭﺏ
tobias	ﺕﻭﺏیﺍﺱ
tobin	ﺕﻭﺏیﻥ
todd	ﺕﻭﺩ
toft	ﺕﺍﻑﺕ
toida	ﺕﻭیﺩﺍ
toit	ﺕﻭیﺕ
tokman	ﺕﺍکﻡﻥ
tolani	ﺕﻭﻝﺍﻥی
toledo	ﺕﻭﻝﺩﻭ
toleno	ﺕﺍﻝﻥﻭ
tolliver	ﺕﻭﻝیﻭﺭ
tolman	ﺕﻭﻝﻡﻥ
tom	ﺕﺍﻡ
tomany	ﺕﻭﻡﺍﻥی
tomares	ﺕﻭﻡﺍﺭﺱ
tomatius	ﺕﺍﻡﺍﺕیﻭﺱ
tombros	ﺕﺍﻡﺏﺭﻭﺱ
tomes	ﺕﻭﻡﺯ
tomi	ﺕﺍﻡی
tomines	ﺕﺍﻡیﻥﺯ
tommi	ﺕﻭﻡی
tomo	ﺕﺍﻡﻭ
tompkins	ﺕﺍﻡپکیﻥﺯ
tomura	ﺕﺍﻡﺍﺭﺍ
tonar	ﺕﻭﻥﺍﺭ
toner	ﺕﻭﻥﺭ
tong	ﺕﺍﻥگ
tongue	ﺕﺍﻥگ
toni	ﺕﻭﻥی
tony	ﺕﻭﻥی
tooley	ﺕﻭﻝی
toon	ﺕﻭﻥ
toontje	ﺕﻥﺝی
tooth	ﺕﻭﺱ
topic	ﺕﺍپیک
toptani	ﺕﺍپﺕﺍﻥی
tor	ﺕﻭﺭ
torda	ﺕﻭﺭﺩﺍ
torigoe	ﺕﺭیﺝﻭ
tormala	ﺕﻭﺭﻡﺍﻝﺍ
tornberg	ﺕﻭﺭﻥﺏﺭگ
torng	ﺕﻭرﻥگ
torres	ﺕﺍﺭﺱ
torrez	ﺕﻭﺭﺯ
toscano	ﺕﻭﺱکﺍﻥﻭ
totty	ﺕﻭﺕی
touch	ﺕﺍچ
tow	ﺕﺍﻭ
tower	ﺕﺍﻭﺭ
toy	ﺕﻭی
tra	ﺕﺭﺍ
tracy	ﺕﺭیﺱی
trafford	ﺕرﺍﻑﻭرﺩ
trafton	ﺕﺭﺍﻑﺕﻭﻥ
traiectensis	ﺕریکﺕﻥﺱیﺱ
trainham	ﺕﺭیﻥﻩﺍﻡ
trainor	ﺕﺭیﻥﻭﺭ
trash	ﺕﺭﺵ
trask	ﺕرﺱک
traster	ﺕﺭﺍﺱﺕﺭ
traub	ﺕرﺍﻭﺏ
traupman	ﺕرﺍپﻡﻥ
trautman	ﺕرﻭﺕﻡﻥ
trauzzi	ﺕﺭﺍﻭﺯی
travaglia	ﺕﺭﺍﻭﺍﺝﻝیﺍ
travolta	ﺕﺭﺍﻭﻝﺕﺍ
treadway	ﺕﺭیﺩﻭی
treindl	ﺕﺭیﻥﺩ
treinen	ﺕﺭیﻥﻥ
treitel	ﺕﺭیﺕﻝ
tremere	ﺕریﻡیر
trench	ﺕﺭﻥچ
trendel	ﺕرﻥﺩﻝ
trent	ﺕﺭﻥﺕ
trethowan	ﺕﺭﺕﻭﺍﻥ
treuerice	رﻭریﺱ
trevor	ﺕﺭیﻭﺭ
tri	ﺕﺭی
tribble	ﺕﺭیﺏﻝ
trickett	ﺕﺭیکﺕ
triemstra	ﺕﺭیﻡﺱﺕﺍﺭ
trier	ﺕریر
trigger	ﺕﺭیگﺭ
triggs	ﺕﺭیگﺱ
trijn	ﺕریژﻥ
trim	ﺕﺭیﻡ
trindade	ﺕﺭیﻥﺩﺍﺩ
trinidad	ﺕریﻥیﺩﺍﺩ
trinkle	ﺕﺭیﻥکﻝ
trio	ﺕﺭیﻭ
tripps	ﺕﺭیپﺱ
tristram	ﺕﺭیﺱﺕﺭﻡ
tritle	ﺕﺭیﺕﻝ
tritz	ﺕریﺕﺯ
troedson	ﺕﺭﻭﺩﺱﻭﻥ
trojan	ﺕﺭﻭﺝﺍﻥ
trollinger	ﺕﺭﻭﻝیﻥگﺭ
trometer	ﺕﺭﻭﻡیﺕﺭ
trotter	ﺕﺭﻭﺕﺭ
troughton	ﺕﺭﻭگﺕﻭﻥ
trout	ﺕﺭﻭﺕ
troxel	ﺕﺭﺍکﺱﻝ
trubey	ﺕﺭﻭﺏی
truck	ﺕرﺍک
trudel	ﺕﺭﻭﺩﻝ
true	ﺕﺭﻭ
truelsen	ﺕﺭﻭﻝﺱﻥ
truesdale	ﺕﺭﻭیﺱﺩیﻝ
truex	ﺕﺭﻭکﺱ
truitje	ﺕریﻭیﺕژ
trull	ﺕﺭﻭﻝ
trumbo	ﺕﺭﻭﻡﺏﻭ
tryntje	ﺕریﻥﺕ
tuama	ﺕﻭﺍﻡﺍ
tuason	ﺕﺍﻭﺱﻥ
tubutis	ﺕﻭﺏﻭﺕیﺱ
tucker	ﺕﺍکﺭ
tudor	ﺕﺍﺩﺭ
tufte	ﺕﻭﻑﺕﻩ
tufts	ﺕﺍﻑﺕﺯ
tula	ﺕﻭﻝﺍ
tuley	ﺕﺍﻝی
tuli	ﺕﻭﻝی
tulio	ﺕﻭﻝیﻭ
tuller	ﺕﺍﻝﺭ
tullis	ﺕﺍﻝیﺱ
tully	ﺕﻭﻝی
tulse	ﺕﺍﻝﺱ
tumber	ﺕﻭﻡﺏﺭ
tumeis	ﺕﻭﻡیﺱ
tuna	ﺕیﻭﻥﺍ
tung	ﺕﻭﻥگ
tunga	ﺕﻭﻥگﺍ
tuohela	ﺕﻭﻩﻝﺍ
tuomas	ﺕﻭﻡﺍﺱ
tuomi	ﺕﻭﻡی
tuominen	ﺕیﻭﻡیﻥﻥ
tuong	ﺕﻭﻥگ
tupper	ﺕﺍپﺭ
tupshin	ﺕﺍپﺵیﻥ
turambar	ﺕﻭﺭﺍﻡﺏﺭ
turbo	ﺕﻭﺭﺏﻭ
turco	ﺕﻭﺭکﻭ
turcotte	ﺕﻭﺭکﺍﺕ
turgut	ﺕرگﺍﺕ
turin	ﺕﻭﺭیﻥ
turini	ﺕﺍریﻥی
turk	ﺕرک
turkel	ﺕﺍﺭکﻝ
turmelle	ﺕﺍﺭﻡﻝ
turmoil	ﺕﺭﻡﻭیﻝ
turner	ﺕﺭﻥﺭ
turnitsa	ﺕﺭﺍﻥیﺕﺱﺍ
turoff	ﺕﻭﺭﻭﻑ
turret	ﺕﻭﺭﺕ
turtle	ﺕﻭﺭﺕﻝ
turton	ﺕﺭﺕﻭﻥ
tushar	ﺕﻭﺵﺍﺭ
tusing	ﺕﻭﺱیﻥگ
tuso	ﺕﻭﺱﻭ
tuthill	ﺕﺍﺕیﻝ
tuttle	ﺕﺍﺕﻝ
tuyen	ﺕﻭیﻥ
tuyet	ﺕﻭیﺕ
twan	ﺕﻭﺍﻥ
tweedie	ﺕﻭیﺩی
tween	ﺕﻭییﻥ
twin	ﺕﻭییﻥ
twiss	ﺕﻭﻭیﺱ
twitchell	ﺕﻭﺍیچﻝ
two	ﺕﻭ
twombly	ﺕﻭﻡﺏﻝی
tye	ﺕﺍی
tyler	ﺕیﻝﺭ
tymen	ﺕیﻡﻥ
tymes	ﺕیﻡﺯ
tyndall	ﺕیﻥﺩﺍﻝ
tyng	ﺕیﻥگ
tynor	ﺕﺍیﻥﻭﺭ
tyrone	ﺕﺍیﺭﻭﻥ
tyrrell	ﺕیرﻝ
tysmans	ﺕیﺱﻡﻥﺯ
tyson	ﺕﺍیﺱﻥ
tytie	ﺕیﺕی
tzisso	زیﺱﻭ
ubaid	ﺍﺏیﺩ
ubiera	یﻭﺏیﺭﺍ
ucker	یﻭکر
udai	ﺍﻭﺩﺍی
uday	ﺍﻭﺩﺍی
udit	ﺍﻭﺩیﺕ
udita	ﺍﻭﺩیﺕﺍ
udo	ﺍﻭﺩﻭ
udolph	ﺍﺩﻭﻝﻑ
udut	یﻭﺩﺍﺕ
uemura	یﻭﻡﻭﺭﺍ
uenal	یﻭﻥﺍﻝ
uffner	ﺍﻭﻑﻥﺭ
ugo	ﺍﻭگﻭ
ugoni	ﺍﻭگﻥی
ugunzi	یﻭگﺍﻥﺯی
ugur	ﺍﻭگﺍﺭ
uilkje	یﻭییکﻩ
uitgeest	یﻭییﺕگﺱﺕ
ukelo	یﻭکیﻝﻭ
ukraine	ﺍﻭکﺭﺍیﻥ
ulima	ﺍﻝیﻡﺍ
ullman	ﺍﻭﻝﻡﻥ
ulvestad	ﺍﻭﻝﻭﺱﺕﺍﺩ
umanetz	ﺍﻭﻡﺍﻥﺕﺯ
umar	ﻉﻡر
umasuthan	ﺍﻭﻡﺍﺱﻭﺕﺍﻥ
umayma	ﺍﻡﺍیﺍ
umberger	ﺍﻭﻡﺏﺭگﺭ
umlas	ﺍﻭﻡﻝﺍﺱ
umstead	ﺍﻡﺱﺕﺩ
unaiza	یﻭﻥیزﺍ
underwood	ﺍﻥﺩﺭﻭﻭﺩ
unger	ﺍﻥگﺭ
unpingco	ﺍﻥپیﻥگکﻭ
unruh	ﺍﻥﺭﺍﻩ
unsicker	ﺍﻥﺱیکﺭ
upchurch	ﺍپچﺭچ
uplands	ﺍپﻝﻥﺩﺱ
upright	ﺍپﺭﺍیﺕ
upston	ﺍپﺱﺕﻥ
upton	ﺍپﺕﻥ
uranium	یﻭﺭﺍﻥیﻡ
urbanik	یﻭﺭﺏﺍﻥیک
urena	یﻭﺭیﻥﺍ
uri	ﺍﻭﺭی
urma	ﺍﻭﺭﻡﺍ
urseltje	یﻭرزﻝﺕ
urwin	ﺍﺭﻭیﻥ
usamah	یﻭﺱﺍﻡﺍ
user	یﻭﺯﺭ
uthman	ﺍﺕﻡﻥ
utrecht	یﻭﺕریچ
utt	ﺍﺕ
vacant	ﻭﺍکﺍﻥﺕ
vaccaro	ﻭکﺭﻭ
vadaparty	ﻭﺍﺩﺍپﺍﺭﺕی
vail	ﻭیﻝ
vaillancourt	ﻭﺍیﻝﺍﻥکﻭﺭﺕ
vaitkus	ﻭیﺕکﻭﺱ
vajdic	ﻭﺍﺝﺩیک
vakil	ﻭﺍکی
valance	ﻭﺍﻝﺍﻥﺱ
valdivia	ﻭﺍﻝﺩیﻭیﺍ
vale	ﻭﺍﻝ
valencia	ﻭﺍﻝﻥﺱیﺍ
valentijn	ﻭﺍﻝﻥﺕیﺝﻥ
valentine	ﻭﻝﻥﺕﺍیﻥ
valentino	ﻭﺍﻝﻥﺕیﻥﻭ
valerian	ﻭﺍﻝﺭیﻥ
valkenaar	ﻭﺍﻝکﻥﺍﺭ
valkila	ﻭﺍﻝکیﻝﺍ
vall	ﻭﺍﻝ
valley	ﻭﺍﻝی
van	ﻑﻭﻥ
vanantwerp	ﻭﺍﻥﺍﺕﻭرپ
vanburen	ﻭﺍﻥﺏرﻥ
vancil	ﻭﺍﻥﺱیﻝ
vancko	ﻭﻥکﻭ
vancortlandt	ﻭﺍﻥکﻭرﺕﻝﻥﺕ
vancuren	ﻭﺍﻥکﻭرﻥ
vandeman	ﻭﻥﺩﻡﻥ
vanden	ﻭﺍﻥﺩﻥ
vandenhoff	ﻭﺍﻥﺩﻥﻩﺍﻑ
vandera	ﻭﺍﻥﺩرﺍ
vanderford	ﻭﻥﺩﺭﻑﻭﺭﺩ
vanderspeigle	ﻭﺍﻥﺩرﺱپیگﻝ
vanderstock	ﻭﻥﺩرﺍﺱﺕﺍک
vanderveer	ﻭﺍﻥﺩرﻭیر
vandivort	ﻭﻥﺩیﻭﺭﺕ
vandousen	ﻭﺍﻥﺩﻭﺱﻥ
vandry	ﻭﻥﺩﺭی
vanduzen	ﻭﺍﻥﺩزﻥ
vandyck	ﻭﺍﻥﺩیک
vang	ﻭﺍﻥگ
vangati	ﻭﺍﻥگﺍﺕی
vanhoff	ﻭﻥﻩﻑ
vanick	ﻭﻥیک
vanilli	ﻭﺍﻥیﻝﺍ
vankeuren	ﻭﺍکﻭرﻥ
vanriper	ﻭﻥﺭیپﺭ
vanschoonhoven	ﻭﺍﻥﺱچﻭﻥﻩﻭﻥ
vanvechten	ﻭﺍﻥﻭچﺕﻥ
vanvleck	ﻭﺍﻥﻭﻝک
vanvranken	ﻭﺍﻥﻭرﺍﻥکﻥ
vanzandt	ﻭﺍﻥزﺍﻥﺕ
vardan	ﻭﺭﺩﺍﻥ
vardi	ﻭﺍﺭﺩی
vargas	ﻭﺍﺭگﺍﺱ
varlow	ﻭﺭﻝﻭ
varma	ﻭﺍﺭﻡﺍ
varney	ﻭﺍﺭﻥی
varty	ﻭﺍﺭﺕی
varvel	ﻭﺍﺭﻭﻝ
vasallo	ﻭﺍﺱﺍﻝﻭ
vato	ﻭﺍﺕﻭ
vaun	ﻭﺍﻭﻥ
vawdry	ﻭیﺩری
vaya	ﻭﺍیﺍ
veasey	ﻭیﺱی
vecoven	ﻭیکﺍﻭﻥ
vecsler	ﻭﺱﻝﺭ
ved	ﻭﺩ
veenkamp	ﻭیﻥکﻡپ
vega	ﻭگﺍ
vela	ﻭﻝﺍ
velasco	ﻭیﻝﺍﺱکﻭ
veld	ﻭﻝﺩ
velden	ﻭﻝﺩﻥ
veldman	ﻭﻝﺩﻡﻥ
vella	ﻭﻝﺍ
velletri	ﻭﻝﺕﺭی
veloso	ﻭﻝﻭﺱﻭ
ven	ﻭﻥ
venable	ﻭیﻥیﺏﻝ
venables	ﻭﻥﺍﺏﻝﺱ
venkata	ﻭﻥکﺍﺕﺍ
ventureli	ﻭﻥﺕﺭﻝی
verbeck	ﻭرﺏک
verboven	ﻭرﺏﻭﻥ
verde	ﻭﺭﺩﻩ
vergara	ﻭرگﺍرﺍ
verhulst	ﻭﺭﻩﻭﺱﺕ
verity	ﻭﺭیﺕی
verlinde	ﻭﺭﻝیﻥﺩ
verma	ﻭﺭﻡﺍ
vermaas	ﻭﺭﻡﺍﺱ
vermaseren	ﻭﺭﻡﺍﺱﺭﻥ
vermes	ﻭﺭﻡﺯ
vermeulen	ﻭﺭﻡیﻭﻝﻥ
vernell	ﻭرﻥﻝ
vernon	ﻭﺭﻥﻥ
verweij	ﻭﺭﻭیﺝ
verwer	ﻭﺭﻭﺭ
vessels	ﻭﺱﻝﺯ
vessey	ﻭﺱی
vest	ﻭﺱﺕ
vestal	ﻭﺱﺕﺍﻝ
vestli	ﻭﺱﺕﻝی
vetter	ﻭﺕﺭ
vezina	ﻭﺯیﻥﺍ
vibe	ﻭﺍیﺏ
viccars	ﻭیکﺍرﺯ
vici	ﻭیﺱی
vicious	ﻭیﺱیﻭﺱ
vickers	ﻭیکﺭﺯ
vicksell	ﻭیکﺱﻝ
victor	ﻭیکﺕﻭﺭ
victorie	ﻭیکﺕﻭری
vida	ﻭیﺩﺍ
vidal	ﻭیﺩﺍﻝ
vidar	ﻭیﺩﺍر
video	ﻭیﺩیﻭ
vidi	ﻭیﺩی
vieira	ﻭییرﺍ
vieux	ﻭیﻭکﺱ
vieweg	ﻭیﻭگ
vik	ﻭیک
vikas	ﻭیکﺍﺱ
vikram	ﻭیکﺭﺍﻡ
viktor	ﻭیکﺕﻭﺭ
vila	ﻭیﻝﺍ
viladot	ﻭیﻝﺍﺩﻭﺕ
vilas	ﻭیﻝﺍﺱ
vilcans	ﻭیﻝکﺍﻥﺱ
viljo	ﻭیﻝﺝﻭ
villa	ﻭیﻝﺍ
villani	ﻭیﻝیﺍﻥی
villard	ﻭیﻝﺍﺭﺩ
vimal	ﻭیﻡﺍﻝ
vin	ﻭیﻥ
vinata	ﻭیﻥﺍﺕﺍ
vince	ﻭیﻥﺱ
vincent	ﻭیﻥﺱﻥﺕ
vine	ﻭﺍیﻥ
vineel	ﻭیﻥیﻝ
vineet	ﻭیﻥیﺕ
vineis	ﻭیﻥیﺯ
vini	ﻭیﻥی
vinko	ﻭیﻥکﻭ
vinod	ﻭیﻥﺍﺩ
vinson	ﻭیﻥﺱﻭﻥ
viola	ﻭیﻭﻝﺍ
viraf	ﻭیﺭﺍﻑ
virendra	ﻭیﺭﻥﺩﺭﺍ
virgil	ﻭیﺭﺝیﻝ
virginia	ﻭیﺭﺝیﻥیﺍ
virtanen	ﻭیﺭﺕﺍﻥﻥ
virtual	ﻭیﺭچﻭﺍﻝ
vish	ﻭیﺵ
vishal	ﻭیﺵﺍﻝ
vision	ﻭیژﻭﻥ
visionary	ﻭیژﻥﺭی
vispi	ﻭیﺱپی
visser	ﻭیﺱﺭ
vitaca	ﻭیﺕﺍکﺍ
vitali	ﻭیﺕﺍﻝی
vitaly	ﻭیﺕﺍﻝی
vitek	ﻭیﺕک
vito	ﻭیﺕﻭ
vitor	ﻭیﺕﻭﺭ
vitt	ﻭیﺕ
vitto	ﻭیﺕﻭ
vittoria	ﻭیﺕﻭﺭیﺍ
viva	ﻭیﻭﺍ
vivek	ﻭیﻭک
vizen	ﻭیﺯﻥ
vlaardingen	ﻭﻝرﺩیﻥگﻥ
vladack	ﻭﻝﺍﺩﺍک
vladan	ﻭﻝﺍﺩﺍﻥ
vladica	ﻭﻝﺍﺩیکﺍ
vlado	ﻭﻝﺍﺩﻭ
voccia	ﻭککیﺍ
vogel	ﻭگﻝ
vogl	ﻭگﻝ
vogler	ﻭﻭگﻝﺭ
vogtland	ﻭﻭگﺕﻝﻥﺩ
vohra	ﻭﻩﺭﺍ
voikins	ﻭکیﻥز
vojak	ﻭﻭﺝﺍک
voket	ﻭکﺕ
volcheck	ﻭﻭﻝچک
voldman	ﻭﻝﺩﻡﻥ
volk	ﻭﻝک
volkerding	ﻭﻝکرﺩیﻥگ
volkman	ﻭﻝکﻡﺍﻥ
voll	ﻭﻝ
volodin	ﻭﻝﻭﺩیﻥ
voltmer	ﻭﻝﺕﻡﺭ
volz	ﻭﻝﺯ
von	ﻭﻥ
vonk	ﻭﺍﻥک
voorhies	ﻭﻭﺭﻩیﺯ
voorhout	ﻭرﻩﺍﺕ
vos	ﻭﺱ
voss	ﻭﺍﺱ
vost	ﻭﺍﺱﺕ
vostinic	ﻭﺱﺕیﻥیک
vowles	ﻭﻭﻝﺯ
vrouwtje	رﻭﺕﺝ
wachs	ﻭﺍچﺱ
wack	ﻭک
wafa	ﻭﺍﻑﺍ
wafiqah	ﻭﺍﻑیکﺍﻩ
wafiyyah	ﻭﺍﻑیﺍ
wagle	ﻭﺍگﻝ
wagner	ﻭگﻥﺭ
wagnon	ﻭگﻥﻭﻥ
wah	ﻭﺍﻩ
wahibah	ﻭﺡیﺏﺍ
wai	ﻭی
wail	ﻭیﻝ
waingrow	ﻭﺍیﻥگﺭﻭ
wainstead	ﻭیﻥﺱﺕﺩ
waite	ﻭیﺕ
waites	ﻭیﺕﺯ
wajihah	ﻭﺝیﺡﻩ
wake	ﻭیک
wakehouse	ﻭیکﻩﻭﺱ
wal	ﻭﺍﻝ
waldmann	ﻭﺍﻝﺩﻡﺍﻥ
waldmanneuenna	ﻭﺍﻝﺩﻡﺍﻥیﻭﻥﺍ
waldo	ﻭﺍﻝﺩﻭ
waldram	ﻭﺍﻝﺩﺭﺍﻡ
walend	ﻭﺍﻝﻥﺩ
walenta	ﻭﻝﻥﺕﺍ
walford	ﻭﺍﻝﻑﻭﺭﺩ
walidah	ﻭﻝیﺩﻩ
walka	ﻭﺍﻝکﺍ
walker	ﻭﺍکر
walkerdine	ﻭﺍکﺭﺩﺍیﻥ
wall	ﻭﺍﻝ
wallace	ﻭﺍﻝیﺱ
walle	ﻭﺍﻝﻩ
wallet	ﻭﺍﻝﺕ
wallewein	ﻭﺍﻝﻭیﻥ
wallin	ﻭﺍﻝیﻥ
wallis	ﻭﺍﻝیﺱ
wallman	ﻭﺍﻝﻡﻥ
wallner	ﻭﺍﻝﻥﺭ
walls	ﻭﺍﻝﺯ
wally	ﻭﺍﻝی
walmsley	ﻭﺍﻝﻡﺯﻝی
walser	ﻭﺍﻝﺱﺭ
walsh	ﻭﺍﺵ
walshe	ﻭﺍﻝﺵ
walter	ﻭﺍﻝﺕﺭ
walters	ﻭﺍﻝﺕﺭﺯ
walth	ﻭﺍﻝﺕ
waltman	ﻭﺍﻝﺕﻡﻥ
walton	ﻭﺍﻝﺕﻥ
waltram	ﻭﺍﻝﺕرﺍﻡ
walts	ﻭﺍﻝﺕﺯ
walworth	ﻭﺍﻝﻭﺭﺕ
walz	ﻭﺍﻝﺯ
wan	ﻭﺍﻥ
warborough	ﻭرﺏﻭرﻭﻑ
warburton	ﻭﺍﺭﺏﺭﺕﻭﻥ
warda	ﻭرﺩﺍ
wardell	ﻭﺍﺭﺩﻝ
ware	ﻭیﺭ
warland	ﻭﺍرﻝﻥﺩ
warn	ﻭﺍﺭﻥ
warne	ﻭﺍﺭﻥ
warner	ﻭﺍﺭﻥﺭ
warren	ﻭﺍﺭﻥ
wasay	ﻭﺱی
waseem	ﻭﺍﺱیﻡ
washington	ﻭﺍﺵیﻥگﺕﻭﻥ
wasik	ﻭﺍﺱیک
wasit	ﻭﺍﺱیط
waskey	ﻭﺍﺱکی
waslo	ﻭﺍﺱﻝﻭ
wasson	ﻭیﺱﻭﻥ
watanabe	ﻭﺍﺕﺍﻥیﺏ
waterman	ﻭﺍﺕﺭﻡﻥ
watkins	ﻭﺍﺕکیﻥﺯ
watrous	ﻭﺍﺕﺭﻭﺱ
watt	ﻭﺍﺕ
watters	ﻭﺍﺕرﺯ
watterson	ﻭﺍﺕﺭﺱﻭﻥ
wattles	ﻭﺍﺕﻝﺯ
wavle	ﻭﺍﻝﻭ
way	ﻭی
wayne	ﻭیﻥ
weadock	ﻭیﺩﺍک
weage	ﻭیگ
weare	ﻭیﺭ
weast	ﻭیﺱﺕ
weaston	ﻭیﺱﺕﻭﻥ
weaver	ﻭیﻭﺭ
weaverling	ﻭیﻭﺭﻝیﻥگ
webb	ﻭﺏ
webber	ﻭیﺏر
weber	ﻭﺏﺭ
webster	ﻭﺏﺱﺕﺭ
wechner	ﻭچﻥﺭ
wedberg	ﻭﺩﺏﺭگ
weddle	ﻭﺩﻝ
wedelin	ﻭﺩﻝیﻥ
wedemeier	ﻭﺩﻡیﺭ
wee	ﻭی
weedon	ﻭیﺩﻭﻥ
weeks	ﻭیکﺱ
weers	ﻭیﺭﺯ
wegert	ﻭیگﺭﺕ
wegner	ﻭگﻥﺭ
wei	ﻭی
weibel	ﻭیﺏﻝ
weidner	ﻭﺍیﺩﻥﺭ
weiermann	ﻭیﺭﻡﻥ
weigand	ﻭیگﺍﻥﺩ
weigel	ﻭیگﻝ
weigend	ﻭیﺝﻥﺩ
weikamp	ﻭیکﺍﻡپ
weiland	ﻭیﻝﻥﺩ
weiler	ﻭیﻝﺭ
weimann	ﻭیﻡﺍﻥ
weimar	ﻭیﻡﺭ
wein	ﻭیﻥ
weinberg	ﻭیﻥﺏﺭگ
weinelt	ﻭیﻥﻝﺕ
weiner	ﻭیﻥﺭ
weinert	ﻭیﻥﺭﺕ
weinstock	ﻭیﻥﺱﺕﻭک
weintz	ﻭﻥﺕﺯ
weir	ﻭیر
weisbeck	ﻭیﺱﺏک
weisberg	ﻭیﺱﺏرگ
welam	ﻭﻝﺍﻡ
welber	ﻭﻝﺏﺭ
welch	ﻭﻝچ
wellemtje	ﻭیﻝﻡﺕﺝی
wellingk	ﻭﻝیﻥک
wellington	ﻭﻝیﻥگﺕﻭﻥ
wellman	ﻭﻝﻡﻥ
wells	ﻭﻝﺯ
welsh	ﻭﻝﺵ
welter	ﻭﻝﺕﺭ
welton	ﻭﻝﺕﻭﻥ
welty	ﻭﻝﺕی
welzel	ﻭﻝﺯﻝ
wen	ﻭﻥ
wench	ﻭﻥچ
wende	ﻭﻥﺩ
wendel	ﻭﻥﺩﻝ
wendell	ﻭﻥﺩﻝ
weninger	ﻭﻥیﻥگﺭ
wensel	ﻭﻥﺱﻝ
wentworth	ﻭیﻥﺕﻭرﺕ
wentz	ﻭﻥﺕﺯ
wentzel	ﻭﻥﺕﺯﻝ
werbner	ﻭرﺏﻥر
wermont	ﻭﺭﻡﻭﻥﺕ
wern	ﻭرﻥ
wernegreen	ﻭﺭﻥگﺭیﻥ
werner	ﻭﺍﺭﻥﺭ
werry	ﻭﺭی
wershoven	ﻭﺭﺵﻭﻭﻥ
werther	ﻭرﺩر
wes	ﻭﺱ
wesen	ﻭیﺱﻥ
wesley	ﻭﺱﻝی
wesleyan	ﻭﺱﻝیﺍﻥ
wessel	ﻭیﺱﻝ
wesselius	ﻭزﻝیﻭﺱ
wesson	ﻭیﺱﻭﻥ
west	ﻭﺱﺕ
westcott	ﻭﺱﺕکﺍﺕ
wester	ﻭﺱﺕﺭ
western	ﻭﺱﺕﺭﻥ
westerveldt	ﻭﺱﺕرﻭﻝﺕ
westfall	ﻭﺱﺕﻑﺍﻝ
westley	ﻭﺱﺕﻝی
westmoreland	ﻭﺱﺕﻡﻭﺭﻝﻥﺩ
westover	ﻭﺱﺕﻭﺭ
westphal	ﻭیﺱﺕﻑﺍﻝ
westpoint	ﻭﺱپﻭیﻥﺕ
wet	ﻭﺕ
wetherwax	ﻭیﺕرﻭﺍکﺱ
wetmore	ﻭﺕﻡﻭﺭ
weule	ﻭیﻝﻭ
whale	ﻭﺍﻝﻩ
whalen	ﻭﺍﻝﻥ
whaley	ﻭﺍﻝی
whalley	ﻭﺍﻝی
wharton	ﻭﺍﺭﺕﻭﻥ
whatley	ﻭﺍﺕﻝی
whealton	ﻭیﻝﺕﻭﻥ
wheat	ﻭیﺕ
wheaton	ﻭیﺕﻥ
whetstone	ﻭﺕﺱﺕﻭﻥ
whillans	ﻭیﻝیﺍﻡز
whinen	ﻭیﻥﻥ
whitacre	ﻭیﺕﺍکﺭﻩ
whitaker	ﻭیﺕیکﺭ
whitcomb	ﻭیﺕکﺍﻡﺏ
white	ﻭﺍیﺕ
whiteaker	ﻭﺍیﺕیکﺭ
whitehorn	ﻭﺍیﺕﻩﺭﻥ
whitehouse	ﻭﺍیﺕﻩﺍﻭﺱ
whitfield	ﻭیﺕﻑیﻝﺩ
whitley	ﻭﺍیﺕﻝی
whitmore	ﻭیﺕﻡﺭ
whitson	ﻭیﺕﺱﻭﻥ
whittaker	ﻭیﺕﺍکﺭ
whittemore	ﻭیﺕﻡﻭﺭ
whitten	ﻭﺍیﺕﻥ
whittenburg	ﻭیﺕﻥﺏﺭگ
whittington	ﻭیﺕیﻥگﺕﻭﻥ
whitty	ﻭیﺕی
whitwell	ﻭیﺕﻭﻝ
whitworth	ﻭﺍیﺕﻭﺭﺱ
whorfin	ﻭﺭﻑیﻥ
whorwood	ﻭﺭﻭﻭﺩ
whyte	ﻭﺍیﺕ
wiberg	ﻭیﺏﺭگ
wichura	ﻭیچﻭﺭﺍ
wickham	ﻭیکﻩﺍﻡ
wicks	ﻭیکﺱ
widdul	ﻭیﺩﺍﻝ
wide	ﻭﺍیﺩ
widere	ﻭیﺩیﺭ
wido	ﻭﺍیﺩﻭ
wiebe	ﻭیﺏ
wied	ﻭیﺩ
wiegand	ﻭیگﺍﻥﺩ
wieland	ﻭیﻝﻥﺩ
wiepkje	ﻭیپک
wier	ﻭیﺭ
wierse	ﻭییﺭﺱ
wiest	ﻭیﺱﺕ
wiewer	ﻭیﻭﻭﺭ
wifall	ﻭیﻑﺍﻝ
wiggin	ﻭیگﺝیﻥ
wiggins	ﻭیگیﻥﺯ
wigle	ﻭﺍیگﻝ
wigmore	ﻭیگﻡﻭﺭ
wigston	ﻭیگﺱﺕﻭﻥ
wigton	ﻭیگﺕﻭﻥ
wigum	ﻭیگﻭﻡ
wijbrand	ﻭیژﺏرﺍﻥﺩ
wijdan	ﻭیﺝﺩﺍﻥ
wijnand	ﻭیژﻥﺍﻥﺩ
wiklund	ﻭیکﻝﻭﻥﺩ
wilber	ﻭیﻝﺏﺭ
wilcox	ﻭیﻝکﺍکﺱ
wilcoxon	ﻭیﻝکﺍکﺱﻭﻥ
wildcat	ﻭیﻝﺩکﺍﺕ
wilder	ﻭﺍیﻝﺩﺭ
wilderman	ﻭیﻝﺩﺭﻡﻥ
wildfong	ﻭیﺩﻑﺍﻥگ
wilding	ﻭیﻝﺩیﻥگ
wiles	ﻭیﻝﺱ
wiley	ﻭیﻝی
wilfred	ﻭیﻝﻑﺭﺩ
wilhelm	ﻭیﻝﻩﻝﻡ
wilhelmina	ﻭیﻝﻝﻡیﻥﺍ
wilhelmus	ﻭیﻝﻝﻡﻭﺱ
wilhite	ﻭیﻝﻩﺍیﺕ
wilken	ﻭیﻝکﻥ
wilkens	ﻭیکﻥﺯ
wilkerson	ﻭیﻝکﺭﺱﻭﻥ
wilkes	ﻭیﻝکﺱ
wilkin	ﻭیﻝکیﻥ
wilkins	ﻭیﻝکیﻥﺯ
wilkinson	ﻭیﻝکیﻥﺱﻥ
will	ﻭیﻝ
willats	ﻭیﻝﺍﺕﺯ
willemintje	ﻭیﻝﻡیﻥیﺕﻩ
willemyn	ﻭیﻝیﻡیﻥ
willey	ﻭیﻝی
william	ﻭیﻝیﺍﻡ
williamina	ﻭیﻝیﺍﻡیﻥﺍ
williams	ﻭیﻝییﺍﻡﺯ
williamson	ﻭیﻝیﺍﻡﺱﻭﻥ
willing	ﻭیﻝیﻥگﺯ
willingham	ﻭیﻝیﻥگﻩﺍﻡ
willis	ﻭیﻝیﺯ
willmore	ﻭیﻝﻡﻭﺭ
willmot	ﻭیﻝﻡﺕ
willour	ﻭﻝﺭ
wills	ﻭیﻝﺯ
willson	ﻭیﻝﺱﻭﻥ
willy	ﻭیﻝی
wilmer	ﻭیﻝﻡﺭ
wilmot	ﻭیﻝﻡﻭﺕ
wilmoth	ﻭﻝﻡﻭﺕ
wilson	ﻭیﻝﺱﻥ
wimberley	ﻭیﻡﺏﺭﻝی
wimmer	ﻭیﻡر
wimnorasuetha	ﻭیﻡﻥﻭرﺍﺱیﻭﺕﺍ
wimpje	ﻭیﻡپ
winchell	ﻭیﻥچﻝ
winchester	ﻭیﻥچﺱﺕﺭ
wincn	ﻭیﻥﺱﻥ
wind	ﻭیﻥﺩ
winders	ﻭیﻥﺩﺭﺯ
windom	ﻭیﻥﺩﻭﻡ
wing	ﻭیﻥگ
winget	ﻭیﻥگﺕ
winiecki	ﻭیﻥیکی
wininger	ﻭیﻥیﻥگﺭ
wink	ﻭیﻥک
winkelmann	ﻭیﻥکﻝﻡﺍﻥ
winkels	ﻭیﻥکﻝﺯ
winkle	ﻭیﻥکﻝ
winningstad	ﻭیﻥیﻥگﺱﺕﺩ
winokur	ﻭیﻥﻭکﺭ
winsor	ﻭیﻥﺱﺭ
winston	ﻭیﻥﺱﺕﻭﻥ
winstrom	ﻭیﻥﺱﺕﺭﻭﻡ
winter	ﻭیﻥﺕﺭ
winterer	ﻭیﻥﺕﺭﺭ
winterfeld	ﻭیﻥﺕﺭﻑیﻝﺩ
wintermute	ﻭیﻥﺕﺭﻡیﻭﺕ
winton	ﻭیﻥﺕﻭﻥ
wirt	ﻭیﺭﺕ
wiryana	ﻭیﺭیﺍﻥﺍ
wisdom	ﻭیﺯﺩﺍﻡ
wise	ﻭﺍیﺯ
wisehart	ﻭﺍیﺯﻩﺍرﺕ
wiseman	ﻭﺍیﺱﻡﻥ
wiser	ﻭیﺱﺭ
wiserner	ﻭیﺯﺭﻥﺭ
witchard	ﻭیچﺍﺭﺩ
withagen	ﻭیﺕﺍگﻥ
witherspoon	ﻭیﺕرﺱپﻭﻥ
witt	ﻭیﺕ
witters	ﻭیﺕﺭﺯ
wittick	ﻭیﺕیک
wold	ﻭﻝﺩ
wolfson	ﻭﻝﻑﺱﻭﻥ
wolke	ﻭﻝک
woll	ﻭﻝ
wolski	ﻭﻝﺱکی
wolter	ﻭﻝﺕر
woltering	ﻭﻝﺕریﻥگ
womble	ﻭﻡﺏﻝ
wombwell	ﻭﺍﻡﺏﻭﻝ
won	ﻭﻥ
wone	ﻭﻭﻥ
wong	ﻭﺍﻥگ
wood	ﻭﻭﺩ
woodall	ﻭﻭﺩﺍﻝ
woodard	ﻭﻭﺩﺍﺭﺩ
woodburn	ﻭﻭﺩﺏﺭﻥ
wooded	ﻭﻭﺩﺩ
wooden	ﻭﻭﺩﻥ
woodgate	ﻭﻭﺩگیﺕ
woodhouse	ﻭﻭﺩﻩﺍﻭﺱ
woodill	ﻭﺩیﻝ
woodrow	ﻭﻭﺩﺭﻭ
woods	ﻭﻭﺩﺯ
woodstock	ﻭﻭﺩﺍﺱﺕﺍک
woog	ﻭﻭگ
wook	ﻭﻭک
woolard	ﻭﻭﻝﺍﺭﺩ
woollard	ﻭﻭﻝﺍﺭﺩ
woolley	ﻭﻭﻝی
woon	ﻭﻭﻥ
worchick	ﻭﺭچیک
worden	ﻭﻭﺭﺩﻥ
workman	ﻭﺭکﻡﻥ
works	ﻭﺭکﺱ
worley	ﻭرﻝی
worling	ﻭﺭﻝیﻥگ
worrilow	ﻭریﻝﺍﻭ
wouter	ﻭﺕر
wren	ﺭﻥ
wright	ﺭﺍیﺕ
wrobel	ﻭﺭﻭﺏﻝ
wun	ﻭﻭﻥ
wust	ﻭﺍﺱﺕ
wusta	ﻭﺱطی
wyman	ﻭیﻡﺍﻥ
wymmerzwet	ﻡﺍیﻡرزﺕ
wyntje	ﻭیﻥﺕ
xaros	ﺯﺍﺭﻭﺱ
yacob	یﺍکﻭﺏ
yafiah	یﺍﻑیﺍ
yager	یﺍگﺭ
yahsi	یﺍﺱی
yakootah	یکﻭﺕﺍﻩ
yamaha	یﺍﻡﺍﻩﺍ
yamha	یﺍﻡﺍﻩﺍ
yan	یﺍﻥ
yanco	یﺍﻥکﻭ
yang	یﺍﻥگ
yangi	یﺍﻥگی
yaniv	یﺍﻥیﻭ
yankee	یﺍﻥکی
yanson	یﺍﻥﺱﻭﻥ
yap	یﺍپ
yarman	یﺍﺭﻡﺍﻥ
yarnall	یﺍرﻥﺍﻝ
yarnick	یﺍﻥیک
yaron	یﺍﺭﻭﻥ
yaros	یﺍﺭﻭﺱ
yaryan	یﺍﺭیﺍﻥ
yasar	یﺍﺱر
yaser	یﺍﺱﺭ
yasin	یﺍﺱیﻥ
yasirah	یﺍﺱیرﺍﻩ
yasmine	یﺍﺱﻡیﻥ
yasuo	یﺍﺱﻭ
yat	یﺍﺕ
yates	ییﺕﺯ
yauman	یﺍﻡﻥ
yaw	یﺍﻭ
yazid	یزیﺩ
yearwood	ﺍیﺭﻭﻭﺩ
yeatman	ییﺕﻡﺍﻥ
yeats	ییﺕﺯ
yeka	ییکﺍ
yelich	یﻝیچ
yelland	یﻝﻥﺩ
yellow	یﻝﻝﻭ
yerbury	یرﺏری
yerger	یﺍﺭگﺭ
yermo	یﻭﺭﻡﻭ
yetter	یﺕﺭ
yok	یﻭک
yonas	یﻭﻥﺍﺱ
yongsup	یﻭﻥگﺱﺍپ
york	یﻭﺭک
yosef	یﻭﺯﻑ
yoshio	یﻭﺵیﻭ
yossi	یﻭﺱی
yossy	یﻭﺱی
yost	یﺍﺱﺕ
youens	یﻭیﻥز
youlin	یﻭﻝیﻥ
youmans	یﻭﻡﺍﻥﺱ
young	یﺍﻥگ
younger	یﺍﻥگﺭ
youngs	یﺍﻥگﺯ
youse	یﻭﺱ
yousten	یﻭﺱﺕﻥ
yumn	یﺍﻡﻥ
yzaak	زﺍک
zabel	ﺯﺍﺏﻝ
zach	ﺯﺍخ
zachary	ﺯﺍچﺍﺭی
zafina	زﺍﻑیﻥﺍ
zafir	زﻑیر
zagar	ﺯﺍگﺍﺭ
zahara	زﻩرﺍ
zahid	زﺍﻩیﺩ
zahin	ﺯﻩیﻥ
zahir	زﻩیر
zahirah	زﻩرﺍ
zahra	زﻩرﺍ
zaida	زیﺩﺍ
zaim	زیﺍﻡ
zainab	زیﻥﺏ
zaira	زیرﺍ
zaki	ذکی
zakiyyah	ذکیﺍﻩ
zalan	ﺯﺍﻝﺍﻥ
zammit	زﺍﻡیﺕ
zand	ﺯﻥﺩ
zang	ﺯﻥگ
zangerl	ﺯﺍﻥگﺭﻝ
zanneke	زﺍﻥک
zanon	ﺯﺍﻥﻭﻥ
zapantis	ﺯﺍپﺍﻥﺕیﺱ
zara	زرﺍ
zarifa	زریﻑﺍ
zarqa	زرکﺍ
zawr	زر
zayac	ﺯﺍیﺍک
zaynah	ریﻥﺍﻩ
zayt	ﺯﺍیﺕ
zaza	زز
zeacle	زکﻝ
zec	ﺯک
zeke	ذک
zell	ﺯﻝ
zella	ﺯﻝﺍ
zeller	ﺯﻝﺭ
zeman	ﺯﻡﺍﻥ
zemanek	ﺯﻡﺍﻥک
zen	ﺯﻥ
zepeda	ﺯیپیﺩﺍ
zepka	ﺯپکﺍ
zeyer	ﺯیﺭ
zimmer	ﺯیﻡﺭ
zimraan	زیﻡرﺍﻥ
zions	ﺯیﻭﻥﺯ
zito	ﺯیﺕﻭ
zitser	ﺯیﺕﺱﺭ
zjarritjen	زﺍریﺕﻥ
zocca	ﺯﻭکﺍ
zoerink	زﺍریﻥک
zola	ﺯﻭﻝﺍ
zold	ﺯﻭﻝﺩ
zolmer	ﺯﻭﻝﻡﺭ
zontek	ﺯﻭﻥﺕک
zor	ﺯﻭر
zubaidah	زﺏیﺩﻩ
zuleika	ذﻭﻝکیﺍ
zurink	زریﻥک
zuvieta	زﻭیﺕﺍ
zygmunt	ﺯیگﻡﻭﻥﺕ
zyl	ﺯیﻝ
