abdalmalik	ﺍﺏﺩﻝﻡﺍﻝیک
abeltje	ﺍﺏﻝﺕ
abernathy	ﺍﺏﺭﻥﺍﺕی
abiab	ﺍﺏیﺍﺏ
access	ﺍکﺱﺱ
acosta	ﺍکﻭﺱﺕﺍ
adalma	ﺍﺩﻝﻡﺍ
adana	ﺍﺩﺍﻥﺍ
aden	ﺍﺩﻥ
adept	ﺍﺩپﺕ
adis	ﺍﺩیﺱ
admirals	ﺍﺩﻡیﺭﺍﻝﺯ
adventure	ﺍﺩﻭﻥچﺭ
aetje	ﺍیﺕ
afaf	ﺍﻑﺍﻑ
agent	ﺍﺝﻥﺕ
agren	ﺍگﺭﻥ
airay	ﺍریﺍ
aitsen	ﺍیﺕﺱﻥ
akkana	ﺍکﺍﻥﺍ
alden	ﺍﻝﺩﻥ
alder	ﺍﻝﺩﺭ
aliya	ﻉﻝیﺍ
alkabeer	ﺍﻝکﺏر
allain	ﺍﻝیﻥ
allon	ﺍﻝﻭﻥ
alm	ﺍﻝﻡ
alvarez	ﺍﻝﻭﺍﺭﺯ
alvestad	ﺍﻝﻭﺱﺕﺍﺩ
amanda	ﺍﻡﺍﻥﺩﺍ
ambler	ﺍﻡﺏﻝﺭ
amethysta	ﺍﻡﺕیﺱﺕﺍ
amiot	ﺍﻡیﻭﺕ
anagram	ﺍﻥﺍگﺭﺍﻡ
analog	ﺍﻥﺍﻝﻭگ
anay	ﺍﻥﺍی
ander	ﺍﻥﺩﺭ
andor	ﺍﻥﺩﻭﺭ
angelis	ﺍﻥﺝﻝیﺱ
anglesea	ﺍﻥﺝﻝیﺱیﺍ
anhold	ﺍﻥﻩﻝﺩ
anne	ﺍﻥ
annette	ﺍﻥﺕﻩ
anta	ﺍﻥﺕﺍ
antal	ﺍﻥﺕﺍﻝ
antevs	ﺍﻥﺕﻭﺱ
anthonis	ﺍﻥﺕﻭﻥیﺱ
antonio	ﺍﻥﺕﻭﻥیﻭ
antonus	ﺍﻥﺕﻭﻥﺍﺱ
anuj	ﺍﻥﻭﺝ
appleman	ﺍپﻝﻡﻥ
aragula	ﺍﺭﺍگﻭﻝﺍ
argyle	ﺍرگیﻝ
aronov	ﺍرﻥﻭ
ascoly	ﺍﺱکﻭﻝی
astik	ﺍﺱﺕیک
athey	ﺍﺕی
athos	ﺍﺕﻭﺱ
atkinson	ﺍﺕکیﻥﺱﻥ
atusi	ﺍﺕﻭﺱی
aubrey	ﺍﺏری
aurkleven	ﺍﻭﺭکﻝیﻭﻥ
austhamaren	ﺍﻭﺱﺕﻩﺍﻡﺍﺭﻥ
averell	ﺍﻭریﻝ
avram	ﺍﻭﺭﺍﻡ
awasthi	ﺍﻭﺍﺱﺕی
ayesha	ﺍیﺵﺍ
aylor	ﺍیﻝﻭﺭ
ayres	ﺍیرز
ayse	ﺍیﺱی
babcock	ﺏﺏکﺍک
bagade	ﺏﺍگیﺩ
bagga	ﺏﺍگﺍ
bahro	ﺏﻩﺭﻭ
balkan	ﺏﺍﻝکﺍﻥ
ballance	ﺏﺍﻝﺍﻥﺱ
balmaseda	ﺏﺍﻝﻡﺍﺱﺩﺍ
balzer	ﺏﺍﻝﺯﺭ
bankler	ﺏﺍﻥکﻝﺭ
baranowski	ﺏﺍﺭﺍﻥﻭﺱکی
barath	ﺏﺍﺭﺍﺱ
barbee	ﺏﺍﺭﺏی
bardsdell	ﺏیرﺩﺱﺩﻝ
bareface	ﺏیﺭﻑیﺱ
barendt	ﺏرﻥﺕ
barkah	ﺏﺭکﺍﻩ
barnacle	ﺏﺍرﻥﺍکﻝ
barr	ﺏﺍﺭ
barrett	ﺏﺍﺭﺕ
barry	ﺏﺍﺭی
barta	ﺏﺍﺭﺕﺍ
barthakur	ﺏﺍﺭﺕکﻭﺭ
bartholomew	ﺏرﺕﻭﻝﻡﻭ
basalat	ﺏﺍﺱﺍﻝﺍﺕ
basil	ﺏﺍﺱیﻝ
basle	ﺏﺱﻝ
basma	ﺏﺍﺱﻡﺍ
batterbee	ﺏﺍﺕﺭﺏی
bauhs	ﺏﺍﻭﺱ
baum	ﺏﺍﻭﻡ
bayla	ﺏﺍیﻝﺍ
beaman	ﺏیﻡﻥ
beat	ﺏیﺕ
becky	ﺏکی
bedo	ﺏیﺩﻭ
beetle	ﺏیﺕﻝ
belinda	ﺏﻝیﻥﺩﺍ
bench	ﺏﻥچ
benner	ﺏﻥﺭ
bennetts	ﺏﻥﺕﺯ
beqaa	ﺏکﺍ
bertelson	ﺏﺭﺕﻝﺱﻭﻥ
besbris	ﺏﺱﺏﺭیﺱ
beshears	ﺏﺵیرﺯ
bess	ﺏﺱ
bettig	ﺏﺕیگ
bevin	ﺏﻭیﻥ
beyer	ﺏیﺭ
bieber	ﺏیﺏﺭ
bingen	ﺏیﻥﺝﻥ
binoy	ﺏیﻥﻭی
bir	ﺏیﺭ
birznieks	ﺏیرﺯﻥیکﺱ
blais	ﺏﻝﺍیﺱ
blight	ﺏﻝﺍیﺕ
blohm	ﺏﻝﻭﻩﻡ
blosser	ﺏﻝﺍﺱﺭ
blues	ﺏﻝﻭﺱ
blumenfeld	ﺏﻝﻭﻡﻥﻑﻝﺩ
bodapati	ﺏﻭﺩﺍپﺍﺕی
boerkoel	ﺏرکﻭﻝ
boggs	ﺏﺍگﺯ
boily	ﺏیﻝی
boisvert	ﺏﻭیﺱﻭﺭﺕ
bok	ﺏﺍک
bonds	ﺏﺍﻥﺩﺯ
boniface	ﺏﺍﻥیﻑیﺱ
bonnabeau	ﺏﺍﻥﺍﺏیﻭ
borg	ﺏﺭگ
bose	ﺏﻭﺱ
bosley	ﺏﻭﺱﻝی
boss	ﺏﺍﺱ
bouma	ﺏﻭﻡﺍ
boxberger	ﺏﺍکﺱﺏﺭگﺭ
bozkurt	ﺏﻭﺯکﺍﺭﺕ
bozzi	ﺏﻭﺯی
bran	ﺏﺭﺍﻥ
brandon	ﺏرﻥﺩﻭﻥ
brandy	ﺏﺭﻥﺩی
brashier	ﺏﺭﺍﺵﺍیﺭ
brassard	ﺏﺭﺍﺱﺍﺭﺩ
breeding	ﺏﺭیﺩیﻥگ
breedlove	ﺏﺭیﺩﻝﺍﻭ
brennon	ﺏرﻥﻭﻥ
breton	ﺏﺭیﺕﻭﻥ
brewer	ﺏﺭیﻭﺭ
brigje	ریگ
brisbin	ﺏﺭیﺱﺏیﻥ
britton	ﺏﺭییﺕﻭﻥ
broadfield	ﺏﺭﻭﺩﻑیﻝﺩ
brode	ﺏﺭﺍﺩ
broka	ﺏرﻭکﺍ
bromley	ﺏﺭﻭﻡﻝی
brougham	ﺏﺭﺍگﻩﺍﻡ
bruck	ﺏﺭﻭک
brummett	ﺏرﻭﻡﺕ
bryon	ﺏﺭیﻭﻥ
buono	ﺏﻭﻥﻭ
burgess	ﺏﺭگﺱ
burhan	ﺏرﻩﺍﻥ
burton	ﺏﺍﺭﺕﻥ
busick	ﺏﻭﺱیک
bussiere	ﺏیﺯیﺭ
bustamam	ﺏﺍﺱﺕﺍﻡﺍﻥ
butterfly	ﺏﺍﺕﺭﻑﻝﺍی
cabe	کیﺏ
cabell	کﺍﺏﻝ
cabrello	کﺍﺏﺭیﻝﻭ
cadman	کﺍﺩﻡﻥ
calico	کﺍﻝیکﻭ
callahan	کﺍﻝﺍﻩﺍﻥ
callis	کﺍﻝیﺱ
calverley	کﺍﻝﻭﺭﻝی
carbajal	کﺍﺭﺏﺍﺝﺍﻝ
carolyn	کﺍﺭﻭﻝیﻥ
carrasco	کﺍﺭﺍﺱکﻭ
carrelli	کﺍرﻝی
casner	کﺍﺱﻥﺭ
castano	کﺍﺱﺕﺍﻥﻭ
castillo	کﺍﺱﺕیﻝﻭ
castle	کﺱﺕﻝ
cat	کﺕ
cataldo	کﺍﺕﺍﻝﺩﻭ
catanzaro	کﺕﻥﺯﺭﻭ
catrijn	کﺍﺕریﺝ
cavasin	کﺍﻭﺍﺱیﻥ
celio	ﺱﻝیﻭ
celitje	ﺱیﻝیﺕ
chandran	چﺍﻥﺩﺭﺍﻥ
chantal	چﺍﻥﺕﺍﻝ
charlyn	چﺍﺭﻝیﻥ
chaun	چﺍﻭﻥ
chauvet	چﺍیﻭﻭﺕ
chavda	چﺍﻭﺩﺍ
cheek	چیک
cheeks	چیکﺯ
cheshire	چیﺵﺍیﺭ
chesney	چﺱﻥی
childers	چیﻝﺩرﺯ
chin	چیﻥ
chiram	چیﺭﺍﻡ
chisholm	چیﺵﻭﻝﻡ
chiu	چیﻭ
chizoba	چیﺯﻭﺏﺍ
chovanak	چﻭﻭﺍﻥﺍک
christoe	کﺭیﺱﺕﻭ
christou	کﺭیﺱﺕﻭ
chrons	کﺭﻭﻥﺯ
chu	چﻭ
chua	چﻭﺍ
clack	کﻝﺍک
claridge	کﻝﺍﺭیﺝ
clawsie	کﻝﺍﻭﺱی
cline	کﻝﺍیﻥ
clugston	کﻝﺍگﺱﺕﻭﻥ
coatney	کﻭﺕﻥی
coccia	کﻭکیﺍ
codogno	کﻭﺩﻭگﻥﻭ
coffee	کﺍﻑی
coley	کﻝی
colin	کﻭﻝیﻥ
colman	کﻭﻝﻡﻥ
combs	کﺍﻡﺏﺯ
conduit	کﺍﻥﺩﻭییﺕ
conerly	کﺍﻥﺭﻝی
confer	کﺍﻥﻑﺭ
corridor	کﻭﺭیﺩﻭﺭ
couchman	کﻭچﻡﻥ
crary	کرﺍری
craters	کﺭﺍﺕﺭﺯ
cray	کﺭی
crespo	کﺭﺱپﻭ
crispijn	کریﺱپیﺝﻥ
cronheim	کﺭﻭﻥﻩیﻡ
crumbach	ﺱﺭﻭﻡﺏچ
cunniff	کﺍﻥیﻑ
cuthbert	کﺍﺕﺏﺭﺕ
cutler	کﺍﺕﻝیﺭ
cyr	ﺱیﺭ
dabney	ﺩﺍﺏﻥی
dais	ﺩﺍیﺱ
dallard	ﺩﻝﺭﺩ
damis	ﺩﻡیﺱ
dangoor	ﺩﻥﺝﻭﺭ
danilo	ﺩﺍﻥیﻝﻭ
darde	ﺩﺭﺩﻩ
darley	ﺩﺍﺭﻝی
darnall	ﺩرﻥﺍﻝ
davi	ﺩیﻭیﺩ
davidsen	ﺩیﻭیﺩﺱﻥ
dawood	ﺩﺍﻭﺩ
dea	ﺩی
degraw	ﺩیگﺭﻭ
deicher	ﺩیچیﺭ
dekok	ﺩکک
delany	ﺩیﻝﺍﻥی
dellis	ﺩﻝیﺱ
dempsey	ﺩﻡپﺱی
denault	ﺩﻥﺍﻭﻝﺕ
deng	ﺩﻥگ
dennis	ﺩﻥیز
derek	ﺩﺭک
desmoulins	ﺩﺱﻡﻭﻝیﻥﺯ
desoto	ﺩﺱﻭﺕﻭ
dessent	ﺩیﺱﻥﺕ
devine	ﺩیﻭﺍیﻥ
diaboli	ﺩیﺍﺏﻭﻝی
dial	ﺩﺍیﺍﻝ
dickson	ﺩیکﺱﻭﻥ
dik	ﺩیک
dil	ﺩیﻝ
diller	ﺩیﻝﺭ
dilligan	ﺩﺍیﻝﺍیگﺍﻥ
dimitar	ﺩیﻡیﺕﺍﺭ
ding	ﺩیﻥگ
dino	ﺩیﻥﻭ
dipetro	ﺩیپیﺕرﻭ
dippold	ﺩیپﻝﺩ
divakaran	ﺩیﻭﺍکرﺍﻥ
doctress	ﺩﺍکﺕرﺱ
dodman	ﺩﺍﺩﻡﻥ
doe	ﺩﻭ
dolenec	ﺩﻭﻝیﻥک
dollinger	ﺩﺍﻝیﻥگﺭ
domenig	ﺩﻭﻡﻥیگ
donath	ﺩﻭﻥﺍﺕ
donato	ﺩﻭﻥﺍﺕﻭ
doolittle	ﺩﻭﻝیﺕﻝ
dorrel	ﺩﻭﺭﻝ
dorsett	ﺩﻭﺭﺱﺕ
doug	ﺩﻭگ
dougal	ﺩﻭگﺍﻝ
dove	ﺩﺍﻭ
downing	ﺩﺍﻭﻥیﻥگ
drachman	ﺩﺭچﻡﻥ
drag	ﺩﺭگ
dreamer	ﺩﺭیﻡﺭ
driedger	ﺩﺭیﺝﺭ
dror	ﺩﺭﻭﺭ
dubuque	ﺩﺍﺏﺍکیﻭ
duckworth	ﺩﺍکﻭﺭث
duken	ﺩﺍکﻥ
dungane	ﺩﺍﻥگﻥ
dupree	ﺩﺍپﺭی
duse	ﺩﻭﺱ
dustin	ﺩﻭﺱﺕیﻥ
ear	ﺍﺭ
ebert	ﺍﺏﺭﺕ
edberg	ﺍﺩﺏﺭگ
eddey	ﺍﺩی
edginton	ﺍﺝیﻥﺕﻭﻥ
egbert	ﺍگﺏرﺕ
egerton	ﺍگرﺕﻥ
egilsson	ﺍگیﻝﺱﻭﻥ
einke	ﺍیﻥکﻩ
ekwall	ﺍکﻭﺍﻝ
eleveld	ﺍﻝﻭﻝﺩ
elia	ﺍﻝیﺍ
ellwanger	ﺍﻝﻭﺍﻥگر
eloisa	ﺍیﻝﻭیﺯﺍ
elsie	ﺍﻝﺱی
elspeth	ﺍﻝﺱپﺩ
elya	ﺍﻝییﺍ
emil	ﺍﻡیﻝ
empereur	ﺍﻡپﺭﻭﺭ
engelhardt	ﺍﻥگﻝﻩﺍﺭﺩ
engwall	ﺍﻥگﻭﺍﻝ
enigma	ﺍﻥیﺝﻡﺍ
enrico	ﺍﻥﺭیکﻭ
enzo	ﺍﻥﺯﻭ
erdmann	ﺍﺭﺩﻡﻥ
ermrey	ﺍﺭﻡﺭی
estes	ﺍﺱﺕﺱ
estrugo	ﺍیﺱﺕﺭﺍگﻭ
ettinger	ﺍﺕیﻥگﺭ
eugene	ﺍیﻭگﻥﻩ
evans	ﺍیﻭﺍﻥﺯ
everhart	ﺍﻭرﻩرﺕ
every	ﺍﻭﺭی
fach	ﻑﺍک
fagan	ﻑﺍگﺍﻥ
fair	ﻑیﺭ
fairhurst	ﻑیﺭﻩﺭﺱﺕ
fales	ﻑﺍﻝﺯ
farley	ﻑﺍﺭﻝی
faust	ﻑﺍﻭﺱﺕ
faverty	ﻑﺍﻭرﺕی
feather	ﻑﺩﺭ
fechner	ﻑچﻥﺭ
feland	ﻑﻝﺍﻥﺩ
felawka	ﻑﻝﺍﻭکﺍ
fenner	ﻑﻥﺭ
fenwick	ﻑﻥﻭیک
ferrington	ﻑﺭیﻥگﺕﻭﻥ
fetch	ﻑﺕچ
finstad	ﻑیﻥﺱﺕﺍﺩ
flesti	ﻑﻝﺱﺕی
fletje	ﻑﻝیﺝﻩ
flora	ﻑﻝﻭﺭﺍ
florek	ﻑﻝﻭﺭک
florian	ﻑﻝﻭﺭیﻥ
fluckiger	ﻑﻝﺍکیگﺭ
flynn	ﻑﻝﺍیﻥ
fong	ﻑﺍﻥگ
fongen	ﻑﻭﻥگﻥ
fonseca	ﻑﻭﻥﺱیکﺍ
fore	ﻑﻭﺭ
forenholte	ﻑرﻥﻩﻭﻝﺕ
forero	ﻑﻭﺭﺭﻭ
forth	ﻑﻭرث
fraenkel	ﻑﺭﺍﻥکﻝ
francisco	ﻑرﺍﻥﺱیﺱکﻭ
franck	ﻑﺭﻥک
francke	ﻑﺭﻥکﻩ
francoys	ﻑرﺍﻥکﻭی
frankco	ﻑرﺍﻥکﻭ
fredette	ﻑﺭﺩﺕ
fredrick	ﻑریﺩریک
fredy	ﻑرﺩی
freeburg	ﻑﺭیﺏﺭگ
freiling	ﻑﺭیﻝیﻥگ
freivogel	ﻑﺭیﻭﻭگﻝ
freyermuth	ﻑﺭیﺭﻡﺍﺕ
fridgeir	ﻑﺭیﺩگیﺭ
friedman	ﻑﺭیﺩﻡﻥ
friel	ﻑریﻝ
friesen	ﻑﺭیﺱﻥ
frissell	ﻑریﺱﻝ
frnaciscus	ﻑرﺍﻥﺱیﺱکﺍﺱ
fuetterer	ﻑﻭﺕﺭﺭ
fulghum	ﻑﻭﻝگﺍﻡ
fuller	ﻑﻭﻝﺭ
furrows	ﻑﺭﻭﺯ
gabai	گﺍﺏﺍی
gabi	گﺏی
galea	گﺍﻝﺍ
galen	گﺍﻝﻥ
gallop	گﺍﻝپ
ganesh	گﺍﻥﺵ
garance	گﺍﺭﺍﻥﺱ
garrabrant	گﺍرﺍﺏرﺍﻥﺕ
gatrell	گﺍﺕﺭﻝ
gaudreau	گﺍﺩﺭﻭ
gayman	گﺍیﻡﻥ
geertje	گرﺕ
gellrich	گﻝﺭیک
george	ﺝرﺝ
giannasi	گیﺍﻥﺍﺱی
gibney	گیﺏﻥی
gilman	گیﻝﻡﻥ
gitnick	گیﺕﻥیک
gloyer	گﻝﺍیﺭ
goodhew	گﻭﺩﻩﻭ
gooijer	گﻭییﺝﺭ
goralwalla	گﻭﺭﺍﻝﺍﻭﺍﻝﺍ
gorden	گﺭﺩﻥ
gosling	گﺍﺱﻝیﻥگ
goutham	گﺍﺕﻩﺍﻡ
gramsas	گﺭﺍﻡﺱﺱ
graner	گریﻥر
granicher	گﺭﻥیچﺭ
grater	گﺭﺍﺕﺭ
great	گﺭیﺕ
greenidge	گﺭیﻥیﺝ
greewnood	گﺭیﻭﻥﻭﺩ
grey	گری
grinham	گﺭیﻥﻩﺍﻡ
gritton	گﺭیﺕﻭﻥ
gritz	گﺭیﺕﺯ
groenland	گﺭﻭیﻥﻝﻥﺩ
groesbeck	گرﻭﺍﺱﺏک
groin	گﺭﻭیﻥ
grundstroem	گﺭﺍﻥﺩﺍﺱﺕﺭﻭﻡ
grunenberg	گﺭﻭﻥﻥﺏﺭگ
guha	گﻭﻩﺍ
gummerus	گﺍﻡﺭﻭﺱ
gunnel	گﺍﻥﻝ
gurrola	گﺍﺭﻭﻝﺍ
gus	گﺍﺱ
guslick	گﺍﺱﻝیک
gwin	گﻭیﻥ
gwyn	ﺝﻭﺍیﻥ
gyokers	گﺍیﻭکرﺯ
hafer	ﻩﺍﻑﺭ
hafs	ﺡﺩﺱ
hak	ﻩک
hakeem	ﺡکیﻡ
haleger	ﻩﺍﻝگﺭ
hamachi	ﻩﺍﻡﺍچی
hamson	ﻩﺍﻡﺱﻭﻥ
hamza	ﺡﻡز
haniyya	ﺡﺍﻥیﻩ
har	ﻩﺍﺭ
harish	ﻩﺍﺭیﺵ
harmanus	ﻩرﻡﻥیﻭﺱ
hartnup	ﻩﺍرﺕﻥﺍپ
haskel	ﻩﺍﺱکﻝ
hastings	ﻩﺍﺱﺕیﻥگﺯ
hatta	ﻩﺍﺕﺍ
hayden	ﻩیﺩﻥ
hayes	ﻩیﺯ
hazen	ﻩﺍﺯﻥ
headlund	ﻩیﺩﻝﺍﻥﺩ
heard	ﻩﺭﺩ
hearley	ﻩیﺭﻝی
hector	ﻩکﺕﻭﺭ
hegyi	ﻩگی
heintz	ﻩیﻥﺕﺯ
hempel	ﻩﻡپﻝ
hendrica	ﻩیﻥﺩریکﺍ
hentzel	ﻩﻥﺕﺯﻝ
herring	ﻩﺭیﻥگ
herst	ﻩﺭﺱﺕ
herwig	ﻩﺭﻭیگ
hildebrand	ﻩیﻝﺩﺏﺭﺍﻥﺩ
hilliard	ﻩیﻝیﺍرﺩ
hillyerd	ﻩیﻝیﺭﺩ
hilmer	ﻩیﻝﻡﺭ
hitz	ﻩیﺕﺯ
hoag	ﻩﻭگ
hochberg	ﻩﺍچﺏرگ
hoffbeck	ﻩﺍﻑﺏک
hoffman	ﻩﺍﻑﻡﻥ
hoggard	ﻩﺍگﺍﺭﺩ
holloway	ﻩﺍﻝﻭی
holtlandensis	ﻩﺍﺕﻝﻥﺩﻥﺱیﺱ
holzen	ﻩﻭﻝﺯﻥ
holzer	ﻩﺍﻝﺯﺭ
hopcraft	ﻩپکرﺍﻑﺕ
hopson	ﻩﺍپﺱﻭﻥ
horrigmo	ﻩﻭﺭیگﻡﻭ
houck	ﻩﺍک
house	ﻩﺍﻭﺱ
houseman	ﻩﻭﺱﻡﻥ
hovis	ﻩﺍﻭیﺱ
howes	ﻩﺍﻭیﺱ
huddleston	ﻩﺍﺩﻝﺱﺕﻭﻥ
humes	ﻩیﻭﻡﺯ
huntress	ﻩﺍﻥﺕرﺱ
hurford	ﻩﺍﺭﻑﻭﺭﺩ
husemann	ﻩﺍﺱﻡﻥ
ikbal	ﺍﻕﺏﺍﻝ
ilmin	ﺍیﻝﻡیﻥ
inez	ﺍیﻥﺯ
inman	ﺍیﻥﻡﻥ
inna	ﺍیﻥﺍ
interrante	ﺍیﻥﺕﺭﻥﺕ
inward	ﺍیﻥﻭﺍرﺩ
iott	ﺍیﻭﺕ
irth	ﺍیﺭث
jabir	ﺝﺏیر
jacob	ژﺍکﻭﺏ
jahnke	ﺝﺍﻥک
jantunen	ﺝﺍﻥﺕﻭﻥﻥ
jaschek	ﺝﺍﺱچک
javier	ﺝﺍﻭیﺭ
jayson	ﺝیﺱﻭﻥ
jedi	ﺝﺩی
jeronimus	ﺝرﻭﻥیﻡﻭﺱ
jesper	ﺝﺱپﺭ
jewett	ﺝﻭیﺕ
jhang	ﺝﻩﺍﻥگ
joergen	ﺝﻭﺭﺝﻥ
joseph	ژﻭزﻑ
josie	ﺝﻭﺯیﻩ
jougla	ﺝﻭگﻝﺍ
june	ﺝﻭﻥ
kain	کیﻥ
kakure	کﺍکیﻭﺭ
kamb	کﺍﻡﺏ
kanda	کﺍﻥº©ﺍ
kanter	کﺍﻥﺕﺭ
kappa	کﺍپﺍ
kapral	کﺍپﺭﺍﻝ
karakash	کﺍﺭکﺍﺵ
kardon	کﺍرﺩﻥ
karish	کﺍﺭیﺵ
karridian	کﺍﺭیﺩیﺍﻥ
kavita	کﺍﻭیﺕﺍ
kaya	کﺍیﺍ
kayvon	کیﻭﺍﻥ
kazunori	کﺍﺯﻭﻥﻭﺯی
keath	کیﺕ
keeton	کیﺕﻭﻥ
keiron	کیﺭﻭﻥ
keltner	کﻝﺕﻥﺭ
kendig	کﻥﺩیگ
kenner	کﻥﺭ
keong	کیﻭﻥگ
kerins	کﺭیﻥﺯ
kesavan	کﺱﻭﺍﻥ
kiatikun	کیﺍﺕیکﻭﻥ
kiddle	کیﺩﻝ
kieffer	کیﻑﺭ
kiehne	کیﻥﻩ
kilgore	کیﻝگﻭﺭ
kille	کیﻝﻩ
killebrew	کیﻝﺏﺭﻭ
killpack	کیﻝپک
kimberly	کیﻡﺏﺭﻝی
kimron	کیﻡرﻭﻥ
kind	کﺍیﻥﺩ
kinsella	کیﻥﺱﻝﺍ
kinyon	کیﻥیﻭﻥ
kiran	کیرﺍﻥ
klee	کﻝی
kleier	کﻝیﺭ
knaff	ﻥﺍﻑ
koberg	کﺏﺭگ
koblas	کﻭﺏﻝﺍﺱ
kobsa	کﻭﺏﺱﺍ
koch	کﻭخ
kokernak	کﻭکرﻥیک
koorapaty	کﻭﺭﺍپﺍﺕی
kordas	کﻭﺭﺩﺍﺱ
korte	کﻭﺭﺕﻩ
kortink	کﻭرﺕیﻥک
koskimaki	کﻭﺱکیﻡﺍکی
kovalcik	کﻭﺍﻝﺱیک
kozak	کﻭﺯﺍک
krause	کرﺍیﺱ
krazy	کرﺍﺯی
kretzer	کﺭﺕﺯﺭ
kristen	کریﺱﺕﻥ
krob	کﺭﻭﺏ
kruk	کﺭﺍک
kubla	کﻭﺏﻝﺍ
kubose	کییﻭﺏﺍﺱ
ladak	ﻝﺩک
laffey	ﻝﺍﻑی
laing	ﻝﺍیﻥگ
lakesha	ﻝﺍکیﺵﺍ
lalinde	ﻝﺍﻝیﻥﺩﻩ
land	ﻝﺍﻥﺩ
lander	ﻝﺍﻥﺩﺭ
landry	ﻝﺍﻥﺩﺭی
lang	ﻝﺍﻥگ
langdell	ﻝﺍﻥگﺩﻝ
langevad	ﻝﺍﻥگﻭﺍﺩ
langley	ﻝﺍﻥگﻝی
lap	ﻝپ
lapidary	ﻝﺍپیﺩﺍﺭی
lapo	ﻝﺍپﻭ
larsson	ﻝﺍرﺱﻭﻥ
lascala	ﻝﺍﺱکﺍﻝﺍ
latala	ﻝﺍﺕﺍﻝﺍ
latham	ﻝﺍﺕﺍﻡ
lausin	ﻝﺍیﻭﺱیﻥ
lavery	ﻝﺍﻭﺭی
lawrence	ﻝﺍرﻥﺱ
leeder	ﻝیﺩﺭ
lehne	ﻝیﻥ
lehrian	ﻝﻩﺭیﺍﻥ
leiderdorp	ﻝیﺩرﺩرپ
leighton	ﻝیﺕﻭﻥ
leslie	ﻝﺱﻝی
letterman	ﻝﺕﺭﻡﻥ
lev	ﻝﻭ
leythen	ﻝیﺕﻥ
liau	ﻝیﻭ
lieuwe	ﻝییﻭﻭﻩ
limace	ﻝﺍیﻡﺍک
limbach	ﻝیﻡﺏﺍخ
limmer	ﻝیﻡﺭ
lincke	ﻝیﻥکﻩ
linehan	ﻝیﻥﻩﺍﻥ
liren	ﻝیﺭﻥ
littlejohn	ﻝیﺕﻝﺝﺍﻥ
livian	ﻝیﻭیﻥ
livingston	ﻝیﻭیﻥگﺱﺕﻭﻥ
liza	ﻝیﺯﺍ
lizard	ﻝیﺯﺍﺭﺩ
loch	ﻝﻭچ
lombard	ﻝﺍﻡﺏﺍﺭﺩ
lonnie	ﻝﻭﻥی
loosmore	ﻝﻭﺱﻡﻭﺭ
lorien	ﻝﻭریﻥ
lorton	ﻝﻭﺭﺕﻭﻥ
lowell	ﻝﻭیﻝ
lucey	ﻝﻭﺱی
ludwig	ﻝﻭﺩﻭیگ
lukka	ﻝﻭکﺍ
luther	ﻝﻭﺕﺭ
lydia	ﻝیﺩیﺍ
lylah	ﻝیﻝﺍ
lyric	ﻝیﺭیک
macaraeg	ﻡﺍکﺍﺭﺍیگ
macisaac	ﻡﺍکیﺱﺍک
mackay	ﻡکﻭی
maclean	ﻡکﻝیﻥ
madis	ﻡﺍﺩیﺱ
madurai	ﻡﺍﺩﻭﺭﺍی
magion	ﻡژیﻭﻥ
mahoney	ﻡیﻩﻭﻥی
mahto	ﻡﺍﻩﺕﻭ
makela	ﻡیکﻝﺍ
maki	ﻡکی
malcolme	ﻡﻝکﻭﻡ
malini	ﻡﻝیﻥی
mallick	ﻡﺍﻝیک
mallin	ﻡﺍﻝیﻥ
maltby	ﻡﺍﻝﺏی
manas	ﻡﻥﺱ
mandaville	ﻡﺍﻥﺩﺍﻭیﻝ
manickam	ﻡﻥیکﺍﻡ
manlig	ﻡﺍﻥﻝیگ
mao	ﻡﺍﻭ
marcelo	ﻡﺍﺭﺱﻝﻭ
marco	ﻡﺍﺭکﻭ
marcus	ﻡﺍﺭکییﻭﺱ
margarietje	ﻡﺍرگریﺕﻩ
marick	ﻡﺍﺭیک
markku	ﻡﺍﺭکﻭ
maroon	ﻡﺍﺭﻭﻥ
marrero	ﻡﺍریرﻭ
marty	ﻡﺍﺭﺕی
marvit	ﻡﺍﺭﻭیﺕ
mashey	ﻡﺍﺵی
maslin	ﻡﺱﻝیﻥ
maxi	ﻡﺍکﺱی
mayerfeld	ﻡیﺭﻑﻝﺩ
mcgown	ﻡکگﻭﻥ
mchenry	ﻡکﻩﻥﺭی
mcneill	ﻡکﻥیﻝ
mean	ﻡیﻥ
melcher	ﻡﻝچﺭ
melka	ﻡﻝکﺍ
mellon	ﻡﻝﻭﻥ
menestrina	ﻡﻥﺱﺕﺭیﻥﺍ
menzies	ﻡﻥﺯیﺯ
mest	ﻡﺱﺕ
mikolic	ﻡیکﻭﻝیک
milestone	ﻡیﻝﺱﺕﻭﻥ
milley	ﻡیﻝی
mingo	ﻡیﻥگﻭ
miranker	ﻡیﺭﺍﻥکﺭ
mistick	ﻡیﺱﺕیک
mitu	ﻡیﺕﻭ
moll	ﻡﻭﻝ
monger	ﻡﺍﻥگﺭ
montoure	ﻡﻭﻥﺕﻭر
montoya	ﻡﻭﻥﺕﻭیﺍ
montreal	ﻡﻭﻥﺕﺭﺍﻝ
mooney	ﻡﻭﻥی
moynes	ﻡﻭیﻥﺯ
munk	ﻡﺍﻥک
murphy	ﻡﺍﺭﻑی
murray	ﻡﺍری
nabil	ﻥﺍﺏیﻝ
nagasiva	ﻥﺍگﺍﺱیﻭﺍ
naimah	ﻥیﻡﺍ
nallick	ﻥﺍﻝیک
naquin	ﻥﺍکﻭییﻥ
narag	ﻥﺍرﺍگ
narayan	ﻥﺍرﺍیﺍﻥ
national	ﻥﺵﻥﺍﻝ
newsham	ﻥیﻭﺵﺍﻡ
nid	ﻥیﺩ
nikolic	ﻥیکﻭﻝیک
nils	ﻥیﻝﺱ
noble	ﻥﺍﺏﻝ
noor	ﻥﻭر
nugent	ﻥﺍگﻥﺕ
ober	ﺍﻭﺏﺭ
oborg	ﺍﺏﺭگ
obremski	ﺍﺏﺭﻡﺱکی
olafson	ﺍﻭﻝﺍﻑﺱﻭﻥ
oldcorn	ﺍﻭﻝﺩکﻭﺭﻥ
oltmann	ﺍﻝﺕﻡﻥ
omerry	ﺍﻭﻡری
ositis	ﺍﺱیﺕیﺱ
ostrin	ﺍﺱﺕﺭیﻥ
oswego	ﺍﻭﺱﻭگﻭ
oughton	ﺍﻭﻕﺕﻭﻥ
paglia	پﺍگﻝیﺍ
pahle	پﺍﻝ
palmo	پﺍﻝﻡﻭ
pancras	پﺍﻥکرﺍﺱ
panici	پﺍﻥیﺱی
paquet	پﺍکﻭﺍﺕ
park	پﺍﺭک
parrish	پﺍﺭیﺵ
pauli	پﺍﻝی
paull	پﺍیﻭﻝ
pedicini	پﺩیﺱیﻥی
pelletier	پﻝﺕییﺭ
pengadu	پﻥگﺍﺩﻭ
pengelly	پﻥگﻝی
perdicaro	پﺭﺩیکﺍﺭﻭ
perricone	پﺭیکﻥ
persson	پﺭﺱﻭﻥ
pesce	پﺵﻩ
petcher	پﺕچﺭ
petr	پیﺕر
pillich	پیﻝیچ
pinn	پیﻥ
pivot	پیﻭﺍﺕ
plache	پﻝچ
platkus	پﻝﺕکﻭﺱ
polepalli	پﻭﻝیپﺍﻝی
polo	پﻭﻝﻭ
pope	پﺍپ
porges	پﻭﺭﺝﺯ
posh	پﻭﺵ
prauda	پرﺍﻭﺩﺍ
probal	پرﻭﺏﺍﻝ
probst	پﺭﺍﺏﺱﺕ
profit	پرﺍﻑیﺕ
pulsifer	پﺍﻝﺱیﻑﺭ
pyziur	پیﺯیﺭ
qamra	کﻡرﺍ
querin	کﻭیﺭیﻥ
radcliff	ﺭﺍﺩکﻝیﻑ
radu	ﺭﺍﺩﻭ
rafaeli	ﺭﺍﻑﺍیﻝی
rafferty	ﺭﺍﻑﺭﺕی
ragnvald	ﺭﺍگﻥﻭﺍﻝﺩ
rainer	ﺭیﻥﺭ
rau	ﺭﺍﻭ
raverdy	ﺭﺍﻭﺭﺩی
reckeweg	ﺭکﻭگ
redondo	ﺭﺩﻭﻥﺩﻭ
rego	ﺭگﻭ
remmen	ﺭﻡﻥ
renalds	ﺭﻥﺍﻝﺩﺯ
renaud	ﺭﻥﺍﻭﺩ
rendar	ﺭﻥﺩﺭ
renish	رﻥیﺵ
reppert	ﺭپﺭﺕ
reymont	ﺭیﻡﺍﻥﺕ
rich	ﺭیچ
richmeyer	ﺭیچﻡیﺭ
richolson	ﺭیکﻭﻝﺱﻭﻥ
rijkaard	ریکﺍرﺩ
rising	ریﺯیﻥگ
ritacco	ﺭیﺕﺍکﻭ
rivard	ﺭیﻭﺍﺭﺩ
rivera	ﺭیﻭﺭﺍ
rizzo	ﺭیﺯﻭ
robel	ﺭﻭﺏﻝ
roepke	ﺭﻭپکﻩ
romulus	ﺭﺍﻡﻭﻝﻭﺱ
rongo	ﺭﻭﻥگﻭ
ronnen	ﺭﺍﻥﻥ
rosback	رﻭﺱﺏک
rosemarie	ﺭﻭﺯﻡﺍﺭی
rosenfeld	ﺭﺯﻥﻑﻝﺩ
rosenson	رﺯﻥﺱﻭﻥ
rostand	ﺭﻭﺱﺕﻥﺩ
rotunda	رﻭﺕﻭﻥﺩﺍ
rouch	ﺭﺍچ
roussel	رﺍﺱﻝ
rowsell	ﺭﻭﺱﻝ
rubie	ﺭﻭﺏی
ruebel	ﺭﻭیﺏﻝ
ruemmler	ﺭیﻭﻡﻝﺭ
ruholl	ﺭﻭﻩﻝ
rupp	رﺍپ
rusu	ﺭﺍﺱﻭ
ruthstrom	ﺭﺍﺕﺱﺕﺭﻭﻡ
ryan	رﺍییﺍﻥ
ryder	ﺭیﺩﺭ
rydquist	ﺭیﺩکﻭیﺱﺕ
saito	ﺱﺍیﺕﻭ
salazar	ﺱﺍﻝﺍﺯﺍﺭ
salerma	ﺱﺍﻝﺭﻡﺍ
salsman	ﺱیﻝﺯﻡﻥ
samaddar	ﺱﺍﻡﺍﺩﺍﺭ
sampath	ﺱﻡپﺕ
san	ﺱﺍﻥ
sanchez	ﺱﺍﻥچﺯ
sandberg	ﺱﻥﺩﺏﺭگ
santanna	ﺱﺍﻥﺕﺍﻥﺍ
sarma	ﺱﺍﺭﻡﺍ
sathaye	ﺱﺍﺕی
savarese	ﺱﺍﻭﺍﺭﺱ
savela	ﺱیﻭﻝﺍ
schaffer	ﺍﺱکﺍﻑر
scullin	ﺍﺱکﻭﻝیﻥ
seaver	ﺱیﻭﺭ
sedlak	ﺱﺩﻝﺍک
seelig	ﺱیﻝیگ
seitz	ﺱیﺕﺯ
serling	ﺱﺭﻝیﻥگ
serratosa	ﺱﺭﺍﺕﻭﺯﺍ
servideo	ﺱﺭﻭیﺩیﻭ
seth	ﺱﺕ
sethia	ﺱﺕیﺍ
sew	ﺱﻭ
seymour	ﺱیﻡﻭﺭ
shammar	ﺵﺍﻡﺍر
shanahan	ﺵﺍﻥﺍﻩﺍﻥ
shannon	ﺵﺍﻥﻭﻥ
shanson	ﺵﺍﻥﺱﻭﻥ
sharma	ﺵﺍرﻡﺍ
sharqiyah	ﺵرکیﺍﻩ
sheats	ﺵیﺕﺯ
shebs	ﺵﺏﺱ
shell	ﺵﻝ
sher	ﺵﺭ
sherr	ﺵر
shimin	ﺵیﻡیﻥ
shomer	ﺵﻭﻡﺭ
shortreed	ﺵﺭﺕﺭیﺩ
shults	ﺵﺍﻝﺕﺯ
siegler	ﺱیگﻝر
silcox	ﺱیﻝکﺍکﺱ
simin	ﺱیﻡیﻥ
simone	ﺱیﻡﻭﻥ
sina	ﺱیﻥﺍ
sislo	ﺱیﺱﻝﻭ
sisson	ﺱیﺱﻭﻥ
sit	ﺱیﺕ
sitaram	ﺱیﺕﺍﺭﺍﻡ
skene	ﺍﺱکیﻥ
slaney	ﺍﺱﻝیﻥی
slatkin	ﺍﺱﻝﺍﺕکیﻥ
smithwick	ﺍﺱﻡیﺕﻭیک
smoot	ﺍﺱﻡﻭﺕ
smythe	ﺍﺱﻡﺍیﺕ
snyder	ﺍﺱﻥﺍیﺩﺭ
solodov	ﺱﻝﻭﺩﻭﻑ
soma	ﺱﻭﻡﺍ
sophie	ﺱﻭﻑی
sorani	ﺱﻭﺭﺍﻥی
souza	ﺱﻭﺯﺍ
spike	ﺍﺱپﺍیک
spilite	ﺍﺱپیﻝیﺕ
sprayberry	ﺍﺱپﺭیﺏﺭی
stajano	ﺍﺱﺕﺍﺝﺍﻥﻭ
stannon	ﺍﺱﺕﻥﻭﻥ
star	ﺍﺱﺕﺍﺭ
stathis	ﺍﺱﺕﺍﺕیﺱ
stavely	ﺍﺱﺕیﻭﻝی
stermitz	ﺍﺱﺕرﻡیﺕﺯ
stinson	ﺍﺱﺕیﻥﺱﻥ
stoffel	ﺍیﻑﻭﻑﻝ
stoker	ﺍﺱﺕﺍکﺭ
stolcke	ﺍﺱﺕﺍﻝکﻩ
stoy	ﺍﺱﺕﻭی
strayer	ﺍﺱﺕﺭیﺭ
stremler	ﺍﺱﺕﺭﻡﻝﺭ
suffer	ﺱﻭﻑﺭ
suha	ﺱﻭﻩﺍ
sundeep	ﺱﺍﻥﺩیپ
surgeon	ﺱرﺝیﻭﻥ
susalis	ﺱﻭﺯﺍﻝیﺱ
susanne	ﺱﻭﺯﺍﻥﻩ
suze	ﺱﻭﺯ
swafford	ﺱﻭﺍﻑﻭﺭﺩ
swain	ﺍﺱﻭﺍیﻥ
sylvie	ﺱیﻝﻭی
tafilah	ﺕﻉﻑیﻝﻩ
tahsin	ﺕﺡﺱیﻥ
talibah	طﻝیﺏﺍ
tallan	ﺕﺍﻝﺍﻥ
tariq	طریﻕ
tate	ﺕیﺕ
tatsuro	ﺕﺍﺕﺱﻭﺭﻭ
tegelberg	ﺕگﻝﺏﺭگ
teh	ﺕﻩ
tempelman	ﺕﻡپﻝﻡﻥ
templeton	ﺕﻡپﻝﺕﻭﻥ
terrace	ﺕﺭﺍﺱﻩ
terran	ﺕﺭﺍﻥ
terris	ﺕﺭیﺱ
teshima	ﺕﺵیﻡﺍ
thief	ﺕیﻑ
thornton	ﺕرﻥﺕﻥ
tichauer	ﺕیچﺍﻭﺭ
tillemans	ﺕیﻝﻡﺍﻥز
tipul	ﺕیپﺍﻝ
title	ﺕﺍﺕﻝ
tofferi	ﺕﻭﻑﺭی
tolvanen	ﺕﺍﻝﻭﺍﻥﻥ
tomlinson	ﺕﺍﻡﻝیﻥﺱﻭﻥ
toms	ﺕﺍﻡﺯ
tonjes	ﺕﺍﻥﺝﺱ
trapp	ﺕﺭﺍپ
trough	ﺕﺭﻭ
trown	ﺕﺭﺍﻭﻥ
tuglu	ﺕﺍگﻝﻭ
tunen	ﺕﺍﻥﻥ
tyree	ﺕﺍیﺭ
tysinger	ﺕیﺱیﻥﺝﺭ
underhill	ﺍﻥﺩرﻩیﻝ
urban	ﺍﺭﺏﺍﻥ
vaggen	ﻭﺍگﻥ
valur	ﻭﺍﻝﻭﺭ
vandenburgh	ﻭﺍﻥﺩﻥﺏﺭﻕ
vanecek	ﻭﺍﻥﺱک
vangelder	ﻭﻥﺝﻝﺩﺭ
vee	ﻭی
velez	ﻭیﻝﺯ
vianen	ﻭیﺍﻥﻥ
viren	ﻭیﺭﻥ
viviane	ﻭیﻭیﺍﻥﻩ
vollum	ﻭﺍﻝﻭﻡ
wackerfuss	ﻭکﺭﻑﺍﺱ
wales	ﻭﺍﻝﺯ
wass	ﻭﺍﺱ
watsen	ﻭﺍﺕﺱﻥ
weidman	ﻭیﺩﻡﺍﻥ
westerholm	ﻭﺱﺕﺭﻩﻝﻡ
weston	ﻭﺱﺕﻥ
whadzen	ﻭﺍﺩﺯﻥ
whittle	ﻭیﺕﻝ
wibowo	ﻭیﺏﻭﻭﻭ
wick	ﻭیک
widad	ﻭیﺩﺍ
widall	ﻭیﺩﺍﻝ
wietse	ﻭیﺕﺱﻩ
wilford	ﻭیﻝﻑﺭﺩ
willner	ﻭیﻝﻥﺭ
winkler	ﻭیﻥکﻝر
winz	ﻭیﻥﺯ
wisal	ﻭیﺱﺍﻝ
wolpert	ﻭﻝپرﺕ
woodsprite	ﻭﺩﺍﺱپرﺍیﺕ
woten	ﻭﻭﺕﻥ
xaver	ﺯیﻭر
yake	ییک
yaminah	یﺍﻡیﻥﺍ
yanowitz	یﺍﻥﻭﻭیﺕﺯ
yoseph	یﻭﺱﻑ
zamore	ﺯﺍﻡﻭﺭ
zapara	ﺯﺍپﺍﺭﺍ
zaria	زری
zemel	ﺯیﻡﻝ
zirilli	ﺯیﺭیﻝی
