aabar	ﺍﺏﺭ
aahie	ﺍﻩی
aali	ﺍﻉﻝی
aaliyah	ﺍﻉﻝیﺍﻩ
aaltruide	ﺍﻝﺕﺭﻭییﺩ
aamina	ﺍﺍﻡیﻥﺍ
aaron	ﺍﺭﺩﻥ
aba	ﺍﺏﺍ
abad	ﺍﺏﺍﺩ
abbey	ﺍﺏی
abbot	ﺍﺏﻭﺕ
abbotsmith	ﺍﺏﻭﺕﺱﻡیﺕ
abbott	ﺍﺏﺕ
abby	ﺍﺏی
abcher	ﺍﺏچﺭ
abdalrahman	ﺍﺏﺩﻝﺭﺡﻡﺍﻥ
abdul	ﻉﺏﺩﻝ
abdulaziz	ﻉﺏﺩﺍﻝﻉﺯیﺭ
abdullah	ﻉﺏﺩﺍﻝﻝﻩ
abdulrahman	ﻉﺏﺩﺍﻝﺭﺡﻡﺍﻥ
abe	ﺍﺏﻩ
abel	ﺍﺏیﻝ
abele	ﺍﺏﻝﻩ
abell	ﺍﺏﻝ
abella	ﺍﺏﻝﺍ
abeltje	ﺍﺏﻝﺕ
abend	ﺍﺏﻥﺩ
abercrombie	ﺍﺏﺭکﺭﻭﻡﺏی
aberg	ﺍﺏﺭگ
abery	ﺍﺏﺭی
abhay	ﺍﺏﻩی
abia	ﺍﺏیﺍ
abiab	ﺍﺏیﺍﺏ
abiad	ﺍﺏیﺍﺩ
abilock	ﺍﺏیﻝﺍک
ablation	ﺍﺏﻝیﺵﻥ
abley	ﺍﺏﻝی
abner	ﺍﺏﻥﺭ
aboba	ﺍﺏﻭﺏﺍ
abolin	ﺍﺏﻭﻝیﻥ
abou	ﺍﺏﻭ
abraham	ﺍﺏﺭﺍﻩﺍﻡ
abram	ﺍﺏﺭﺍﻡ
abramson	ﺍﺏﺭﺍﻡﺱﻭﻥ
abrupt	ﺍﺏﺭﺍپﺕ
abstract	ﺍﺏﺱﺕﺭکﺕ
abtine	ﺍﺏﺕیﻥ
abudhabi	ﺍﺏﺍﺩﻩﺏی
abyan	ﺍﺏیﺍﻥ
academy	ﺍکﺍﺩﻡی
accapadi	ﺍکﺍپﺍﺩی
access	ﺍکﺱﺱ
ace	ﺍیﺱ
acee	ﺍکی
acevedo	ﺍکﻭﺩﻭ
achernar	ﺍچﺭﻥﺍﺭ
achilles	ﺍچیﻝﺱ
ack	ﺍک
ackerman	ﺍکﺭﻡ
ackley	ﺍکﻝی
ackroyd	ﺍکﺭﻭیﺩ
acmena	ﺍکﻡﻥﺍ
acosta	ﺍکﻭﺱﺕﺍ
acox	ﺍکﺍکﺱ
active	ﺍکﺕیﻭ
acton	ﺍکﺕﻭﻥ
acuna	ﺍکﻭﻥﺍ
acuner	ﺍکﻭﻥﺭ
adab	ﺍﺩﺍﺏ
adalma	ﺍﺩﻝﻡﺍ
adam	ﺍﺩﺍﻡ
adamo	ﺍﺩﺍﻡﻭ
adan	ﺍﺩﺍﻥ
adana	ﺍﺩﺍﻥﺍ
adcock	ﺍﺩکک
addicks	ﺍﺩیکﺱ
addington	ﺍﺩیﻥگﺕﻭﻥ
addis	ﺍﺩیﺱ
addison	ﺍﺩیﺱﻭﻥ
addy	ﺍﺩی
ade	ﺍﺩﻩ
adel	ﺍﺩﻝ
adela	ﺍﺩﻝﺍ
adelaide	ﺍﺩﻝﺍیﺩ
adelardo	ﺍﺩﻝﺍﺭﺩﻭ
adelheid	ﺍﺏﻝﻩیﺩ
adelson	ﺍﺩﻝﺱﻭﻥ
adgeringelant	ﺍگﺭیﻥگﻝﺍﻥﺕ
adie	ﺍﺩیﻩ
adik	ﺍﺩیک
adil	ﺍﺩیﻝ
adina	ﺍﺩیﻥﺍ
adisak	ﺍﺩیﺱﺍک
adit	ﺍﺩیﺕ
adkins	ﺍﺩکیﻥﺯ
adler	ﺍﺩﻝﺭ
admiralen	ﺍﺩﻡیﺭﺍﻝﻥ
admirals	ﺍﺩﻡیﺭﺍﻝﺯ
adnams	ﺍﺩﻥﺍﻡﺯ
adolfsson	ﺍﺩﻭﻝﻑﺱﻭﻥ
adolph	ﺍﺩﻭﻝﻑ
adonis	ﺍﺩﻭﻥیﺱ
adri	ﺍﺩﺭی
adriaen	ﺍﺩﺭیﺍﻥ
adriana	ﺍﺩﺭیﺍﻥﺍ
adriance	ﺍﺩﺭیﺍﻥﺱ
adriane	ﺍﺩﺭیﻥ
adrie	ﺍﺩﺭی
adriene	ﺍﺩﺭیﻥی
adrienne	ﺍﺩﺭیﻥی
adsett	ﺍﺩﺕ
adusumalli	ﺍﺩﻭﺱﻭﻡﺍﻝی
adventure	ﺍﺩﻭﻥچﺭ
aechtie	ﺍچی
aeltje	ﺍیﻝﺕﻩ
aernoudt	ﺍﺭﺕﻭﺕ
aetje	ﺍیﺕ
afa	ﺍﻑﺍ
afaf	ﺍﻑﺍﻑ
afif	ﺍﻑیﻑ
afioun	ﺍﻑیﻭﻥ
afou	ﺍﻑﻭ
afra	ﺍﻑﺭﺍ
aftab	ﺍﻑﺕﺍﺏ
afzal	ﺍﻑﺯﺍﻝ
against	ﺍگیﻥﺱﺕ
agali	ﺍگﺍﻝی
aganovic	ﺍگﻥﻭیک
agass	ﺍگﺍﺱ
agate	ﺍگﺍﺕی
ageno	ﺍگﻥﻭ
agent	ﺍﺝﻥﺕ
aggelos	ﺍﺝﻝﻭﺱ
agndie	ﺍگﻥﺩی
agopian	ﺍگپیﺍﻥ
agostinelli	ﺍگﻭﺱﺕیﻥﻝی
agostini	ﺍگﻭﺱﺕیﻥی
agoyo	ﺍگﻭیﻭ
agrawala	ﺍگﺭﺍﻭﺍﻝﺍ
agren	ﺍگﺭﻥ
aguero	ﺍگﻭیﺭﻭ
agullo	ﺍگﻭﻝﻭ
ahern	ﺍﻩﺭﻥ
ahlstrom	ﺍﻝﺱﺕﺭﻭﻡ
aibel	ﺍیﺏﻝ
aida	ﺍیﺩﺍ
aidid	ﺍیﺩیﺩ
aiesha	ﺍیﺵﺍ
aik	ﺍیک
aiken	ﺍیکﻥ
aileen	ﺍیﻝیﻥ
ailsa	ﺍیﻝﺱﺍ
aim	ﺍیﻡ
aiman	ﺍیﻡﺍﻥ
aimee	ﺍیﻡی
ain	ﺍیﻥ
ainissa	ﺍیﻥیﺱﺍ
ainley	ﺍیﻥﻝی
ainsaar	ﺍیﻥﺱﺭ
aint	ﺍیﻥﺕ
air	ﺍیﺭ
airay	ﺍﺭیﺍ
aird	ﺍیﺭﺩ
airdo	ﺍیﺭﺩﻭ
airlines	ﺍیﺭﻝﺍیﻥﺯ
airoun	ﺍیﺭﻭﻥ
aisenstat	ﺍیﺱﻥﺱﺕﺍﺕ
aissama	ﺍیﺱﺍﻡﺍ
ait	ﺍیﺕ
aitcho	ﺍیﺕچﻭ
aitken	ﺍیﺕکﻥ
aitsen	ﺍیﺕﺱﻥ
ajay	ﺍﺝﺍی
aka	ﺍکﺍ
akademik	ﺍکﺍﺩﻡیک
akdag	ﺍکﺩﺍگ
akeem	ﺍکیﻡ
akemi	ﺍکﻡی
akgun	ﺍکگﺍﻥ
aki	ﺍکی
akihiko	ﺍکیﻩیکﻭ
akil	ﺍکیﻝ
akilah	ﺍکیﻝﺍ
akilesh	ﺍکیﻝﺵ
akin	ﺍکیﻥ
akitomo	ﺍکیﺕﻭﻡﻭ
akl	ﺍکﻝ
akman	ﺍکﻡﺍﻥ
akrill	ﺍکﺭیﻝ
aksu	ﺍکﺱﻭ
alaaldin	ﺍﻝﺍﻝﺩیﻥ
alagesan	ﺍﻝگﺱﺍﻥ
alain	ﺍﻝیﺍﻥ
alaisdair	ﺍﻝﺍیﺱﺩیﺭ
alamode	ﺍﻝﻡﻭﺩ
alana	ﺍﻝﺍﻥﺍ
alapati	ﺍﻝﺍپﺍﺕی
alaqabah	ﺍﻝکﺏﺍﻩ
albahah	ﺍﻝﺏﺍﻩﺍﻩ
alber	ﺍﻝﺏﺭ
albert	ﺍﻝﺏﺭﺕ
albertini	ﺍﻝﺏﺭﺕیﻥی
albinger	ﺍﻝﺏیﻥگﺭ
albright	ﺍﻝﺏﺭیﺝ
alcmere	ﺍکﻡﺭ
alden	ﺍﻝﺩﻥ
alder	ﺍﻝﺩﺭ
aldrich	ﺍﻝﺩﺭیچ
aldridge	ﺍﻝﺩﺭیگ
alegado	ﺍﻝگﺍﺩﻭ
alelyunas	ﺍﻝیﻝیﻭﻥﺍﺱ
alesandro	ﺍﻝﺱﻥﺩﺭﻭ
aleser	ﺍﻝیﺯﺭ
alessandri	ﺍﻝﺱﺍﻥﺩﺭی
alex	ﺍﻝکﺱ
alexander	ﺍﻝکﺱﺍﻥﺩﺭ
alexandros	ﺍﻝکﺱﺍﻥﺩﺭﻭﺯ
alexiou	ﺍﻝکﺱیﻭ
alexy	ﺍﻝکﺱی
alf	ﺍﻝﻑ
alfaro	ﺍﻝﻑﺍﺭﻭ
alfonso	ﺍﻝﻑﺍﻥﺱﻭ
alford	ﺍﻝﻑﻭﺭﺩ
alfors	ﺍﻝﻑﺭﺱ
alfred	ﺍﻝﻑﺭﺩ
alfredo	ﺍﻝﻑﺭﺩﻭ
algie	ﺍﻝگی
alhudud	ﺍﻝﺍﺡﺩﻭﺩ
ali	ﻉﻝی
alia	ﻉﻝیﺍ
alias	ﺍﻝیﺍﺱ
alibey	ﺍﻝیﺏی
alice	ﺍﻝیﺱ
alicia	ﺍﻝیﺱیﺍ
alien	ﺍﻝیﻥ
alim	ﻉﻝیﻡ
alima	ﻉﻝیﻡﺍ
alington	ﺍﻝیﻥگﺕﻭﻥ
aliphas	ﺍﻝیﻑﺍﺱ
alisa	ﺍﻝیﺯﺍ
alistair	ﺍﻝیﺱﺕیﺭ
aliya	ﻉﻝیﺍ
alkabeer	ﺍﻝکﺏﺭ
alkerton	ﺍﻝکﺭﺕﻥ
alkhazna	ﺍﻝخﺯﻥﺍ
all	ﺍﻝ
alladhiqiyah	ﺍﻝﺍﻩﺍیﺩیکیﺍ
allard	ﺍﻝﺍﺭﺩ
allaway	ﺍﻝﺍﻭی
allbery	ﺍﻝﺏﺭی
allcock	ﺍﻝکک
allcor	ﺍﻝکﺭ
allden	ﺍﻝﺩﻥ
allee	ﺍﻝی
allegro	ﺍﻝگﺭﻭ
allen	ﺍﻝﻥ
allender	ﺍﻝﻥﺩﺭ
allerton	ﺍﻝﺭﺕﻥ
alleway	ﺍﻝیﻭی
alley	ﺍﻝی
allie	ﺍﻝی
allison	ﺍﻝیﺱﻥ
allport	ﺍﻝپﻭﺭﺕ
allred	ﺍﻝﺭﺩ
allshouse	ﺍﻝﺵﻭﺯ
allsop	ﺍﻝﺱپ
allsopp	ﺍﻝﺱﺍپ
allums	ﺍﻝﺍﻡﺯ
allyn	ﺍﻝیﻥ
allyson	ﺍﻝیﺱﻭﻥ
allyz	ﺍﻝیﺯ
alm	ﺍﻝﻡ
almas	ﺍﻝﻡﺍﺱ
almeroth	ﺍﻝﻡﺭﻭﺕ
almgren	ﺍﻝﻡگﺭﻥ
almintaqah	ﺍﻝﻡیﻥﺍکﺍﺡ
almirall	ﺍﻝﻡیﺭﺍﻝ
almqvist	ﺍﻝﻡکﻭیﺱﺕ
almudevar	ﺍﻝﻡﻭﺩیﻭﺍﺭ
alnoor	ﺍﻝﻥﻭﺭ
alok	ﺍﻝﻭک
alpen	ﺍﻝپﻥ
alpert	ﺍﻝپﺭﺕ
alpha	ﺍﻝﻑﺍ
alridge	ﺍﺭیﺝ
alsop	ﺍﻝﺱپ
alsworth	ﺍﻝﺯﻭﺭث
altair	ﺍﻝطیﺭ
altman	ﺍﻝﺕﻡﺍﻥ
alto	ﺍﻝﺕﻭ
alukal	ﺍﻝﻭکﺍﻝ
alva	ﺍﻝﻭﺍ
alvarez	ﺍﻝﻭﺍﺭﺯ
alvaro	ﺍﻝﻭﺍﺭﻭ
alvarus	ﺍﻝﻭﺍﺭﻭﺱ
alves	ﺍﻝﻭﺯ
alvin	ﺍﻝﻭیﻥ
alwan	ﺍﻝﻭﺍﻥ
alwin	ﺍﻝﻭیﻥ
alwis	ﺍﻝﻭیﺱ
alwyn	ﺍﻝﻭیﻥ
alya	ﺍﻝیﺍ
alyosha	ﺍﻝﻭﺵﺍ
alyssa	ﺍﻝیﺱﺍ
alyx	ﺍﻝیکﺱ
alzena	ﺍﻝﺯﻥﺍ
ama	ﺍﻡﺍ
amador	ﺍﻡﺍﺩﻭﺭ
amal	ﺍﻉﻡﺍﻝ
amand	ﺍﻡﺍﻥﺩ
amani	ﺍﻡﺍﻥی
amano	ﺍﻡﺍﻥﻭ
amara	ﺍﻡﺍﺭﺍ
amaral	ﺍﻡﺍﺭﺍﻝ
amardeo	ﺍﻡﺍﺭﺩیﻭ
amarit	ﺍﻡﺍﺭیﺕ
amarnath	ﺍﻡﺍﺭﻥﺕ
amberle	ﺍﻡﺏﺭﻝی
ambidge	ﺍﻡﺏیﺝ
ambler	ﺍﻡﺏﻝﺭ
ambrosio	ﺍﻡﺏﺭﻭﺱیﻭ
ambrosius	ﺍﻡﺏﺭﻭﺱیﻭﺱ
ambush	ﺍﻡﺏﻭﺵ
amedeo	ﺍﻡﺩیﻭ
amelia	ﺍﻡﻝیﺍ
america	ﺍﻡﺭیکﺍ
american	ﺍﻡﺭیکﻥ
amerikan	ﺍﻡﺭیکﻥ
amerman	ﺍﻡﺭﻡﺍﻥ
amery	ﺍﻡﺭی
amethysta	ﺍﻡﺕیﺱﺕﺍ
amezquita	ﺍﻡیﺯﻭﺕﺍ
ami	ﺍﻡی
amicus	ﺍﻡیکﻭﺱ
amie	ﺍﻡیﻩ
amihai	ﺍﻡیﻩﺍی
amina	ﺍﻡیﻥﺍ
amiot	ﺍﻡیﻭﺕ
amir	ﺍﻡیﺭ
amira	ﺍﻡیﺭﺍ
amit	ﺍﻡیﺕ
amitava	ﺍﻡیﺕﺍﻭﺍ
amlak	ﺍﻡﻝک
amna	ﺍﻡﻥﺍ
amnon	ﺍﻡﻥﻭﻥ
amoroso	ﺍﻡﻭﺭﻭﺱﻭ
amory	ﺍﻡﺭی
amos	ﺍﻡﻭﺱ
amphon	ﺍﻡﻑﻥ
ampon	ﺍﻡپﻥ
ampte	ﺍﻡپﺕ
amritha	ﺍﻡﺭیﺕﺍ
amshey	ﺍﻡﺵی
amstadt	ﺍﻡﺱﺕﺍﺕ
amster	ﺍﻡﺱﺕﺭ
amy	ﺍﻡی
amyot	ﺍﻡیﻭﺕ
anagram	ﺍﻥﺍگﺭﺍﻡ
anakin	ﺍﻥﺍکیﻥ
analog	ﺍﻥﺍﻝﻭگ
anand	ﺍﻥﺍﻥﺩ
ananda	ﺍﻥﺍﻥﺩﺍ
anant	ﺍﻥﺍﻥﺕ
anantha	ﺍﻥﺍﻥﺱﺍ
anas	ﺍﻥﺍﺯ
anastacia	ﺍﻥﺍﺱﺕﺍﺱیﺍ
anathea	ﺍﻥﺍﺕی
anatoly	ﺍﻥﺍﺕﻭﻝی
anay	ﺍﻥﺍی
anbar	ﺍﻥﺏﺭ
anbu	ﺍﻥﺏﻭ
anchi	ﺍﻥچی
anckorn	ﺍﻥکﻭﺭﻥ
and	ﺍﻥﺩ
ande	ﺍﻥﺩ
andenes	ﺍﻥﺩﻥﺱ
ander	ﺍﻥﺩﺭ
anderberg	ﺍﻥﺩﺭﺏﺭگ
anderer	ﺍﻥﺩﺭﺭ
andersen	ﺍﻥﺩﺭﺱﻥ
anderson	ﺍﻥﺩﺭﺱﻭﻥ
andolsen	ﺍﻥﺩﻭﻝﺱﻥ
andr	ﺍﻥﺩﺭ
andra	ﺍﻥﺩﺭﺍ
andrea	ﺍﻥﺩﺭیﺍ
andreaea	ﺍﻥﺩﺭییﺍ
andreas	ﺍﻥﺩﺭیﺍﺱ
andreasen	ﺍﻥﺩﺭﺱﻥ
andreassen	ﺍﻥﺩﺭیﺱﻥ
andree	ﺍﻥﺩﺭی
andreessen	ﺍﻥﺩﺭیﺱﻥ
andrei	ﺍﻥﺩﺭی
andres	ﺍﻥﺩﺭیﺱ
andress	ﺍﻥﺩﺭﺱ
andrews	ﺍﻥﺩﺭیﻭﺯ
andries	ﺍﻥﺩﺭیﺱ
andris	ﺍﻥﺩﺭیﺱ
andrus	ﺍﻥﺩﺭﻭﺱ
angeles	ﺍﻥﺝﻝﺱ
angelini	ﺍﻥﺝیﻝیﻥی
angelis	ﺍﻥﺝﻝیﺱ
angelo	ﺍﻥﺝﻝﻭ
anghe	ﺍﻥگﻩ
angle	ﺍﻥﺝﻝ
angles	ﺍﻥگﻝﺱ
anglesea	ﺍﻥﺝﻝیﺱیﺍ
angulo	ﺍﻥگﻭﻝﻭ
anhold	ﺍﻥﻩﻝﺩ
anil	ﺍﻥیﻝ
anilane	ﺍﻥﺍیﻝیﻥ
anisa	ﺍﻥیﺱﺍ
ankeney	ﺍﻥکﻥی
anker	ﺍﻥکﺭ
anne	ﺍﻥ
annette	ﺍﻥﺕﻩ
annexstad	ﺍﻥکﺱﺕﺍﺩ
annius	ﺍﻥیﻭﺱ
anniversary	ﺍﻥیﻭﺭﺱﺭی
anno	ﺍﻥﻭ
anon	ﺍﻥﻭﻥ
anoop	ﺍﻥﻭپ
anoosh	ﺍﻥﻭﺵ
anscomb	ﺍﻥﺱکﺍﻡﺏ
ansell	ﺍﻥﺱﻝ
anselm	ﺍﻥﺱﻝﻡ
anselmo	ﺍﻥﺱﻝﻡﻭ
ansley	ﺍﻥﺱﻝی
anspach	ﺍﻥﺱپﺍچ
ansselin	ﺍﻥﺱﻝیﻥ
anssi	ﺍﻥﺱی
antal	ﺍﻥﺕﺍﻝ
antanaitis	ﺍﻥﺕﺍﻥﺍیﺕیﺱ
antaramian	ﺍﻥﺕﺍﺭﺍﻡیﺍﻥ
antenna	ﺍﻥﺕﻥﺍ
antero	ﺍﻥﺕﺭﻭ
antevs	ﺍﻥﺕﻭﺱ
anthea	ﺍﻥﺱی
anthistle	ﺍﻥﺕیﺱﺕﻝ
anthon	ﺍﻥﺕﻭﻥ
anthony	ﺍﻥﺕﻭﻥی
antila	ﺍﻥﺕیﻝﺍ
antipodes	ﺍﻥﺕیپﺩﺱ
antone	ﺍﻥﺕﻭﻥ
antoni	ﺍﻥﺕﻭﻥی
antonio	ﺍﻥﺕﻭﻥیﻭ
antonis	ﺍﻥﺕﻭﻥیﺱ
antonius	ﺍﻥﺕﻭﻥیﺱ
antonoglou	ﺍﻥﺕﻭﻥﻭگﻝﻭ
antonowich	ﺍﻥﺕﻭﻥﻭﻭیچ
antony	ﺍﻥﺕﻭﻥی
antoun	ﺍﻥﺕﻭﻥ
antrosio	ﺍﻥﺕﺭﻭﺱیﻭ
antti	ﺍﻥﺕی
anu	ﺍﻥﻭ
anuchin	ﺍﻥﻭچیﻥ
anujit	ﺍﻥﻭﺝیﺕ
anukul	ﺍﻥﻭکﻭﻝ
anupam	ﺍﻥﻭپﺍﻡ
anvers	ﺍﻥﻭﺭﺱ
anwar	ﺍﻥﺹﺍﺭ
anwer	ﺍﻥﺱﺭ
anzalone	ﺍﻥﺯﺍﻝﻭﻥی
anzlovar	ﺍﻥﺯﻝﻭﺍﺭ
aoglat	ﺍﻭگﻝﺕ
aogori	ﺍﻭگﻭﺭی
aoyoun	ﺍﻭیﻭﻥ
apel	ﺍپﻝ
apendice	ﺍپﻥﺩیﺱ
aperson	ﺍپﺭﺱﻭﻥ
aphichart	ﺍﻑیچﺍﺭﺕ
aphoriel	ﺍﻑﻭﺭیﻝ
aphrodite	ﺍﻑﺭﺩیﺕ
aplin	ﺍپﻝیﻥ
aponte	ﺍپﻭﻥﺕﻩ
apoorva	ﺍپﻭﺭﻭﺍ
appel	ﺍپﻝ
appelberg	ﺍپﻝﺏﺭگ
applebee	ﺍپﻝیﺏی
appleby	ﺍپﻝیﺏی
appleman	ﺍپﻝﻡﻥ
april	ﺍپﺭیﻝ
aqil	ﺍکیﻝ
aqila	ﺍکیﻝﺍ
arantes	ﺍﺭﻥﺕﺱ
arbanas	ﺍﺭﺏﺍﻥﺍﺱ
arber	ﺍﺭﺏﺭ
arbil	ﺍﺭﺏیﻝ
arbur	ﺍﺭﺏﻭﺭ
arce	ﺍﺭﺱی
arch	ﺍﺭچ
archdale	ﺍﺭچﺍﻝ
archer	ﺍﺭچﺭ
archibald	ﺍﺭچیﺏﺍﻝﺩ
ardalich	ﺍﺭﺩﺍﻝیچ
ardis	ﺍﺭﺩیﺱ
arend	ﺍﺭﻥﺩ
arendt	ﺍﺭﻥﺕ
ari	ﺍﺭی
aries	ﺍﺭیﺯ
ariss	ﺍﺭیﺯ
aristotle	ﺍﺭیﺱﺕﻭﺕﻝ
arktiki	ﺍﺭکﺕیکی
arlet	ﺍﺭﻝﺕ
arlidge	ﺍﺭﻝیﺝ
arling	ﺍﺭﻝیﻥگ
arm	ﺍﺭﻡ
armato	ﺍﺭﻡﺍﺕﻭ
armeni	ﺍﺭﻡﻥی
armitage	ﺍﺭﻡیﺕﺍژ
armitt	ﺍﺭﻡیﺕ
armontrout	ﺍﺭﻡﻭﻥﺕﺭﻭﺕ
armour	ﺍﺭﻡﻭﺭ
armstrong	ﺍﺭﻡﺍﺱﺕﺭﺍﻥگ
arne	ﺍﺭﻥﻩ
arnett	ﺍﺭﻥﺕ
arnfield	ﺍﺭﻥﻑیﻝﺩ
arnold	ﺍﺭﻥﻝﺩ
arnot	ﺍﺭﻥﺍﺕ
aromaa	ﺍﺭﻭﻡﺍ
aronson	ﺍیﺭﻭﻥﺱﻭﻥ
arpin	ﺍﺭپیﻥ
arras	ﺍﺭﺍﺱ
arrifa	ﺍﺭیﻑﺍ
arrington	ﺍﺭیﻥگﺕﻥ
arscott	ﺍﺭﺱکﺍﺕ
arsenault	ﺍﺭﺱﻥﺍﻝﺕ
arsikere	ﺍﺭﺱیکﺭ
arter	ﺍﺭﺕﺭ
arthers	ﺍﺭﺕﺭﺯ
artiss	ﺍﺭیﺱ
arunachalam	ﺍﺭﻭﻥﺍچﺍﻝﺍﻡ
arunah	ﺍﺭﻭﻥﺍﻩ
arvesen	ﺍﺭﻭﺱﻥ
arviola	ﺍﺭﻭیﻭﻝﺍ
arya	ﺍﺭیﺍ
arzate	ﺍﺭﺯﺍﺕ
asbell	ﺍﺱﺏﻝ
asbrink	ﺍﺱﺏﺭیﻥک
ascolese	ﺍﺱکﻭﻝیﺯ
ascoly	ﺍﺱکﻭﻝی
asguarian	ﺍﺱگﻭﺭیﺍﻥ
ashenden	ﺍﺵﻥﺩﻥ
asherman	ﺍﺵﺭﻡﻥ
ashfield	ﺍﺵﻑیﻝﺩ
ashley	ﺍﺵﻝی
ashmore	ﺍﺵﻡﻭﺭ
ashok	ﺍﺵﻭک
ashton	ﺍﺵﺕﻭﻥ
ashworth	ﺍﺵﻭﺭث
asif	ﺍﺱیﻑ
ask	ﺍﺱک
askanas	ﺍﺱکﻥﺱ
asma	ﺍﺱﻡﺍ
assakul	ﺍﺱﺍکﻭﻝ
asselman	ﺍﺱﻝﻡﻥ
assi	ﺍﺱی
assimilate	ﺍﺱیﻡیﻝیﺕ
asson	ﺍیﺱﻭﻥ
astaire	ﺍﺱﺕﺍیﺭ
aster	ﺍﺱﺕﺭ
astik	ﺍﺱﺕیک
astley	ﺍﺱﺕﻝی
astore	ﺍﺱﺕﻭﺭ
astrid	ﺍﺱﺕﺭیﺩ
aswalap	ﺍﺱﻭﺍﻝﺍپ
atanacio	ﺍﺕﺍﻥﺱیﻭ
ataras	ﺍﺕﺍﺭﺍﺱ
atchison	ﺍچیﺱﻭﻥ
atems	ﺍﺕﻡﺯ
atherton	ﺍﺕﺭﺕﻥ
athey	ﺍﺕی
athos	ﺍﺕﻭﺱ
athow	ﺍﺕﻭ
atish	ﺍﺕیﺵ
atiya	ﺍﺕییﺍ
atka	ﺍﺕکﺍ
atkins	ﺍﺕکیﻥﺯ
atkinson	ﺍﺕکیﻥﺱﻥ
atlas	ﺍﺕﻝﺱ
atle	ﺍﺕﻝ
atmosphere	ﺍﺕﻡﺱﻑﺭ
atram	ﺍﺕﺭﺍﻡ
atri	ﺍﺕﺭی
atriceps	ﺍﺕﺭیﺱپﺱ
attewell	ﺍﺕیﻭﻝ
attig	ﺍﺕیگ
attilio	ﺍﺕیﻝیﻭ
attlee	ﺍﺕﺕﻝی
atul	ﺍﺕﻭﻝ
atusi	ﺍﺕﻭﺱی
atwater	ﺍﺕﻭﺍﺕﺭ
atwood	ﺍﺕﻭﺩ
aubrey	ﺍﺏﺭی
aubrie	ﺍﻭﺏﺭی
aucellina	ﺍﻭﺱﻝیﻥﺍ
auckland	ﺍکﻝﻥﺩ
audley	ﺍﺩﻝی
audra	ﺍﻭﺩﺭﺍ
audun	ﺍﻭﺩﻭﻥ
augen	ﺍﻭﺝﻥ
augor	ﺍگﺭ
august	ﺍﻭگﻭﺱﺕ
augusto	ﺍگﻭﺱﺕﻭ
augustyn	ﺍگﻭﺱﺕیﻥ
auker	ﺍﻭکﺭ
auld	ﺍﻭﻝﺩ
auldridge	ﺍﻝﺩﺭیگ
aun	ﺍﻭﻥ
aurand	ﺍﺭﺍﻥﺩ
aurdalen	ﺍﻭﺭﺩﺍﻝﻥ
aureole	ﺍﻭﺭیﻭﻝی
aurho	ﺍﻭﺭﻩﻭ
auriga	ﺍﻭﺭیگﺍ
aurkleven	ﺍﻭﺭکﻝیﻭﻥ
aurnupen	ﺍﻭﺭﻥﻭپﻥ
auslander	ﺍﻭﺱﻝﺍﻥﺩﺭ
austbanen	ﺍﻭﺱﺕﺏﺍﻥﻥ
austern	ﺍﺱﺕﺭﻥ
austhamaren	ﺍﻭﺱﺕﻩﺍﻡﺍﺭﻥ
austin	ﺍﺱﺕیﻥ
austrian	ﺍﺱﺕﺭیﻥ
austvollen	ﺍﻭﺱﺕﻭﻝیﻥ
austvorren	ﺍﻭﺱﺕﻭﺭیﻥ
auyeung	ﺍیﻥگ
aveek	ﺍﻭیک
aveling	ﺍﻭﻝیﻥگ
averell	ﺍﻭﺭیﻝ
averice	ﺍﻭﺭیک
averies	ﺍﻭﺭیﺯ
averill	ﺍﻭﺭیﻝ
averis	ﺍﻭﺭیﺱ
aversa	ﺍﻭیﺭﺱﺍ
avian	ﺍﻭیﺍﻥ
avicenna	ﺍﻭیﺱﻥﺍ
avichay	ﺍﻭیچﺍی
avinash	ﺍﻭیﻥﺍﺵ
avis	ﺍﻭیﺱ
aviva	ﺍﻭیﻭﺍ
avniel	ﺍﻭﻥیﻝ
avolio	ﺍﻭﻭﻝیﻭ
avraham	ﺍﻭﺭﺍﻩﺍﻡ
avram	ﺍﻭﺭﺍﻡ
avrum	ﺍﻭﺭﻭﻡ
awadia	ﺍﻭﺍﺩیﺍ
awan	ﺍﻭﺍﻥ
awasthi	ﺍﻭﺍﺱﺕی
awel	ﺍﻭﻝ
awketts	ﺍکﺕﺱ
awtrey	ﺍﻭﺕﺭی
axe	ﺍکﺱ
axel	ﺍکﺱیﻝ
axelsson	ﺍکﺱﻝﺱﻭﻥ
axford	ﺍکﺱﻑﺭﺩ
axthelm	ﺍکﺱﺩﻝﻡ
ayala	ﺍیﺍﻝﺍ
ayckbourn	ﺍکﺏﻭﺭﻥ
aycock	ﺍیکﻭک
ayers	ﺍیﺭﺯ
ayesha	ﺍیﺵﺍ
ayling	ﺍیﻝیﻥ
aylor	ﺍیﻝﻭﺭ
aylott	ﺍیﻝﻭﺕ
aylward	ﺍیﻝﻭﺍﺭﺩ
ayman	ﺍیﻡﺍﻥ
ayn	ﺍیﻥ
ayse	ﺍیﺱی
ayson	ﺍیﺱﻭﻥ
ayush	ﺍیﻭﺵ
ayuso	ﺍیﻭﺱﻭ
azad	ﺍﺯﺍﺩ
azalea	ﺍﺯﺍﻝی
azhar	ﺍﺯﻩﺭ
azlan	ﺍﺯﻝﻥ
azure	ﺍﺯﻭﺭ
baabar	ﺏﺍﺍﺏﺍﺭ
baba	ﺏﺍﺏﺍ
baback	ﺏﺍﺏک
babah	ﺏﺍﺏﺍ
babak	ﺏﺍﺏک
babar	ﺏﺍﺏﺍﺭ
babcock	ﺏﺏکﺍک
babette	ﺏﺍﺏﺕ
babikow	ﺏﺍﺏیکﻭ
babitz	ﺏﺍﺏیﺕﺯ
babu	ﺏﺍﺏﻭ
baburao	ﺏﺍﺏﻭﺭﺍﻭ
babushkin	ﺏﺍﺏﻭﺵکیﻥ
bacar	ﺏکﺭ
bacharach	ﺏﺍچﺍﺭﺍچ
bachus	ﺏﺍچﺍﺱ
back	ﺏک
backas	ﺏﺍکﺍﺱ
backdoor	ﺏکﺩﻭﺭ
backer	ﺏکﺭ
backhurst	ﺏکﻩﻭﺭﺱﺕ
backman	ﺏکﻡﻥ
backof	ﺏکﻭﻑ
backway	ﺏکﻭی
bacon	ﺏیکﻭﻥ
badami	ﺏﺩﻡی
badcock	ﺏﺍﺩکک
badeloch	ﺏﺍﺩﻝﻭچ
baden	ﺏﺍﺩیﻥ
baderman	ﺏﺍﺩﺭﻡﻥ
badian	ﺏﺩیﻥ
badir	ﺏﺩیﺭ
badrak	ﺏﺩﺭک
badrick	ﺏﺍﺩﺭیک
baefje	ﺏیﺝ
baertie	ﺏﺭﺕی
baffle	ﺏﺍﻑﻝ
bagade	ﺏﺍگیﺩ
bagga	ﺏﺍگﺍ
baggarly	ﺏﺍگﺍﺭﻝی
baghdad	ﺏﻍﺩﺍﺩ
bagley	ﺏگﻝی
bagnold	ﺏگﻥﻭﻝﺩ
bagshawe	ﺏﺍگﺵﺍﻭ
baguley	ﺏﺍگﻭﻝی
bagwill	ﺏگﻭیﻝ
bahamonde	ﺏﻩﺍﻡﻥﺩ
bahija	ﺏﺍﻩیﻩ
bahro	ﺏﻩﺭﻭ
bai	ﺏﺍی
baillie	ﺏﺍیﻝی
baillieu	ﺏﺍیﻝیﻭ
bain	ﺏیﻥ
baines	ﺏیﻥﺯ
bainmedart	ﺏیﻥﻡﺩﺍﺭﺕ
bains	ﺏیﻥﺯ
bajic	ﺏﺍﺝیک
bajwa	ﺏﺍﺝﻭﺍ
bak	ﺏک
bakaya	ﺏﺍکﺍیﺍ
baken	ﺏیکﻥ
bakeneset	ﺏیکﻥﺱﺕ
baker	ﺏکﺭ
bakewell	ﺏیکﻭﻝ
bakhoum	ﺏﺍخﻭﻡ
bakos	ﺏﺍکﻭﺱ
bakshee	ﺏﺍکﺵی
balarie	ﺏﺍﻝﺍﺭی
balash	ﺏﺍﻝﺍﺵ
balbir	ﺏﺍﻝﺏیﺭ
balchunas	ﺏﺍﻝچﻭﻥﺍﺱ
bald	ﺏﺍﻝﺩ
baldington	ﺏﺍﺩیﻥگﺕﻥ
baldred	ﺏﺍﻝﺩﺭﺩ
baldur	ﺏﺍﻝﺩﻭﺭ
bale	ﺏﺍﻝ
baleine	ﺏﺍﻝیﻥ
balendra	ﺏﺍﻝﻥﺩﺭﺍ
balfanz	ﺏﺍﻝﻑﻥﺯ
balham	ﺏﺍﻝﻩﺍﻡ
baliga	ﺏﺍﻝیگﺍ
balike	ﺏﺍﻝیک
balin	ﺏﺍﻝیﻥ
balit	ﺏﺍﻝیﺕ
ball	ﺏﺍﻝ
ballance	ﺏﺍﻝﺍﻥﺱ
ballard	ﺏﺍﻝﺍﺭﺩ
ballast	ﺏﺍﻝﺍﺱﺕ
balleny	ﺏﺍﻝﻥی
ballistic	ﺏﺍﻝیﺱﺕیک
bally	ﺏﺍﻝی
balma	ﺏﺍﻝﻡﺍ
balmaseda	ﺏﺍﻝﻡﺍﺱﺩﺍ
balmer	ﺏﺍﻝﻡﺭ
balqa	ﺏﺍﻝکﺍ
balsam	ﺏﺍﻝﺱﺍﻡ
balsley	ﺏﺍﻝﺱﻝی
balson	ﺏﺍﻝﺱﻭﻥ
baltais	ﺏﺍﻝﺕﺍیﺱ
baltaxe	ﺏﺍﻝﺕﺍکﺱ
balthazar	ﺏﺍﻝﺕﺍﺯﺍﺭ
baltzell	ﺏﺍﻝﺕﺯﻝ
balu	ﺏﺍﻝﻭ
banan	ﺏﻥﺍﻥ
bancroft	ﺏﺍﻥکﺭﺍﻑﺕ
bandali	ﺏﻥﺩﻝی
banded	ﺏﺍﻥﺩﺩ
banderob	ﺏﻥﺩﺭﻭﺏ
bandireddi	ﺏﺍﻥﺩیﺭﺩی
bandstone	ﺏﻥﺩﺍﺱﺕﻭﻥ
bandung	ﺏﻥﺩﺍﻥگ
bandy	ﺏﻥﺩی
bang	ﺏﻥگ
baniya	ﺏﻥیﺍ
banker	ﺏﻥکﺭ
bankler	ﺏﺍﻥکﻝﺭ
banks	ﺏﺍﻥکﺱ
bankwalla	ﺏﺍﻥکﻭﺍﻝﺍ
banna	ﺏﺍﻥﺍ
banton	ﺏﺍﻥﺕﻭﻥ
bao	ﺏﺍﻭ
baptist	ﺏﺍپﺕیﺱﺕ
baptista	ﺏﺍپﺕیﺱﺕﺍ
baqir	ﺏکیﺭ
bar	ﺏﺍﺭ
barakat	ﺏﺭکﺍﺕ
barath	ﺏﺍﺭﺍﺱ
barbagallo	ﺏﺍﺭﺏﺍگﺍﻝﻭ
barbas	ﺏﺍﺭﺏﺍﺱ
barbee	ﺏﺍﺭﺏی
barber	ﺏﺍﺭﺏﺭ
barborak	ﺏﺍﺭﺏﻭﺭﺍک
barbour	ﺏﺍﺭﺏﻭﺭ
barcroft	ﺏﺍﺭکﺭﺍﻑﺕ
barculo	ﺏﺍﺭکﺍﻝﻭ
barcus	ﺏﺍﺭکﻭﺱ
bard	ﺏﺍﺭﺩ
bare	ﺏیﺭ
bareback	ﺏیﺭﺏک
bareface	ﺏیﺭﻑیﺱ
barela	ﺏیﺭﻝﺍ
barend	ﺏﺍﺭﻥﺩ
barff	ﺏﺍﺭﻑ
barford	ﺏﺭﻑﻭﺭﺩ
bargh	ﺏﺭﻕ
bargiel	ﺏﺍﺭﺝیﻝ
bargus	ﺏﺭگﺱ
bari	ﺏﺍﺭی
bariaux	ﺏﺍﺭیﺍکﺱ
barich	ﺏیﺭیچ
bark	ﺏﺍﺭک
barkah	ﺏﺭکﺍﻩ
barkai	ﺏﺍﺭکﺍی
barker	ﺏﺍﺭکﺭ
barkley	ﺏﺍﺭکﻝی
barksdale	ﺏﺍﺭکﺱﺩیﻝی
barksfield	ﺏﺭکﺱﻑیﻝﺩ
barlas	ﺏﺍﺭﻝﺍﺱ
barlow	ﺏﺭﻝﻭ
barnaby	ﺏﺍﺭﻥﺍﺏی
barnard	ﺏﺭﻥﺍﺭﺩ
barnas	ﺏﺍﺭﻥﺍﺱ
barnett	ﺏﺍﺭﻥﺕ
barney	ﺏﺍﺭﻥی
barnshaw	ﺏﺭﺵﺍﻭ
barnum	ﺏﺍﺭﻥﺍﻡ
barnwell	ﺏﺭﻥﻭﻝ
baron	ﺏﺍﺭﻥ
barone	ﺏﺍﺭﻭﻥ
baroness	ﺏﺍﺭﻭﻥﺱ
baronia	ﺏﺍﺭﻭﻥیﺍ
baronick	ﺏﺍﺭﻥیک
barraby	ﺏﺭﺍﺏی
barracouta	ﺏﺍﺭﺍکﻭﺕﺍ
barratt	ﺏﺭﺍﺕ
barre	ﺏﺍﺭﻩ
barrel	ﺏﺍﺭﻝ
barrett	ﺏﺍﺭﺕ
barrey	ﺏﺍﺭی
barrie	ﺏﺍﺭی
barrier	ﺏﺭیﺭ
barringer	ﺏﺍﺭیﻥگﺭ
barrington	ﺏﺭیﻥگﺕﻥ
barroso	ﺏﺍﺭﺍﺱﻭ
barry	ﺏﺍﺭی
barsai	ﺏﺍﺭﺱی
barta	ﺏﺍﺭﺕﺍ
bartelle	ﺏﺍﺭﺕﻝ
bartelmus	ﺏﺍﺭﺕﻝﻡﺍﺱ
bartelt	ﺏﺍﺭﺕﻝﺕ
barth	ﺏﺍﺭث
barthakur	ﺏﺍﺭﺕکﻭﺭ
bartholomeus	ﺏﺍﺭﺕﻩﻭﻝﻭﻡیﻭﺱ
bartle	ﺏﺍﺭﺕﻝ
bartlett	ﺏﺭﺍﺕﻝﺕ
bartley	ﺏﺍﺭﺕﻝی
bartok	ﺏﺍﺭﺕک
bartolini	ﺏﺍﺭﺕﻭﻝیﻥی
barton	ﺏﺍﺭﺕﻥ
bartonico	ﺏﺍﺭﺕﻭﻥیکﻭ
bartz	ﺏﺍﺭﺕﺯ
barua	ﺏﺍﺭﻭﺍ
baruch	ﺏﺍﺭﻭچ
bas	ﺏﺍﺱ
basecamp	ﺏیﺱکﻡپ
basem	ﺏیﺱﻡ
basha	ﺏﺍﺵﺍ
basher	ﺏﺍﺵﺭ
basil	ﺏﺍﺱیﻝ
basilica	ﺏﺍﺱیﻝیکﺍ
basilisk	ﺏﺍﺱیﻝیﺱک
basilius	ﺏﺍﺱیﻝیﻭﺱ
basim	ﺏﺱیﻡ
basin	ﺏیﺱیﻥ
basira	ﺏﺱیﺭﺍ
basit	ﺏﺱیط
baskar	ﺏﺍﺱکﺍﺭ
baskerville	ﺏﺍﺱکﺭﻭیﻝ
baskett	ﺏﺱکﺕ
basle	ﺏﺱﻝ
basma	ﺏﺍﺱﻡﺍ
basse	ﺏیﺱﻩ
bassel	ﺏیﺱﻝ
bassett	ﺏﺍﺱﺕ
bassle	ﺏﺍﺱﻝ
basso	ﺏﺍﺱﻭ
basson	ﺏﺍﺱﻥ
bastard	ﺏﺍﺱﺕﺍﺭﺩ
bastiaan	ﺏﺍﺱﺕیﻥ
bastien	ﺏﺍﺱﺕیﻥ
bastion	ﺏﺍﺱﺕیﻥ
basu	ﺏﺍﺱﻭ
bat	ﺏﺍﺕ
bataille	ﺏﺍﺕیﻝ
batchelder	ﺏچﻝﺭ
bateman	ﺏیﺕﻡﻥ
bathurst	ﺏﺍﺕﺭﺱﺕ
batra	ﺏﺍﺕﺭﺍ
battan	ﺏﺍﺕﺍﻥ
batterbee	ﺏﺍﺕﺭﺏی
battey	ﺏﺍﺕی
battle	ﺏﺍﺕﻝ
batul	ﺏطﻭﻝ
baucom	ﺏﺍکﻭﻡ
baudin	ﺏﺍﻭﺩیﻥ
baudissin	ﺏﺍﻭﺩیﺱیﻥ
baudouin	ﺏﺍﻭﺩﻭییﻥ
bauduyn	ﺏیﻭﺩﻭیﻥ
baugham	ﺏیﻭگﺍﻡ
baughman	ﺏﺍﻭگﻡﻥ
bauhs	ﺏﺍﻭﺱ
baukus	ﺏﺍﻭکﻭﺱ
baum	ﺏﺍﻭﻡ
baumberger	ﺏﺍﻡﺏﺭگﺭ
baumgartner	ﺏﺍﻭﻡگﺍﺭﺕﻥﺭ
baupres	ﺏﺍﻭپﺭﺱ
bawa	ﺏﺍﻭﺍ
bawcom	ﺏﺍﻭکﺍﻡ
bawden	ﺏﺍﻭﺩﻥ
bayard	ﺏﺍیﺍﺭﺩ
bayda	ﺏیﺩﺍ
bayern	ﺏﺍیﺭﻥ
bayers	ﺏیﺭﺯ
bayla	ﺏﺍیﻝﺍ
bayse	ﺏیﺯ
bazett	ﺏﺍﺯﺕ
bdale	ﺏﺩﺍﻝ
bdira	ﺏﺩیﺭﺍ
beach	ﺏیچ
beacham	ﺏیچﺍﻡ
beaches	ﺏیچﺯ
beachley	ﺏیچﻝی
beaglehole	ﺏیگﻝﻩﻝ
beakley	ﺏیکﻝی
beale	ﺏیﻝ
beaman	ﺏیﻡﻥ
bean	ﺏیﻥ
beane	ﺏیﻥﻩ
beanie	ﺏیﻥی
bear	ﺏیﺭ
bearcat	ﺏﺭکﺍﺕ
beard	ﺏیﺭﺩ
bearden	ﺏیﺭﺩﻥ
beardmore	ﺏیﺭﺩﻡﺭ
bearing	ﺏیﺭیﻥگ
bearman	ﺏیﺭﻡﻥ
beartie	ﺏﺭﺕی
beasley	ﺏیﺱﻝی
beate	ﺏیﺕ
beaton	ﺏیﺕﻥ
beatrice	ﺏیﺭﺕﺭیک
beau	ﺏیﻭ
beauchamp	ﺏیچﻡپ
beaufays	ﺏیﻭﻑیﺯ
beaulieu	ﺏیﻭﻝی
beaumont	ﺏیﻭﻡﻥﺕ
beaver	ﺏیﻭﺭ
beavers	ﺏیﻭﺭﺯ
beavis	ﺏیﺍﻭیﺱ
bechard	ﺏیکﺍﺭﺩ
beck	ﺏک
becker	ﺏکﺭ
beckett	ﺏکﺕ
beckingsale	ﺏکیﻥگﺱیﻝ
beckman	ﺏکﻡﻥ
beckmeyer	ﺏکﻡیﺭ
beckwith	ﺏکﻭیﺕ
becky	ﺏکی
beddow	ﺏیﺩﻭ
bedell	ﺏﺩﻝ
bednar	ﺏﺩﻥﺍﺭ
bee	ﺏی
beedle	ﺏیﺩﻝ
beehive	ﺏیﻩیﻭ
beek	ﺏیک
beeler	ﺏیﻝیﺭ
beelzibub	ﺏیﻝﺯیﺏﺍﺏ
beeming	ﺏیﻡیﻥگ
beer	ﺏیﺭ
beet	ﺏیﺕ
beethoven	ﺏﺕﻩﻭﻥ
behara	ﺏﻩﺍﺭﺍ
behcet	ﺏﻩﺱﺕ
behnam	ﺏﻩﻥﺍﻡ
beirut	ﺏیﺭﻭﺕ
bekis	ﺏکیﺱ
bekki	ﺏکی
bela	ﺏﻝﺍ
belding	ﺏﻝﺩیﻥگ
belenky	ﺏﻝﻥکی
belinda	ﺏﻝیﻥﺩﺍ
bell	ﺏﻝ
bello	ﺏﻝﻭ
bellomy	ﺏﻝﺍﻡی
beltrao	ﺏﻝﺕﺭﺍﻭ
belvin	ﺏﻝﻭیﻥ
ben	ﺏﻥ
benamar	ﺏﻥﺍﻡﺍﺭ
benari	ﺏﻥﺍﺭی
bendek	ﺏﻥﺩک
bender	ﺏﻥﺩﺭ
bene	ﺏﻥﻩ
benet	ﺏﻥﺕ
beng	ﺏﻥگ
benge	ﺏﻥگ
bengt	ﺏﻥگﺕ
beniamin	ﺏﻥیﺍﻡیﻥ
benjiman	ﺏﻥﺝیﻡﺍﻥ
benker	ﺏﻥکﺭ
benner	ﺏﻥﺭ
bennet	ﺏﻥﺕ
bennetts	ﺏﻥﺕﺯ
bense	ﺏﻥﺱ
bensen	ﺏﻥﺱﻥ
benson	ﺏﻥﺱﻥ
benten	ﺏﻥﺕﻥ
bentley	ﺏﻥﺕﻝی
benton	ﺏﻥﺕﻥ
bentow	ﺏﻥﺕﻭ
bentz	ﺏﻥﺕﺯ
benz	ﺏﻥﺯ
benzene	ﺏﻥﺯﻥ
beqaa	ﺏکﺍ
berardi	ﺏﺭﺍﺭﺩی
bercovich	ﺏﺭکﻭﻭیچ
berend	ﺏﺭﻥﺩ
berends	ﺏﺭﻥﺩﺱ
beresford	ﺏﺭﺱﻑﻭﺭﺩ
beresh	ﺏﺭﺵ
bereza	ﺏﺭیﺯﺍ
berg	ﺏﺭگ
bergel	ﺏﺭگﻝ
bergeot	ﺏﺭگیﻭﺕ
berger	ﺏﺭگﺭ
berglund	ﺏﺭگﻝﺍﻥﺩ
bergman	ﺏﺭگﻡﻥ
berin	ﺏﺭیﻥ
beris	ﺏﺭیﺱ
berislav	ﺏﺭﺍیﺱﻝﺍﻭ
berk	ﺏﺭک
berkey	ﺏﺭکی
berkley	ﺏﺭکﻝی
berlin	ﺏﺭﻝیﻥ
berlocher	ﺏﺭﻝﺍچﺭ
berman	ﺏﺭﻡﻥ
bermel	ﺏﺭﻡﻝ
bernadus	ﺏﺭﻥﺍﺩﻭﺱ
bernal	ﺏﺭﻥﺍﻝ
bernard	ﺏﺭﻥﺍﺭﺩ
bernardi	ﺏﺭﻥﺍﺭﺩی
bernardin	ﺏﺭﻥﺍﺭﺩیﻥ
bernardo	ﺏﺭﻥﺍﺭﺩﻭ
bernards	ﺏﺭﻥﺍﺭﺩﺯ
bernd	ﺏﺭﻥﺩ
bernhard	ﺏﺭﻥﻩﺍﺭﺩ
bernhardt	ﺏﺭﻥﻩﺍﺭﺕ
bernher	ﺏﺭﻥﻩﺭ
bernie	ﺏﺭﻥی
bernier	ﺏﺭﻥیﺭ
berno	ﺏﺭﻥﻭ
bernt	ﺏﺭﻥﺕ
berry	ﺏﺭی
bertelson	ﺏﺭﺕﻝﺱﻭﻥ
berton	ﺏﺭﺕﻭﻥ
bertrand	ﺏﺭﺕﺭﺍﻥﺩ
beryl	ﺏﺭیﻝ
besam	ﺏﺱﺍﻡ
besbris	ﺏﺱﺏﺭیﺱ
besko	ﺏﺱکﻭ
bess	ﺏﺱ
bethan	ﺏﺕﺍﻥ
bethancourt	ﺏیﺕﺍﻥکﺭﺕ
bethel	ﺏﺕﻝ
beti	ﺏﺕی
betsy	ﺏﺕﺱی
bettig	ﺏﺕیگ
bettio	ﺏﺕییﻭ
betty	ﺏﺕی
betza	ﺏﺕﺯﺍ
beusee	ﺏیﻭﺱﻩ
beutel	ﺏیﻭﺕﻝ
beutling	ﺏیﺍﺕﻝیﻥگ
beuzeville	ﺏیﺯﻭیﻝ
bev	ﺏﻭ
bevan	ﺏیﻭﺍﻥ
beveridge	ﺏﻭﺭیﺝ
beverly	ﺏیﻭﺭﻝی
bex	ﺏکﺱ
beyer	ﺏیﺭ
beyhan	ﺏیﻩﺍﻥ
beyl	ﺏیﻝ
biacco	ﺏیﺍکﻭ
bian	ﺏیﺍﻥ
bible	ﺏیﺏﻝ
bick	ﺏیک
bickerstaffe	ﺏیکﺭﺍﺱﺕیﻑ
bickerton	ﺏیکﺭﺕﻥ
bidee	ﺏیﺩی
bidwell	ﺏیﺩﻭﻝ
bieber	ﺏیﺏﺭ
bielecki	ﺏیﻝکی
bieler	ﺏیﻝﺭ
bien	ﺏیﻥ
bienfang	ﺏیﻥﻑﻥگ
bierling	ﺏﺭﻝیﻥگ
biess	ﺏیﺱ
bifrost	ﺏیﻑﺭﺍﺱﺕ
big	ﺏیگ
bigend	ﺏیگﻥﺩ
bigenwald	ﺏیگﻥﻭﺍﻝﺩ
biggs	ﺏیگﺯ
bigo	ﺏیگﻭ
bigourdan	ﺏیگﻭﺭﺩﺍﻥ
bik	ﺏیک
bilal	ﺏیﻝﺍﻝ
bilhar	ﺏیﻝﻩﺍﺭ
bilinsky	ﺏیﻝیﻥﺱکی
bill	ﺏیﻝ
billany	ﺏیﻝﺍﻥی
billing	ﺏیﻝیﻥگ
billings	ﺏیﻝیﻥگﺯ
billingsley	ﺏیﻝیﻥگﺍﺱﻝﺍی
billington	ذیﻝیﻥگﺕﻥ
billo	ﺏیﻝﻭ
bills	ﺏیﻝﺯ
billycock	ﺏیﻝیکﻭک
bin	ﺏیﻥ
binay	ﺏیﻥی
bindemann	ﺏیﻥﺩﻡﻥ
bines	ﺏیﻥﺱ
binesh	ﺏیﻥﺵ
bing	ﺏیﻥگ
bingen	ﺏیﻥﺝﻥ
bingham	ﺏیﻥﻕﺍﻡ
binion	ﺏیﻥییﻭﻥ
binner	ﺏیﻥﺭ
binnie	ﺏیﻥی
binns	ﺏیﻥﺯ
binod	ﺏیﻥﻭﺩ
binoy	ﺏیﻥﻭی
biocroft	ﺏیﻭکﺭﺍﻑﺕ
bionic	ﺏییﻭﻥیک
bipin	ﺏیپیﻥ
bippert	ﺏﺍیپﺭﺕ
bir	ﺏیﺭ
birch	ﺏیﺭچ
birdsong	ﺏﺭﺩﺱﺍﻥگ
birenboim	ﺏیﺭﻥﺏﻭیﻡ
birge	ﺏیﺭگ
birgel	ﺏیﺭگﻝ
birk	ﺏیﺭک
bismarck	ﺏیﺱﻡﺍﺭک
bissau	ﺏیﺱﺍیﻭ
bisset	ﺏیﺱﺕ
bissett	ﺏیﺱﺕ
biswanath	ﺏیﺯﻭﺍﻥﺍﺕ
biswas	ﺏیﺯﻭﺍﺱ
bittard	ﺏیﺕﺍﺭﺩ
bitz	ﺏیﺕﺯ
bixler	ﺏیکﺱﻝﺭ
bizer	ﺏیﺯﺭ
black	ﺏﻝک
blackley	ﺏﻝکﻝی
blackman	ﺏﻝکﻡﻥ
blacksher	ﺏﻝکﺵیﺭ
blackwell	ﺏﻝکﻭﻝ
blaha	ﺏﻝﺍﻩﺍ
blaik	ﺏﻝیک
blain	ﺏﻝیﻥ
blake	ﺏﻝیک
blakeman	ﺏﻝکﻡﻥ
blal	ﺏﻝﺍﻝ
blalock	ﺏﻝﺍﻝﺍک
blanchard	ﺏﻝﺍﻥچﺍﺭﺩ
blanche	ﺏﻝﺍﻥچﻩ
blane	ﺏﻝیﻥ
blank	ﺏﻝﻥک
blanstan	ﺏﻝﺍﻥﺱﺕﺍﻥ
blas	ﺏﻝﺱ
blasi	ﺏﻝﺍﺱی
blasius	ﺏﻝﺍﺱیﻭﺱ
blask	ﺏﻝﺍﺱک
blatta	ﺏﻝیﺕﺍ
blattberg	ﺏﻝﺕﺏﺭگ
blavatnik	ﺏﻝﺍﻭﺍﺩﻥیک
blaz	ﺏﻝﺍﺯ
blaze	ﺏﻝیﺯ
blazek	ﺏﻝﺍﺯک
blazquez	ﺏﻝﺍﺯکییﻭﺯ
bleier	ﺏﻝیﺭ
blencowe	ﺏﻝیﻥکﻭ
blenkhorn	ﺏﻝﻥکﻩﻭﺭﻥ
blight	ﺏﻝﺍیﺕ
blinco	ﺏﻝیﻥکﻭ
bloch	ﺏﻝﺍچ
block	ﺏﻝﺍک
blohm	ﺏﻝﻭﻩﻡ
blokland	ﺏﻝکﻝﻥﺩ
bloomberg	ﺏﻝﻭﻡﺏﺭگ
blorenge	ﺏﻝﻭﺭﻥﺝ
blosser	ﺏﻝﺍﺱﺭ
bloxom	ﺏﻝکﺱﻭﻡ
bluff	ﺏﻝﺍﻑ
bluffs	ﺏﻝﺍﻑﺱ
blum	ﺏﻝﺍﻡ
blumcke	ﺏﻝﺍﻡکﻩ
blumen	ﺏﻝﻭﻡﻥ
blumenfeld	ﺏﻝﻭﻡﻥﻑﻝﺩ
blunsdon	ﺏﻝﺍﺱﺩﻥ
blystone	ﺏﻝیﺱﺕﻭﻥ
blyweiss	ﺏﻝیﻭیﺱ
boaz	ﺏﻭﺯ
bob	ﺏﺍﺏ
bobbi	ﺏﺍﺏی
bobbie	ﺏﺍﺏی
bobbish	ﺏﻭﺏیﺵ
bobbitt	ﺏﺏیﺕ
bobby	ﺏﺍﺏی
bobe	ﺏﺍﺏ
bocci	ﺏﻭﺱی
bockoven	ﺏﻭکﻭﻥ
bocock	ﺏکﻭک
bocska	ﺏﺍکﺱکﺍ
bodapati	ﺏﻭﺩﺍپﺍﺕی
bode	ﺏﻭﺩ
boden	ﺏﻭﺩﻥ
bodenmiller	ﺏﻭﺩﻥﻡیﻝﺭ
bodla	ﺏﻭﺩﻝﺍ
bodman	ﺏﺍﺩﻡﻥ
bodo	ﺏﻭﺩﻭ
boerkoel	ﺏﺭکﻭﻝ
bogaard	ﺏﻭگﺍﺭﺩ
bogdon	ﺏﺍگﺩﺍﻥ
boggs	ﺏﺍگﺯ
boije	ﺏﻭﺝی
boisseau	ﺏﻭیﺱیﻭ
boisvieux	ﺏﻭیﺱﻭیکﺱ
boisy	ﺏﻭیﺯی
boivin	ﺏﻭیﻭﻥ
bojanchev	ﺏﻭژﺍﻥچیﻭ
bokel	ﺏﻭکﻝ
boker	ﺏﻭکﺭ
bolden	ﺏﻝﺩﻥ
boldt	ﺏﻭﻝﺩﺕ
boldwijn	ﺏﻝﺩﻭییﻥ
bolecek	ﺏﺍﻝﺱک
bolef	ﺏﻭﻝﻑ
bolen	ﺏﻭﻝﻥ
bolinder	ﺏﺍﻝﺍﻥﺩﺭ
boller	ﺏﻭﻝﺭ
bolton	ﺏﻭﻝﺕﺍﻥ
bomber	ﺏﻭﻡﺏﺭ
bomberger	ﺏﻭﻡﺏﺭگﺭ
bomhard	ﺏﻭﻡﻩﺍﺭﺩ
bommen	ﺏﺍﻡﻥ
bon	ﺏﺍﻥ
bonacci	ﺏﻥﺍکﺱی
bonander	ﺏﻭﻥﺍﻥﺩﺭ
bonar	ﺏﻭﻥﺍﺭ
bonavoglia	ﺏﻭﻥﺍﻭگﻝیﺍ
bond	ﺏﺍﻥﺩ
bonds	ﺏﺍﻥﺩﺯ
bongard	ﺏﻭﻥگﺍﺭﺩ
bongarts	ﺏﺍﻥگﺍﺭﺕﺯ
bonifacius	ﺏﻥیﻑﺍﺱیﻭﺱ
bonin	ﺏﻥیﻥ
bonita	ﺏﺍﻥیﺕﺍ
bonito	ﺏﺍﻥیﺕﻭ
bonitz	ﺏﻭﻥیﺕﺯ
bonnabeau	ﺏﺍﻥﺍﺏیﻭ
bonnell	ﺏﺍﻥﻝ
bonner	ﺏﺍﻥﺭ
bonney	ﺏﺍﻥی
bonni	ﺏﺍﻥی
bonnie	ﺏﻭﻥی
bonomo	ﺏﻭﻥﻭﻡﻭ
bononno	ﺏﻭﻥﻭﻥﻭ
bonura	ﺏﺍﻥیﻭﺭﺍ
booby	ﺏﻭﺏی
booey	ﺏﻭﺍی
booher	ﺏﻭﻩﺭ
bool	ﺏﻭﻝ
boon	ﺏﻭﻥ
boonstra	ﺏﻭﻥﺱﺕﺭﺍ
boora	ﺏﻭﺭﺍ
boose	ﺏﻭﺱ
bootsie	ﺏﻭﺕﺱیﻩ
bop	ﺏﺍپ
borchert	ﺏﻭﺭچﺭﺕ
borden	ﺏﺭﺩﻥ
border	ﺏﻭﺭﺩﺭ
borecki	ﺏﻭﺭکی
borel	ﺏﻭﺭﻝ
borg	ﺏﺭگ
borgailo	ﺏﺭگﺍیﻝﻭ
borge	ﺏﻭﺭگﺍ
borgeson	ﺏﺭگﺱﻭﻥ
borione	ﺏﻭﺭیﻭﻥ
borland	ﺏﺭﻝﻥﺩ
borm	ﺏﻭﺭﻡ
bormann	ﺏﺭﻡﻥ
bormel	ﺏﻭﺭﻡﻝ
borrell	ﺏﻭﺭﻝ
borriello	ﺏﻭﺭیﻝﻝﻭ
borries	ﺏﻭﺭیﺯ
borris	ﺏﻭﺭیﺱ
borst	ﺏﻭﺭﺱﺕ
borud	ﺏﻭﺭﺍﺩ
bos	ﺏﻭﺱ
bosak	ﺏﺱﺍک
boschga	ﺏﻭچگﺍ
bose	ﺏﻭﺱ
boshuysen	ﺏﻭﺱﻭیﺱﻥ
bosky	ﺏﺍﺱکی
bosley	ﺏﻭﺱﻝی
bosnia	ﺏﻭﺱﻥی
boss	ﺏﺍﺱ
bossart	ﺏﻭﺱﺍﺭﺕ
bosscha	ﺏﺍﺱﺵﺍ
bossom	ﺏﺍﺱﻭﻡ
bosson	ﺏﻭﺱﻭﻥ
bost	ﺏﻭﺱﺕ
bostak	ﺏﻭﺱﺕﺍک
bostic	ﺏﺍﺱﺕیک
boston	ﺏﻭﺱﺕﻭﻥ
bostrom	ﺏﻭﺱﺕﺭﺍﻡ
bostwick	ﺏﻭﺱﺕیک
boswall	ﺏﺍﺱﻭﺍﻝ
boswell	ﺏﺱﻭﻝ
botari	ﺏﻭﺕﺍﺭی
botez	ﺏﻭﺕﺯ
botting	ﺏﺍﺕیﻥگ
bottrell	ﺏﻭﺕﺭﻝ
bouali	ﺏﻭﺍﻝی
bouas	ﺏﻭﺍﺱ
boudeweyn	ﺏﻭﺩیﻭیﻥ
boudreau	ﺏﻭﺩﺭﻭ
boukhny	ﺏﻭخﻥی
boulton	ﺏﻭﻝﺕﻥ
bounty	ﺏﺍﻥﺕی
bourcier	ﺏﻭﺭﺱیﺭ
bourgea	ﺏﻭﺭﺝیﺍ
bourgeois	ﺏﻭﺭگیﻭیﺱ
bourlon	ﺏﻭﺭﻝﻥ
bourque	ﺏﻭﺭگﻭ
bouton	ﺏﻭﺕﻭﻥ
boutte	ﺏﻭﺕ
bouwer	ﺏﻭﺭ
bouwers	ﺏﻭﺭﺯ
bouzid	ﺏﻭﺯیﺩ
bowden	ﺏﺍﻭﺩﻥ
bowen	ﺏﻭﻥ
bowery	ﺏﺍﻭﺭی
bowie	ﺏﻭی
bowling	ﺏﻭﻝیﻥگ
bowman	ﺏﻭﻡﻥ
bowyer	ﺏﻭیﺭ
boyer	ﺏﺍیﺭ
boyes	ﺏﻭیﺱ
boyko	ﺏﻭیکﻭ
boylan	ﺏﻭیﻝﻥ
bozeman	ﺏﻭﺯﻡﺍﻥ
bozhidar	ﺏﻭژیﺩﺍﺭ
bozkurt	ﺏﻭﺯکﺍﺭﺕ
bozuwa	ﺏﺯﻭﺍ
brabant	ﺏﺭﺍﺏﺍﻥﺕ
brachman	ﺏﺭﺍچﻡﻥ
brackney	ﺏﺭﺍکﻥی
bradely	ﺏﺭﺩﻝی
braden	ﺏﺭﺩﻥ
bradish	ﺏﺭﺍﺩیﺵ
bradley	ﺏﺭﺍﺩﻝی
bradly	ﺏﺭﺩﻝی
bradshaw	ﺏﺭﺍﺩﺵﺍﻭ
brady	ﺏﺭیﺩی
braendle	ﺏﺭﺍﻥﺩﻝ
brafford	ﺏﺭﺍﻑﻭﺭﺩ
bragdon	ﺏﺭگﺩﺍﻥ
braham	ﺏﺭﺍﻩﺍﻡ
brahim	ﺏﺭﺍﻩیﻡ
braithwaite	ﺏﺭﺍیﺕﻭیﺕ
brake	ﺏﺭک
bram	ﺏﺭﺍﻡ
bran	ﺏﺭﺍﻥ
branch	ﺏﺭﻥچ
branchaud	ﺏﺭﻥچﺍﻭﺩ
brand	ﺏﺭﻥﺩ
brandeis	ﺏﺭﻥﺩیﺱ
brandel	ﺏﺭﻥﺩﻝ
brandelle	ﺏﺭﻥﺩﻝ
brandi	ﺏﺭﺍﻥﺩی
brandt	ﺏﺭﺍﻥﺕ
brandy	ﺏﺭﻥﺩی
brannen	ﺏﺭﺍﻥﻥ
branscombe	ﺏﺭﺍﻥﺱکﻭﻡﺏ
branshaw	ﺏﺭﺍﻥﺵﺍﻭ
brashears	ﺏﺭﺍﺵیﺭﺯ
brashers	ﺏﺭﺍﺵﺭﺯ
brashier	ﺏﺭﺍﺵﺍیﺭ
brassard	ﺏﺭﺍﺱﺍﺭﺩ
brater	ﺏﺭﺍﺕﺭ
bratina	ﺏﺭﺍﺕیﻥﺍ
braughton	ﺏﺭﺍﻭﺕﻭﻥ
braunhut	ﺏﺭﻭﺍﻥﻩﺍﺕ
bravo	ﺏﺭﺍﻭﻭ
brawn	ﺏﺭﺍﻭﻥ
bray	ﺏﺭی
breakespear	ﺏﺭکﺍﺱپیﺭ
bream	ﺏﺭیﻡ
breanndan	ﺏﺭیﻥﺩﺍﻥ
breaud	ﺏﺭﻭﺩ
brecher	ﺏﺭچﺭ
breck	ﺏﺭک
bree	ﺏﺭی
breeding	ﺏﺭیﺩیﻥگ
breedlove	ﺏﺭیﺩﻝﺍﻭ
breitling	ﺏﺭیﺕﻝیﻥگ
brejcha	ﺏﺭچﺍ
brenchley	ﺏﺭﻥچﻝی
brendan	ﺏﺭﻥﺩﺍﻥ
brendon	ﺏﺭﻥﺩﻭﻥ
brennan	ﺏﺭﻥﺍﻥ
brenner	ﺏﺭﻥﺭ
brent	ﺏﺭﻥﺕ
bresee	ﺏﺭﺱی
breslau	ﺏﺭﺱﻝﺍﻭ
bresler	ﺏﺭﺱﻝﺭ
bressman	ﺏﺭﺱﻡﻥ
breton	ﺏﺭیﺕﻭﻥ
breuer	ﺏﺭﻭیﺭ
brevik	ﺏﺭﻭیک
brewer	ﺏﺭیﻭﺭ
brewery	ﺏﺭیﻭﺭی
brewster	ﺏﺭﻭﺱﺕﺭ
breyer	ﺏﺭیﺭ
bri	ﺏﺭی
briand	ﺏﺭیﺍﻥ
briber	ﺏﺭیﺏﺭ
brice	ﺏﺭﺍیﺱ
briceno	ﺏﺭیﺱﻥﻭ
bridge	ﺏﺭیﺝ
bridgman	ﺏﺭیﺝﻡﻥ
bridwell	ﺏﺭیﺩﻭﻝ
brie	ﺏﺭﺍی
brien	ﺏﺭﺍیﻥ
brier	ﺏﺭﺍیﺭ
briganti	ﺏیﺭیگﺍﻥﺕی
bright	ﺏﺭﺍیﺕ
brighton	ﺏﺭﺍیﺕﻭﻥ
brij	ﺏﺭیﺝ
brimmer	ﺏﺭیﻡﺭ
brimstone	ﺏﺭیﻡﺱﺕﻭﻥ
brind	ﺏﺭیﻥﺩ
brindle	ﺏﺭیﻥﺩﻝ
bringardner	ﺏﺭیﻥگﺍﺭﺩﻥﺭ
brink	ﺏﺭیﻥک
brinkler	ﺏﺭﺍیﻥکﻝﺭ
brinkman	ﺏﺭیﻥکﻡﻥ
brinson	ﺏﺭیﻥﺱﻥ
brisbane	ﺏﺭیﺱﺏیﻥ
brisbin	ﺏﺭیﺱﺏیﻥ
brisinda	ﺏﺭیﺱیﻥﺩﺍ
bristol	ﺏﺭیﺱﺕﻭﻝ
brita	ﺏﺭیﺕﺍ
british	ﺏﺭیﺕیﺵ
brito	ﺏﺭیﺕﻭ
britt	ﺏﺭیﺕ
britten	ﺏﺭﺍیﺕﻥ
britton	ﺏﺭییﺕﻭﻥ
broadfield	ﺏﺭﻭﺩﻑیﻝﺩ
broadhurst	ﺏﺭﻭﺩﻩﺍﺱﺕ
broadley	ﺏﺭﻭﺩﻝی
brock	ﺏﺭﺍک
brockley	ﺏﺭﺍکﻝی
brod	ﺏﺭﺩ
broda	ﺏﺭﻭﺩﺍ
brode	ﺏﺭﺍﺩ
broder	ﺏﺭﻭﺩﺭ
brohl	ﺏﺭﻭﻩﻝ
broilo	ﺏﺭﻭیﻝﻭ
brokaw	ﺏﺭﻭکﺍﻭ
broken	ﺏﺭﻭکﻥ
bromage	ﺏﺭﻭﻡیﺝ
bromberg	ﺏﺭﻭﻡﺏﺭگ
bromberger	ﺏﺭﻭﻡﺏﺭگﺭ
bromley	ﺏﺭﻭﻡﻝی
bromwich	ﺏﺭﺍﻭیچ
bron	ﺏﺭﺍﻥ
brook	ﺏﺭﻭک
brooke	ﺏﺭﻭک
brooker	ﺏﺭﻭکﺭ
brooks	ﺏﺭﻭکﺯ
brookwell	ﺏﺭﻭکﻭﻝ
brossard	ﺏﺭﻭﺱﺭﺩ
brother	ﺏﺭﺍﺩﺭ
brotherton	ﺏﺭﺍﺩﺭﺕﻥ
broude	ﺏﺭﺍﺩ
brougham	ﺏﺭﺍگﻩﺍﻡ
broun	ﺏﺭﺍﻥ
brousseau	ﺏﺭﻭﺱیﺍﻭ
browarek	ﺏﺭﻭﺍﺭک
brown	ﺏﺭﺍﻭﻥ
browner	ﺏﺭﺍﻭﻥﺭ
brownfield	ﺏﺭﺍﻭﻥﻑیﻝﺩ
browning	ﺏﺭﺍﻭﻥیﻥگ
broz	ﺏﺭﻭﺯ
bruck	ﺏﺭﻭک
brueckner	ﺏﺭﻭکﻥﺭ
bruening	ﺏﺭﻭیﻥیﻥگ
bruines	ﺏﺭﻭیﻥﺱ
brumbaugh	ﺏﺭﺍﻡﺏﺍﻭ
brumfield	ﺏﺭﻭﻡﻑیﻝﺩ
brummer	ﺏﺭﺍﻡﺭ
bruneau	ﺏﺭﻭﻥییﻭ
brunelle	ﺏﺭﻭﻥﻝ
bruner	ﺏﺭﻭﻥﺭ
brunsdon	ﺏﺭﺍﻥﺱﺩﻭﻥ
brunswick	ﺏﺭﺍﻥﺱﻭیک
brunt	ﺏﺭﺍﻥﺕ
brunwin	ﺏﺭﻭﻥﻭییﻥ
bruty	ﺏﺭﻭﺕی
brutzman	ﺏﺭﻭﺕﺯﻡﻥ
bruyn	ﺏﺭﻭیﻥ
bruzzone	ﺏﺭﺍﺯﻭﻥ
bryan	ﺏﺭیﺍﻥ
bryant	ﺏﺭیﺍﻥﺕ
bryce	ﺏﺭیﺱ
bryde	ﺏﺭﺍیﺩ
bryguy	ﺏﺭیگﻭی
bryn	ﺏﺭیﻥ
bryner	ﺏﺭیﻥﺭ
bryon	ﺏﺭیﻭﻥ
bryony	ﺏﺭیﻭﻥی
bryson	ﺏﺭﺍیﺱﻭﻥ
buay	ﺏﻭﺍی
bubb	ﺏﺍﺏ
bubble	ﺏﺍﺏﻝ
buberel	ﺏﺍﺏیﺭﻝ
bucci	ﺏﻭﺱی
buceck	ﺏﻭﺱک
buchalter	ﺏﺍچﺍﻝﺕﺭ
buckle	ﺏﻭکﻝ
buckley	ﺏﺍکﻝی
buckner	ﺏﺍکﻥﺭ
buckser	ﺏﺍکﺱﺭ
bucky	ﺏﺍکی
bud	ﺏﺍﺩ
buda	ﺏﻭﺩﺍ
budd	ﺏﺍﺩ
budds	ﺏﺍﺩﺯ
buddy	ﺏﺍﺩی
budi	ﺏﻭﺩی
budig	ﺏﺍﺩیگ
budnick	ﺏﺍﺩﻥیک
budur	ﺏﺍﺩﺭ
budziak	ﺏﺍﺩﺯیﺍک
buffalo	ﺏﻭﻑﺍﻝﻭ
buffy	ﺏﺍﻑی
bugay	ﺏﺍگﺍی
buggelli	ﺏﺍگﻝی
bugos	ﺏﻭگﺱ
bugs	ﺏﺍگﺯ
buhl	ﺏﻭﻩﻝ
bulkowski	ﺏﺍﻝکﻭﺱکی
bulla	ﺏﻭﻝﺍ
bullard	ﺏﻭﻝﺍﺭﺩ
bulldozer	ﺏﻭﻝﺩﺯﺭ
buller	ﺏﻭﻝﺭ
bulloch	ﺏﻭﻝﻭچ
bullock	ﺏﺍﻝﺍک
bulow	ﺏﻭﻝﻭ
bulsara	ﺏﺍﻝﺱﺍﺭﺍ
bulus	ﺏﻝﺍﺱ
bum	ﺏﻭﻡ
bumgardner	ﺏﻭﻡگﺍﺭﺩﻥﺭ
bumsoo	ﺏﺍﻡﺱﻭ
bunge	ﺏﺍﻥگ
bungers	ﺏﺍﻥگﺭﺯ
bunn	ﺏﺍﻥ
bunny	ﺏﺍﻥی
bunten	ﺏﻭﻥﺕﻥ
bunting	ﺏﺍﻥﺕیﻥگ
buraschi	ﺏﻭﺭﺍﺱچی
burden	ﺏﺭﺩﻥ
burdick	ﺏﺍﺭﺩیک
burditt	ﺏﺭﺩیﺕ
burfitt	ﺏﺍﺭﻑیﺕ
burg	ﺏﺍﺭگ
burgaard	ﺏﺭگﺍﺭﺩ
burgess	ﺏﺭگﺱ
burghard	ﺏﺍﺭﻕﺍﺭﺩ
burhan	ﺏﺭﻩﺍﻥ
burj	ﺏﺭﺝ
burkhard	ﺏﺭخﺍﺭﺩ
burl	ﺏﺭﻝ
burleson	ﺏﺭﻝﺱﻭﻥ
burling	ﺏﺭﻝیﻥگ
burnette	ﺏﺭﻥﺕ
burney	ﺏﺭﻥی
burns	ﺏﺭﻥﺯ
burr	ﺏﺭ
burrell	ﺏﺍﺭﻝ
burrill	ﺏﻭﺭیﻝ
burris	ﺏﺍﺭیﺱ
burrows	ﺏﺍﺭﻭﺯ
burrup	ﺏﻭﺭﺍپ
bursell	ﺏﻭﺭﺱﻝ
burson	ﺏﺭﺱﻭﻥ
burt	ﺏﺭﺕ
burton	ﺏﺍﺭﺕﻥ
burts	ﺏﺭﺕﺱ
busa	ﺏﻭﺱﺍ
busarow	ﺏﻭﺱﺍﺭﻭ
busch	ﺏﻭﺵ
bush	ﺏﻭﺵ
bushnell	ﺏﻭﺵﻥﻝ
bushore	ﺏﻭﺵﻭﺭ
busick	ﺏﻭﺱیک
bussiere	ﺏیﺯیﺭ
bustamante	ﺏﻭﺱﺕﺍﻡﻥﺕ
bustillos	ﺏﺍﺱﺕیﻝﻭﺱ
butaysh	ﺏﻭﺕﺍیﺵ
butch	ﺏﺍچ
butcher	ﺏﻭﺕچﺭ
butler	ﺏﺍﺕﻝﺭ
butte	ﺏﻭﺕ
butterworth	ﺏﺍﺕﺭﻭﺭث
buttnut	ﺏﺍﺕﻥﺍﺕ
button	ﺏﺍﺕﻥ
buttress	ﺏﺍﺕﺭﺯ
buttresses	ﺏﺍﺕﺭﺱﺱ
buttuls	ﺏﺍﺕﺍﻝﺱ
buxey	ﺏﻭکﺱی
buzbee	ﺏﺍﺯﺏی
buzby	ﺏﺍﺯﺏی
byfield	ﺏﺍیﻑیﻝﺩ
bygden	ﺏﺍیﺩﻥ
byler	ﺏیﻝﺭ
byles	ﺏیﻝﺱ
bynon	ﺏﺍیﻥﻭﻥ
byra	ﺏیﺭﺍ
byrd	ﺏیﺭﺩ
byrne	ﺏیﺭﻥﻩ
byrnes	ﺏیﺭﻥﺱ
byron	ﺏیﺭﻥ
bysouth	ﺏﺍیﺱﻭﺕ
bystander	ﺏیﺱﺕﺍﻥﺩﺭ
byung	ﺏیﺍﻥگ
byungse	ﺏیﻭﻥگﺱ
byungtae	ﺏیﺍﻥگﺕﺍی
cabaniss	کﺏﺍﻥیﺱ
cabe	کیﺏ
cable	کیﺏﻝ
cabrello	کﺍﺏﺭیﻝﻭ
cacace	ﺱﺍﺱﺍکی
cacciola	کﺍکیﻭﻝﺍ
cacho	کﺍچﻭ
cactus	کﺍکﺕﻭﺱ
cadaver	کﺩﺍﻭﺭ
cadle	کﺩﻝ
cadman	کﺍﺩﻡﻥ
cadmus	کﺍﺩﻡﻭﺱ
caffrey	کﺍﻑﺭی
cagle	کﺍگﻝ
cahoon	کﺍﻩﻭﻥ
caillet	کیﻝﺕ
cain	کیﻥ
caine	کﺍیﻥی
caird	کﺍیﺭﺩ
cakebread	کیکﺏﺭیﺩ
cala	کﺍﻝﺍ
calahan	کﺍﻝﺍﻩﺍﻥ
calbridge	کﺍﻝﺏﺭیﺝ
caldwell	کﺍﻝﺩﻭﻝ
caliaro	کﺍﻝیﺍﺭﻭ
calinisan	کﺍﻝیﻥﺱﺍﻥ
calius	کﺍﻝییﻭﺱ
call	کﺍﻝ
callanan	کﺍﻝﺍﻥﺍﻥ
callebaut	کﺍﻝﺏﺍﻭﺕ
callis	کﺍﻝیﺱ
calow	کﺍﻝﻭ
calsyn	کﺍﻝﺱیﻥ
calvert	کﺍﻝﻭﺭﺕ
calvin	کﺍﻝﻭیﻥ
camacho	کﺍﻡﺍچﻭ
camama	کﺍﻡﺍﻡﺍ
cameron	کﺍﻡﺭﻭﻥ
cameros	کﺍﻡﺭﻭﺱ
camfield	کﻡﻑیﻝﺩ
campagna	کﺍﻡپﺍگﻥﺍ
campbell	کﺍﻡپﺏﻝ
campey	کﻡپی
campillo	کﺍﻡپیﻝﻭ
campos	کﺍﻡپﻭﺱ
canale	کﺍﻥﺍﻝ
candau	کﺍﻥﺩﺍیﻭ
candy	کﻥﺩی
canfield	کﺍﻥﻑیﻝﺩ
canis	کﺍﻥیﺱ
cannava	کﺍﻥﺍﻭﺍ
cano	کﺍﻥﻭ
canon	کﺍﻥﻥ
cantara	کﺍﻥﺕﺭﺍ
cantrell	کﺍﻥﺕﺭﻝ
canyon	کﺍﻥیﻭﻥ
cao	کﺍﻭ
cape	کیپ
capistran	کپیﺱﺕﺭﺍﻥ
caprette	کپﺭﺕ
caraher	کﺍﺭﺍﻩﺭ
carangelo	کﺍﺭﺍﻥﺝﻝﻭ
carbajal	کﺍﺭﺏﺍﺝﺍﻝ
carbone	کﺍﺭﺏﻥ
carbonell	کﺭﺏﻭﻥیﻝ
carbonelli	کﺍﺭﺏﻭﻥﻝی
carbonneau	کﺍﺭﺏﻭﻥیﺍ
cardenas	کﺍﺭﺩﻥﺍﺱ
cardinali	کﺍﺭﺩیﻥﺍﻝی
cargill	کﺍﺭگیﻝ
carhart	کﺍﺭﻩﺍﺭﺕ
cariaga	کﺍﺭیﺍگﺍ
carina	کﺍﺭﻥیﺍ
carl	کﺍﺭﻝ
carlile	کﺍﺭﻝﺍیﻝ
carlin	کﺍﺭﻝیﻥ
carlos	کﺍﺭﻝﺱ
carlton	کﺍﺭﻝﺕﻭﻥ
carmichael	کﺍﺭﻡیچﺍیﻝ
carmody	کﺍﺭﻡﻭﺩی
carmona	کﺍﺭﻡﻭﻥﺍ
carnelian	کﺍﺭﻥﻝیﺍﻥ
carnell	کﺭﻥﻝ
carnerie	کﺍﺭﻥﺭی
carnes	کﺍﺭﻥﺯ
carney	کﺍﺭﻥی
carnie	کﺍﺭﻥی
carol	کﺭﻭﻝ
carolyn	کﺍﺭﻭﻝیﻥ
carosso	کﺍﺭﻭﺱﻭ
carpenter	کﺍﺭپﻥﺕﺭ
carr	کﺍﺭ
carragher	کﺍﺭﺍگﺭ
carrara	کﺍﺭﺍﺭﺍ
carrasco	کﺍﺭﺍﺱکﻭ
carreira	کﺍﺭیﺭﺍ
carrier	کﺭیﺭ
carrillo	کﺍﺭیﻝﻭ
carson	کﺍﺭﺱﻭﻥ
carstens	کﺍﺭﺱﺕﻥﺯ
carstensen	کﺍﺭﺱﺕﻥﺱﻥ
cartaxo	ﺱﺍﺭﺕﺍکﺱﻭ
carter	کﺍﺭﺕﺭ
cartwright	کﺍﺭﺕﺭﺍیﺕ
caruso	کﺍﺭﻭﺱﻭ
carver	کﺍﺭﻭﺭ
cary	کﺭی
casanova	کﺍﺱﺍﻥﻭﻭﺍ
cascio	کﺍﺱیﻭ
case	کیﺱ
casertino	کﺍﺱﺭﺕیﻥﻭ
casey	کیﺱی
cash	کﺵ
casner	کﺍﺱﻥﺭ
cason	کیﺱﻭﻥ
casriel	کﺍﺱﺭیﻝ
cassara	کﺍﺱﺍﺭﺍ
cassel	کﺱﻝ
casselman	کﺍﺱﻝﻡﻥ
cassidy	کیﺱیﺩی
cassinelli	کﺍﺱیﻥﻝی
castano	کﺍﺱﺕﺍﻥﻭ
castellot	کﺱﺕﻝﻭﺕ
caster	کﺱﺕﺭ
castergine	کﺍﺱﺕﺭگیﻥ
casti	کﺍﺱﺕی
castillo	کﺍﺱﺕیﻝﻭ
castle	کﺱﺕﻝ
castner	کﺱﺕﻥﺭ
castricum	کﺍﺱﺕﺭیکﺍﻡ
castro	کﺍﺱﺕﺭﻭ
cat	کﺕ
catalano	کﺍﺕﺍﻝﺍﻥﻭ
catanzaro	کﺕﻥﺯﺭﻭ
caterina	کﺍﺕﺭیﻥﺍ
catharyn	کﺍﺕﺭیﻥ
cathcart	کﺍﺕکﺍﺭﺕ
catherine	کﺍﺕﺭیﻥ
catlett	کﺕﻝﺕ
catrijn	کﺍﺕﺭیﺝ
catsimatides	کﺕﺱیﻡﺍﺕیﺩﺱ
cattell	کﺕﻝ
cau	کﺍﻭ
cauchon	کﺍچﻭﻥ
caudill	کﺍﻭﺩیﻝ
cauldwell	کﺍﻝﺩﻭﻝ
cauligi	کﺍﻝیگی
cavasin	کﺍﻭﺍﺱیﻥ
cave	کیﻭ
cavers	کﺍﻭﺭﺯ
cawston	کﺍﻭﺱﺕﻥ
cazier	کﺍﺯیﺭ
cecil	ﺱﺱیﻝ
cedelle	کﺩﻝ
cederholm	ﺱﺩﺭﻩﻝﻡ
celarier	ﺱﻝﺍﺭیﺭ
celetje	ﺱیﻝیﺕ
celio	ﺱﻝیﻭ
cemal	کﻡﺍﻝ
cena	ﺱیﻥﺍ
cengeloglu	ﺱﻥگﻝﻭگﻝﻭ
cera	کﺭﺍ
cerasuolo	ﺱﺭﺍﺱﻭﻝ
cernese	کﺭﻥیﺯ
cerveny	کﺭﻭﻥی
cessaro	ﺱﺯﺍﺭﻭ
cetia	ﺱیﺕیﺍ
chacko	چﺍکﻭ
chai	چﺍی
chaiken	چﺍیکﻥ
chalk	چﺍﻝک
chamberlain	چﺍﻡﺏﺭﻝﺍیﻥ
chambers	چﻡﺏﺭﺯ
champlin	چﺍﻡپﻝیﻥ
chancellor	چﻥﺱﻝﻭﺭ
chand	چﺍﻥﺩ
chande	چﻥﺩ
chander	چﺍﻥﺩﺭ
chandler	چﻥﺩﻝﺭ
chandonia	چﺍﻥﺩﻭﻥیﺍ
chandran	چﺍﻥﺩﺭﺍﻥ
chaney	چﺍﻥی
channel	کﺍﻥﺍﻝ
chao	چﺍﻭ
chaos	کیﻭﺱ
chapela	چﺍپﻝﺍ
chapman	چﺍپﻡﻥ
chappell	چﺍپﻝ
chard	چﺍﺭﺩ
charles	چﺍﺭﻝﺯ
charlie	چﺍﺭﻝی
charlotte	چﺍﺭﻝﻭﺕ
charlton	چﺍﺭﺕﻭﻥ
charlyn	چﺍﺭﻝیﻥ
charng	چﺍﺭﻥگ
charpentier	کﺍﺭپﻥﺕیﺭ
charrick	چﺍﺭیک
chartier	کﺍﺭﺕیﺭ
chas	چﺍﺵ
chasms	چﺍﺱﻡﺯ
chastain	چﺍﺱﺕیﻥ
chatane	چﺍﺕﺍﻥی
chauhan	چﺍﻭﻩﺍﻥ
chaun	چﺍﻭﻥ
chauncy	چﺍﻥﺱی
chauveau	چﺍﻭﻭیﻭ
chauvin	چﺍﻭﻭیﻥ
chavda	چﺍﻭﺩﺍ
chavez	چﺍﻭﺯ
chayes	چﺍیﺯ
che	چﻩ
cheal	چیﺍ
cheapman	چیپﻡﻥ
cheatwood	چیﺕﻭﻭﺩ
checkered	چکﺭﺩ
chee	چی
cheek	چیک
cheeks	چیکﺯ
cheeky	چیکی
cheenu	چیﻥﻭ
cheesman	چیﺱﻡﻥ
cheetham	چیﺕﺍﻡ
cheiltje	چیﺕ
chelian	چﻝییﺍﻥ
chelius	چﻝیﻭﺱ
chellaton	چﻝﺍﺕﻭﻥ
chemaly	چﻡﺍﻝی
chembezi	چﻡﺏﺯی
chemello	کﻡﻝﻝﻭ
chen	چﻥ
chenader	چﻥﺍﺩﺭ
cheney	چﻥی
chenteh	چﻥﺕﻩ
cherag	چﺭﺍگ
cherbel	چﺭﺏﻝ
cherepy	چﺭپی
cherie	چﺭی
cherrie	چﺭی
cherubini	چﺭﻭﺏیﻥی
cheryl	چﺭیﻝ
ches	چﺱ
chesbro	چﺱﺏﺭﻭ
chesney	چﺱﻥی
chesny	چﺱﻥی
chester	چﺱﺕﺭ
chet	چیﺕ
chetal	چﺕﺍﻝ
chetan	چیﺕﺍﻥ
chetwin	چیﺕﻭیﻥ
chevron	چﻭﺭﻥ
chi	چی
chia	چیﺍ
chiaki	چیﺍکی
chiang	چیﺍﻥگ
chiasson	کیﺍﺱﻭﻥ
chicago	ﺵیکﺍگﻭ
chichester	چیچﺱﺕﺭ
chick	چیک
chickery	چیکﺭی
chickon	چیکﻥ
chiem	چیﻡ
chien	چیﻥ
chiew	چیﻭ
chik	چیک
child	چﺍیﻝﺩ
childs	چیﻝﺩﺯ
chillingworth	چیﻝیﻥگﻭﺭﺕ
chilly	چیﻝی
chin	چیﻥ
chinen	چیﻥﻥ
chiou	چیﻭ
chip	چیپ
chirag	چیﺭﺍک
chisholm	چیﺵﻭﻝﻡ
chishtie	چیﺵﺕی
chism	چیﺱﻡ
chistopher	کیﺱﺕﻭﻑﺭ
chitrady	چیﺕﺭﺩی
chitta	چیﺕﺍ
chittick	چیﺕیک
chizoba	چیﺯﻭﺏﺍ
chizu	چیﺯﻭ
chizuru	چیﺯﻭﺭﻭ
cho	چﻭ
choi	چﻭی
chokri	چﻭکﺭی
chokshi	چﻭکﺵی
cholette	ﺵﻭﻝﺕ
choo	چﻭ
choon	چﻭﻥ
chopde	چپﺩی
chopin	چﺍپیﻥ
chopra	چﺍپﺭﺍ
chou	چﻭ
choua	چﻭﺍ
choudhary	چﻭﺩﻩﺍﺭی
chovanak	چﻭﻭﺍﻥﺍک
chow	چﻭ
choy	چﻭی
chrescyntie	چﺭیﺱکیﻥﺕی
chris	کﺭیﺱ
christa	کﺭیﺱﺕﺍ
christal	کﺭیﺱﺕﺍﻝ
christall	چﺭیﺱﺕﺍﻝ
christen	کﺭیﺱﺕﻥ
christian	کﺭیﺱﺕیﺍﻥ
christiana	کﺭیﺱﺕیﺍﻥﺍ
christiansen	کﺭیﺱﺕیﺍﻥﺱﻥ
christie	کﺭیﺱﺕی
christine	کﺭیﺱﺕیﻥ
christman	کﺭیﺱﺕﻡﻥ
christmann	کﺭیﺱﺕﻡﻥ
christophe	کﺭیﺱﺕﻭﻑ
christopherson	کﺭیﺱﺕﻭﻑﺭﺱﻭﻥ
christou	کﺭیﺱﺕﻭ
christy	کﺭیﺱﺕی
chrons	کﺭﻭﻥﺯ
chu	چﻭ
chua	چﻭﺍ
chunping	چﻭﻥپیگ
church	چﺭچ
churchill	چﺭچیﻝ
chusak	چﻭﺱﺍک
chwolka	چﻭﻝکﺍ
cichero	کیچﺭﻭ
cinq	ﺱیﻥک
cionca	ﺱیﻭﻥکﺍ
cirilo	ﺱیﺭیﻝﻭ
cirques	ﺱیﺭکﻭیﺱ
cisneros	کیﺱﻥﺭﻭﺱ
citizen	ﺱیﺕیﺯﻥ
cittlau	ﺱیﺕﻝﺍیﻭ
claborn	کﻝﺏﻭﺭﻥ
clabourne	کﻝﺍﺏﻭﺭﻥ
clack	کﻝﺍک
claertie	کﺍﻝﺭﺕی
claesje	کﺍﻝﺱگﻩ
claeson	کﻝﺍیﺱﻭﻥ
claire	کﻝیﺭ
clamen	کﻝﺍﻡﻥ
clancey	کﻝﺍﻥﺱی
clanfield	کﻝﺍﻥﻑیﻝﺩ
clanton	کﻝﺍﻥﺕﻭﻥ
clare	کﻝیﺭ
claridge	کﻝﺍﺭیﺝ
clark	کﻝﺍﺭک
clarke	کﻝﺍﺭک
claros	کﻝﺭﻭﺱ
claude	کﻝﺍﻭﺩی
claudia	کﻝﺍﻭﺩیﺍ
clausing	کﻝﺍﺯیﻥگ
claussen	کﻝﻭﺱﻥ
clawsie	کﻝﺍﻭﺱی
clay	کﻝی
clayson	کﻝﺍیﺱﻭﻥ
clayton	کﻝیﺕﻭﻥ
cleavey	کﻝیﻭی
cleek	کﻝیک
cleere	کﻝیﺭ
clewley	کﻝﻭﻝی
cliburn	کﻝیﺏﺭﻥ
cliff	کﻝیﻑ
clifford	کﻝیﻑﺭﺩ
clift	کﻝیﻑﺕ
clifton	کﻝیﻑﺕﻭﻥ
clonfero	کﻝﻭﻥﻑﺭﻭ
clough	کﻝﺍﻑ
club	کﻝﻭﺏ
clugston	کﻝﺍگﺱﺕﻭﻥ
clumpner	کﻝﻭﻡپﻥﺭ
coast	کﻭﺱﺕ
coatney	کﻭﺕﻥی
cobabe	کﻭﺏیﺏ
cobo	کﻭﺏﻭ
coccia	کﻭکیﺍ
cochran	کﻭچﺭﺍﻥ
cockburn	کﻭکﺏﺭﻥ
cockerill	کﺍکﺭیﻝ
cockfield	کﻭکﻑیﻝﺩ
cockroft	کﺍکﺭﺍﻑﺕ
code	کﺩ
codogno	کﻭﺩﻭگﻥﻭ
cody	کﻭﺩی
coenraad	کﻥﺭﺍﺩ
coenraadt	کﻥﺭﺍﺕ
coenradus	کﻥﺭﺍﺩﻭﺱ
coenraedt	کﻥﺭﺍﺩ
coesmans	کﺯﻡﻥﺯ
coevering	کﻭﺍﻭﺭیﻥگ
coeyman	کﻭییﻡﺍﻥ
coffee	کﺍﻑی
coffin	کﺍﻑیﻥ
cogburn	کﺍگﺏﻭﺭﻥ
coggeshall	کﺍگﺵﺍﻝ
coghlan	کﻭگﻝﺍﻥ
cogswell	کﺍگﺱﻭﻝ
cohan	کﻭﻩﺍﻥ
cohn	کﻭﻩﻥ
coil	کﻭیﻝ
coisman	کﻭیﺱﻡﺍﻥ
col	کﻝ
colbey	کﻝﺏی
colburn	کﻝﺏﺭﻥ
colclasure	کﺍﻝکﻝﺍﺱﻭﺭ
coldewey	کﻝﺩﻭی
coleno	کﻭﻝﻥﻭ
colety	کﻭﻝﺕی
coley	کﻝی
colfelt	کﻝﻑﻝﺕ
colin	کﻭﻝیﻥ
collett	کﺍﻝﺕ
collette	کﻝﺕ
collie	کﺍﻝی
collier	کﻭﻝیﺭ
collinet	کﺍﻝیﻥﺕ
collingwood	کﻭﻝیﻥگﻭﻭﺩ
collins	کﺍﻝیﻥﺯ
collum	کﺍﻝﻭﻡ
colman	کﻭﻝﻡﻥ
colombo	کﻝﻡﺏﻭ
colon	کﻭﻝﻥ
colonello	کﺍﻝﻭﻥﻝﻭ
colten	کﻝﺕﻥ
colton	کﺍﻝﺕﻭﻥ
colwell	کﻭﻝﻭﻝ
comarow	کﻭﻡﺍﺭﻭ
combee	کﺍﻡﺏیی
combites	کﺍﻡﺏیﺕﺯ
combs	کﺍﻡﺏﺯ
comeau	کﺍﻡیﻭ
comer	کﻡﺭ
compton	کﺍﻡپﺕﻭﻥ
computer	کﺍﻡپیﻭﺕﺭ
comstock	کﺍﻡﺱﺕﺍک
conboy	کﺍﻥﺏﻭی
conconi	کﺍﻥکﻥﺕ
condelli	کﺍﻥﺩﻝی
conduit	کﺍﻥﺩﻭییﺕ
cone	کﺍﻥ
conerly	کﺍﻥﺭﻝی
confer	کﺍﻥﻑﺭ
cong	کﺍﻥگ
conley	کﺍﻥﻝی
conlon	کﺍﻥﻝﻥ
connelly	کﺍﻥﻝی
connett	کﻭﻥﺕ
connor	کﺍﻥﺭ
conover	کﻭﻥﻭﻭﺭ
conroy	کﺍﻥﺭﻭی
constabaris	کﺍﻥﺱﺕﺍﺏﺍﺭیﺱ
conte	کﺍﻥﺕﻩ
convery	کﺍﻥﻭﺭی
cook	کﻭک
cookson	کﻭکﺱﻭﻥ
cool	کﻭﻝ
cooley	کﻭﻝی
coomber	کﻭﻡﺏﺭ
cootjans	کﻭﺕﺝﺍﻥﺯ
copeland	کﻭپﻝﻥﺩ
coplen	کﻭپﻝﻥ
coppeans	کﻭپﻥﺯ
coppedge	کﻭپﺝ
coppejans	کﻭپﺝﺍﻥﺯ
copps	کﺍپﺱ
coram	کﻭﺭﺍﻡ
corbett	کﻭﺭﺏﺕ
corbin	کﻭﺭﺏیﻥ
corbit	کﺭﺏیﺕ
corcoran	کﺍﺭکﺍﺭﻥ
cordes	کﻭﺭﺩﺯ
cordrey	کﺭﺩﺭی
coren	کﻭﺭﻥ
corey	کﻭﺭی
corkum	کﻭﺭکﺍﻡ
corl	کﻭﺭﻝ
corley	کﺭﻝی
cormick	کﺭﻡیک
cornelius	کﺭﻥﻝیﻭﺱ
corneliusen	کﻭﺭﻥﻝیﻭﺱﻥ
cornellis	کﺭﻥﻝیﺱ
corns	کﻭﺭﻥﺯ
cornuelle	کﻭﺭﻥیﻭﻝ
cornwall	کﻭﺭﻥﻭﺍﻝ
cornwell	کﺭﻥﻭﻝ
coronella	کﻭﺭﻭﻥﻝﺍ
corradini	کﻭﺭﺍﺩیﻥی
corre	کﻭﺭ
correia	کﻭﺭیﺍ
corridor	کﻭﺭیﺩﻭﺭ
corrigan	کﻭﺭیگﺍﻥ
corsello	کﻭﺭﺱﻝﻭ
cort	کﻭﺭﺕ
cortell	کﻭﺭﺕﻝ
cortez	کﻭﺭﺕﺯ
corwin	کﺭﻭیﻥ
coryell	کﻭﺭیﻝ
corzine	کﻭﺭﺯﺍیﻥ
cosell	کﺍﺱﻝ
cosgriff	کﺍﺯگﺭیﻑ
cosgrove	کﺍﺱگﺭﻭﻩ
cosmas	کﻭﺱﻡﺍﺱ
costa	کﺍﺱﺕﺍ
costanza	کﻭﺱﺕﺍﻥﺯﺍ
costello	کﺍﺱﺕﻝﻭ
costner	کﺍﺱﺕﻥﺭ
cote	کﻭﺕ
cotlar	کﺕﻝﺍﺭ
cotroneo	کﻭﺕﺭﻭﻥیﻭ
cotta	کﻭﺕﺍ
cottle	کﺍﺕﻝ
couch	کﻭچ
coughlin	کﺍگﻝیﻥ
coulson	کﺍﻝﺱﻭﻥ
counsell	کﺍﻥﺱﻝ
courcelle	کﻭﺭﺱﻝ
courcoul	کﻭﺭکﻭﻝ
courtlandt	کﺭﺕﻝﻥﺩ
courtois	کﺍﺭﺕﻭیﺯ
coury	کﻭﺭی
coutts	ﺱﻭﺕﺱ
couzin	کﻭﺯیﻥ
coves	کﻭﻭﺱ
cowe	کﻭﻭ
cowen	کﻭیﻥ
cowley	کﺍﻭﻝی
cowling	کﺍﻭﻝیﻥگ
coxhead	کﺍکﺱﻩﺩ
coy	کﻭی
coyle	کﻭیﻝ
coyne	کﻭیﻥ
cozzi	کﻭﺯی
crabtree	کﺭﺏﺕﺭی
cracraft	کﺭکﺭﺍﻑﺕ
craft	کﺭﻑﺕ
crafton	کﺭﻑﺕﻭﻥ
craig	کﺭگ
crain	کﺭیﻥ
cramer	کﺭﺍﻡﺭ
crandlemire	کﺭﺍﻥﺩﻝﻡیﺭ
cranford	کﺭﻥﻑﺭﺩ
cranswick	کﺭﺍﻥﺯﻭیک
crapse	کﺭپﺱ
crase	کﺭیﺱ
crater	کﺭیﺕﺭ
craters	کﺭﺍﺕﺭﺯ
craven	کﺭیﻭﻥ
crawford	کﺭﺍﻭﻑﻭﺭﺩ
crawley	کﺭﺍﻭﻝی
cray	کﺭی
crealese	کﺭیﻝیﺯ
creasey	کﺭیﺱی
creasy	کﺭیﺱی
creath	کﺭیث
creek	کﺭیک
creider	کﺭیﺩﺭ
crepeau	کﺭیپیﻭ
crespo	کﺭﺱپﻭ
cress	کﺭﺱ
crest	کﺭیﺱﺕ
crests	کﺭﺱﺕﺱ
crevasse	کﺭیﻭﺍﺱ
crevasses	کﺭیﻭﺍﺱﺯ
crews	کﺭﻭﺯ
crichton	کﺭیﺵﺕﻭﻥ
crider	کﺭﺍیﺩﺭ
crisp	کﺭیﺱپ
crispen	کﺭیﺱپﻥ
crispijn	کﺭیﺱپیﺝﻥ
criswell	کﺭﺍیﺱﻭﻝ
critchfield	کﺭیچﻑیﻝﺩ
crockart	کﺭﺍکﺍﺭﺕ
crockett	کﺭﺍکﺕ
crockford	کﺭﺍکﻑﺭﺩ
crom	کﺭﻭﻡ
cronheim	کﺭﻭﻥﻩیﻡ
cropper	کﺭﺍپﺭ
crosby	کﺭﺍﺱﺏی
cross	کﺭﺍﺱ
crossen	کﺭﺍﺱﻥ
croteau	کﺭﻭﺕیﻭ
crouchley	کﺭﺍچﻝی
croughton	کﺭﺍﻕﺕﻭﻥ
croume	کﺭﻭﻡ
crouse	کﺭﻭﺱ
crowcroft	کﺭکﺭﺍﻑﺕ
crowe	کﺭﻭ
crowell	کﺭﺍﻭﻝ
crown	کﺭﺍﻭﻥ
crowson	کﺭﺍﻭﺱﻭﻥ
croyle	کﺭﻭیﻝ
crozier	کﺭﺍﺯیﺭ
crumbach	ﺱﺭﻭﻡﺏچ
crumhorn	کﺭﺍﻡﻩﻭﺭﻥ
crutcher	کﺭﺍچﺭ
crutchley	کﺭﺍچﻝی
crystal	کﺭیﺱﺕﺍﻝ
csaba	ﺱیﺱﺍﺏﺍ
cuenca	کﻭﻥکﺍ
culhane	کﺍﻝﻩیﻥ
cully	کﻭﻝی
culpin	کﺍﻝپیﻥ
cumming	کﺍﻡیﻥگ
cunitz	کﺍﻥیﺕﺯ
cunniff	کﺍﻥیﻑ
cunningham	کﺍﻥیﻥگﻩﺍﻡ
cuong	کیﻭﻥگ
cupples	کﻭپﻝﺱ
curran	کﻭﺭﺍﻥ
currie	کﺍﺭی
curry	کﺍﺭی
curson	کﺭﺱﻥ
curtain	کﺭﺕیﻥ
curtis	کﺍﺭﺕیﺱ
curtner	کﺍﺭﺕﻥﺭ
cushing	کﺍﺵیﻥگ
cushman	کﺍﺵﻡﻥ
cutchie	کﺍچی
cuthbert	کﺍﺕﺏﺭﺕ
cutie	کﻭﺕی
cutler	کﺍﺕﻝیﺭ
cutter	کﺍﺕﺭ
cutting	کﺍﺕیﻥگ
cybanski	چیﺏﺍﻥﺱکی
cybermage	ﺱﺍیﺏﺭﻡیﺝ
cyclones	ﺱیﺱﻝﻭﻥﺯ
cynthia	ﺱیﻥﺕیﺍ
cyr	ﺱیﺭ
cyril	کیﺭیﻝ
cyrus	ﺱیﺭﻭﺱ
daatje	ﺩیﺕﺝی
dabney	ﺩﺍﺏﻥی
daco	ﺩﺍکﻭ
dada	ﺩﺍﺩﺍ
dade	ﺩﺍﺩﻩ
dady	ﺩﺩی
dag	ﺩﺍگ
dagan	ﺩﺍگﺍﻥ
dagley	ﺩگﻝی
dahl	ﺩﺍﻝ
dahuk	ﺩﺍﻩﺍک
dailey	ﺩیﻝی
dais	ﺩﺍیﺱ
dal	ﺩﺍﻝ
dalager	ﺩﺍﻝﺍﺝﺭ
dalal	ﺩﻝﺍﻝ
dalbec	ﺩﺍﻝﺏک
daley	ﺩﺍﻝی
dalie	ﺩﻝی
dallaire	ﺩﺍﻝﺍیﺭ
dallan	ﺩﺍﻝﺍﻥ
dallard	ﺩﻝﺭﺩ
dalley	ﺩﺍﻝی
dalmia	ﺩﺍﻝﻡییﺍ
dalrymple	ﺩﺍﻝﺭیﻡپﻝ
dame	ﺩیﻡ
damian	ﺩﺍﻡیﺍﻥ
damiano	ﺩﺍﻡیﺍﻥﻭ
damion	ﺩﺍﻡیﻭﻥ
damis	ﺩﻡیﺱ
damon	ﺩیﻡﻥ
dan	ﺩﺍﻥ
dana	ﺩﺍﻥﺍ
danald	ﺩﺍﻥﺍﻝﺩ
dancer	ﺩﻥﺱﺭ
dancing	ﺩﺍﻥﺱیﻥگ
danco	ﺩﺍﻥکﻭ
dancy	ﺩﺍﻥﺱی
dandler	ﺩﻥﺩﻝﺭ
dandridge	ﺩﻥﺭیﺝ
danekind	ﺩﻥکیﻥﺩ
danenbarger	ﺩﺍﻥﻥﺏﺍﺭگﺭ
dangel	ﺩﺍﻥﺝﻝ
dangoor	ﺩﻥﺝﻭﺭ
dani	ﺩﺍﻥی
daniel	ﺩﺍﻥیﻝ
daniell	ﺩﺍﻥیﻝ
danielle	ﺩﺍﻥیﻝ
daniels	ﺩﺍﻥییﻝﺱ
danielson	ﺩﺍﻥیﻝﺱﻭﻥ
danih	ﺩﻥیﻩ
danilo	ﺩﺍﻥیﻝﻭ
danis	ﺩﺍﻥیﺱ
danko	ﺩﺍﻥکﻭ
danz	ﺩﺍﻥﺯ
darby	ﺩﺍﺭﺏی
darde	ﺩﺭﺩﻩ
dare	ﺩیﺭ
darley	ﺩﺍﺭﻝی
darlington	ﺩﺍﺭﻝیﻥگﺕﻥ
darnall	ﺩﺭﻥﺍﻝ
darnell	ﺩﺍﺭﻥﻝ
darrell	ﺩﺍﺭﻝ
darrigues	ﺩﺍﺭیگﻭﺱ
darrow	ﺩﺍﺭﻭ
dart	ﺩﺍﺭﺕ
daryl	ﺩﺍﺭیﻝ
das	ﺩﺍﺱ
datri	ﺩﺍﺕﺭی
datz	ﺩﺕﺱ
dauber	ﺩﺍﻭﺏﺭ
daud	ﺩﺍیﻭﺩ
daugherty	ﺩﺍگﺭﺕی
daulton	ﺩﺍﻝﺕﻭﻥ
daum	ﺩﻭﻡ
dauria	ﺩﺍیﻭﺭیﺍ
dauwen	ﺩﺍیﻭﻭﻥ
davenport	ﺩﺍﻭﻥپﺭﺕ
daverin	ﺩﺍﻭﺭیﻥ
davi	ﺩیﻭیﺩ
david	ﺩیﻭیﺩ
davide	ﺩیﻭیﺩ
davidian	ﺩیﻭیﺩیﺍﻥ
davidson	ﺩیﻭیﺩﺱﻭﻥ
davie	ﺩیﻭی
davison	ﺩیﻭیﺱﻥ
dawes	ﺩﺍﻭﺱ
dawkins	ﺩﺍکیﻥﺯ
dawning	ﺩﺍﻭﻥیﻥگ
dawood	ﺩﺍﻭﺩ
dawson	ﺩﺍﺱﻥ
dawud	ﺩﺍﻭﺍﺩ
dax	ﺩﺍکﺱ
day	ﺩی
dayr	ﺩیﺭ
dea	ﺩی
deadfield	ﺩﺩﻑیﻝﺩ
dealy	ﺩیﻝی
dean	ﺩیﻥ
deaner	ﺩیﻥﺭ
deangelo	ﺩیﻥگﻝﻭ
dear	ﺩیﺭ
deatherage	ﺩﺕﺭیﺝ
debathe	ﺩیﺏیﺕ
debathonia	ﺩیﺏﺍﺕﻭﻥیﺍ
debow	ﺩیﺏﻭ
decker	ﺩکﺭ
declerck	ﺩکﻝﺭک
deconinck	ﺩیکﺍﻥیﻥک
decouty	ﺩیکﺍﻭﺕی
dedrick	ﺩﺩﺭیک
deeming	ﺩیﻡیﻥگ
dees	ﺩیﺱ
defroy	ﺩﻑﺭﻭی
degen	ﺩیگﺍﻥ
degennaro	ﺩیگﻥﺍﺭﻭ
degerlund	ﺩگﺭﻝﻭﻥﺩ
degotardi	ﺩگﻭﺕﺍﺭﺩی
degraff	ﺩگﺭﺍﻑ
degraw	ﺩیگﺭﻭ
deguzman	ﺩیگﺍﺯﻡﻥ
dehmel	ﺩﻡﻝ
dehner	ﺩﻩﻥﺭ
dehnert	ﺩﻩﻥﺭﺕ
dei	ﺩی
deibele	ﺩیﺏﻝ
deibler	ﺩﺏﻝﺭ
deicher	ﺩیچیﺭ
deininger	ﺩیﻥیﻥگﺭ
dekan	ﺩکﺍﻥ
dekel	ﺩیکﻝ
dekok	ﺩکک
del	ﺩﻝ
delaere	ﺩیﻝﺍیﺭ
delaney	ﺩیﻝﻥی
deleeuw	ﺩیﻝیﻭ
delikatny	ﺩﻝیکﺍﺕﻥی
delisio	ﺩﻝیﺱیﻭ
dellinger	ﺩیﻝیﻥگﺭ
dellis	ﺩﻝیﺱ
dellmann	ﺩﻝﻡﺍﻥ
deloris	ﺩﻝﻭﺭیﺯ
delouise	ﺩﻝﻭیﺱ
deloura	ﺩﻝﻭﺭﺍ
delrio	ﺩﻝﺭیﻭ
deltuvia	ﺩﻝﺕﻭﻭیﺍ
dema	ﺩیﻡﺍ
demarest	ﺩیﻡﺍﺭﺱﺕ
demars	ﺩیﻡﺍﺭﺱ
demcak	ﺩﻡکﺍک
demers	ﺩیﻡﺭﺱ
demetrio	ﺩیﻡیﺕﺭیﻭ
demetriou	ﺩیﻡیﺕﺭیﻭ
demke	ﺩﻡکﻩ
demler	ﺩﻡﻝﺭ
demon	ﺩﻡﻥ
dempster	ﺩﻡپﺱﺕﺭ
den	ﺩﻥ
denault	ﺩﻥﺍﻭﻝﺕ
denebeim	ﺩیﻥﺏیﻡ
deng	ﺩﻥگ
denham	ﺩﻥﻩﺍﻡ
denkewalter	ﺩﻥکﻭﺍﻝﺕﺭ
denman	ﺩﻥﻡﻥ
dennell	ﺩیﻥﻝ
denning	ﺩﻥیﻥگ
dennison	ﺩﻥیﺱﻭﻥ
deno	ﺩﻥﻭ
denton	ﺩﻥﺕﻭﻥ
denux	ﺩﻥﻭکﺱ
depalm	ﺩﻭپﺍﻝﻡ
depaola	ﺩیپﺍیﻭﻝﺍ
deporter	ﺩیپﺭﺕﺭ
depressive	ﺩیپﺭﺱیﻭ
derby	ﺩﺭﺏی
derek	ﺩﺭک
derienze	ﺩﺭیﻥﺯ
dermott	ﺩﺭﻡﻭﺕ
derrick	ﺩﺭیک
derro	ﺩﺭﻭ
dervenis	ﺩﺭﻭﻥیﺱ
des	ﺩﺯ
desai	ﺩیﺱﺍی
desanto	ﺩیﺱﺍﻥﺕﻭ
desgagne	ﺩﺯگﺍگﻥﻩ
desle	ﺩﺱﻝ
desmet	ﺩﺱﻡیﺕ
desmond	ﺩیﺱﻡﻭﻥﺩ
desmoulins	ﺩﺱﻡﻭﻝیﻥﺯ
desnoyers	ﺩﺱﻥﻭیﺭﺯ
desotelle	ﺩﺱﺕﻝی
desoto	ﺩﺱﻭﺕﻭ
desrosiers	ﺩﺱﺭﺍﺯیﺭﺱ
dessent	ﺩیﺱﻥﺕ
detlefs	ﺩﺕﻝﻑﺱ
detours	ﺩیﺕﻭﺭﺯ
dettman	ﺩﺕﻡﻥ
detweiler	ﺩﺕﻭیﻝﺭ
devanathan	ﺩیﻭﺍﻥﺍﺕﺍﻥ
devarque	ﺩﺍﻭﺍﺭک
deven	ﺩیﻭﻥ
devender	ﺩﻭیﻥﺩﺭ
devenpeck	ﺩیﻥپیک
devereaux	ﺩﻭﺭﺍﻭکﺱ
devine	ﺩیﻭﺍیﻥ
deviney	ﺩﻭیﻥی
devisser	ﺩیﺯﺭ
devito	ﺩﻭیﺕﻭ
dewan	ﺩیﻭﺍﻥ
dewar	ﺩیﻭﺍﺭ
dewey	ﺩیﻭی
dewhirst	ﺩﻭﻩیﺭﺱﺕ
dewilde	ﺩیﻭیﻝﺩﻩ
dewitt	ﺩیﻭیﺕ
dexter	ﺩکﺱﺕﺭ
dhamar	ﺝﻡﺍﺭ
diaa	ﺩیﺍ
diab	ﺩیﺍﺏ
dial	ﺩﺍیﺍﻝ
diamantaras	ﺩیﺍﻡﺍﻥﺕﺍﺭﺍﺱ
diamond	ﺩیﺍﻡﻭﻥﺩ
diana	ﺩیﺍﻥﺍ
diane	ﺩیﺍﻥ
diaz	ﺩیﺍﺯ
dib	ﺩیﺏ
dibble	ﺩﺍیﺏﻝ
dick	ﺩیک
dickens	ﺩیکﻥﺯ
dickey	ﺩیکی
dickow	ﺩیکﻭ
dicky	ﺩیکی
dico	ﺩیکﻭ
die	ﺩﺍی
diederichs	ﺩیﺩیﺭیچﺱ
diedrich	ﺩیﺩﺭیخ
diego	ﺩیگﻭ
dierderick	ﺩیﺭﺩﺭک
dierk	ﺩیﺭک
diether	ﺩیﺕﺭ
dietmar	ﺩیﺕﻡﺍﺭ
dievertje	ﺩیﺭﻭﺭﺕﺝ
dighe	ﺩیگﻩ
digweed	ﺩیگﻭیﺩ
dik	ﺩیک
dike	ﺩﺍیک
dikstra	ﺩیکﺱﺕﺭﺍ
dil	ﺩیﻝ
dilan	ﺩیﻝﺍﻥ
dileep	ﺩیﻝیپ
dilemma	ﺩیﻝﻡﺍ
dilip	ﺩیﻝیپ
diller	ﺩیﻝﺭ
dilligan	ﺩﺍیﻝﺍیگﺍﻥ
dillon	ﺩیﻝﻥ
dillworth	ﺩیﻝﻭﺭث
dilten	ﺩﻝﺕﻥ
dima	ﺩیﻡﺍ
dimaryp	ﺩیﻡﺍﺭیپ
dimashq	ﺩیﻡﺍﺵ
dimitar	ﺩیﻡیﺕﺍﺭ
dimitri	ﺩیﻡیﺕﺭی
dimitrios	ﺩیﻡیﺕﺭیﻭﺱ
dimitris	ﺩیﻡیﺕﺭیﺱ
dimock	ﺩیﻡﻭک
din	ﺩیﻥ
dina	ﺩیﻥﺍ
dinah	ﺩیﻥﺍ
dineen	ﺩیﻥﻥ
dinesh	ﺩیﻥﺵ
ding	ﺩیﻥگ
dinghy	ﺩیﻥگی
dingsor	ﺩیﻥگﺱﻭﺭ
dingyi	ﺩیﻥگی
dini	ﺩیﻥی
dinler	ﺩیﻥﻝﺭ
dinn	ﺩیﻥ
dinno	ﺩیﻥﻭ
dinse	ﺩیﻥﺱ
dinsmoor	ﺩیﻥﺱﻡﻭﺭ
dint	ﺩیﻥﺕ
diomedea	ﺩیﺍﻡﺩی
dion	ﺩﺍیﺍﻥ
dione	ﺩﺍیﺍﻥ
dionida	ﺩیﻭﻥیﺩﺍ
dionisios	ﺩﺍیﺍﻥیﺱیﺱ
dionne	ﺩیﻭﻥﻩ
dionysia	ﺩﺍیﺍﻥیﺱیﺍ
dipak	ﺩیپﺍک
dipaolo	ﺩیپﺍیﻭﻝﻭ
dipboye	ﺩیپﺏﻭی
dipietro	ﺩیپیﺕﺭﻭ
dippold	ﺩیپﻝﺩ
director	ﺩﺍیﺭکﺕﻭﺭ
dirks	ﺩیﺭکﺱ
dirocco	ﺩیﺭﻭکﻭ
disegi	ﺩیﺱگی
dishaw	ﺩیﺵﺍﻭ
disney	ﺩیﺯﻥی
distel	ﺩیﺱﺕﻝ
ditutala	ﺩیﺕﻭﺕﺍﻝﺍ
divakaruni	ﺩیﻭﺍکﺍﺭﻭﻥی
divertje	ﺩیﻭﺭﺕ
divine	ﺩیﻭﺍیﻥ
divis	ﺩیﻭیﺱ
divya	ﺩیﻭیﺍ
dix	ﺩیکﺱ
dixie	ﺩیکﺱﺍی
dixon	ﺩیکﺱﻥ
dixson	ﺩیکﺱﻭﻥ
diya	ﺩیﺍ
diyala	ﺩییﺍﻝﺍ
dizon	ﺩیﺯﻭﻥ
djamila	ﺝﻡیﻝﺍ
doake	ﺩﻭک
doan	ﺩﻭﻥ
dobbratz	ﺩﻭﺏﺭﺍﺕﺯ
dobbs	ﺩﺍﺏﺱ
dobinson	ﺩﺍﺏیﻥﺱﻥ
dobrikin	ﺩﻭﺏﺭیکیﻥ
dobson	ﺩﺍﺏﺱﻭﻥ
dobyns	ﺩﺍﺏیﻥﺯ
doc	ﺩﺍک
dockhorn	ﺩﺍکﻩﻭﺭﻥ
doctors	ﺩﺍکﺕﺭﺯ
dodamani	ﺩﻭﺩﺍﻡﺍﻥی
doddek	ﺩﺍﺩک
dodds	ﺩﺍﺩﺱ
dodell	ﺩﻭﺩﻝ
dodge	ﺩﺍﺝ
dodgen	ﺩﺍگﻥ
dodier	ﺩﺍﺩیﺭ
doe	ﺩﻭ
dog	ﺩﺍگ
dogan	ﺩﻭگﺍﻥ
doggers	ﺩﺍگﺭﺯ
doggo	ﺩﺍﺩﻭ
dogs	ﺩﺍگﺯ
dogwatch	ﺩﺍگﻭﺍچ
doherty	ﺩﺍﻩﺭﺕی
dohn	ﺩﺍﻥ
doi	ﺩﻭی
dokkene	ﺩﺍکﻥ
dolan	ﺩﻭﻝﺍﻥ
dolbear	ﺩﺍﻝﺏیﺭ
dole	ﺩﻭﻝ
doleh	ﺩﻝﻩ
dolin	ﺩﻭﻝیﻥ
dolinar	ﺩﺍﻝیﻥﺍﺭ
dollens	ﺩﺍﻝﻥﺯ
dollinger	ﺩﺍﻝیﻥگﺭ
dolly	ﺩﺍﻝی
dolman	ﺩﺍﻝﻡﻥ
dolmas	ﺩﺍﻝﻡﺱ
dolores	ﺩﺍﻝﺭﺱ
domba	ﺩﻭﻡﺏﺍ
domen	ﺩﻭﻡﻥ
domenico	ﺩﻭﻡﻥیکﻭ
domeyko	ﺩﻭﻡیکﻭ
domingo	ﺩﻭﻡیﻥگﻭ
domingues	ﺩﺍﻡیﻥگﺱ
dominic	ﺩﻭﻡیﻥیک
dominick	ﺩﻭﻡیﻥیک
dominicus	ﺩﺍﻡیﻥیکﺍﺱ
dominion	ﺩﻭﻡیﻥیﻥ
dominy	ﺩﺍﻡیﻥی
domm	ﺩﻭﻡ
dona	ﺩﻭﻥﺍ
donachie	ﺩﻭﻥﺍچی
donaghy	ﺩﻥﺍﻕی
donald	ﺩﻥﺍﻝﺩ
donath	ﺩﻭﻥﺍﺕ
donati	ﺩﻭﻥﺍﺕی
donato	ﺩﻭﻥﺍﺕﻭ
donetsk	ﺩﻭﻥﺕﺱک
dong	ﺩﺍﻥگ
dongtai	ﺩﺍﻥگﺕﺍی
dongwei	ﺩﺍﻥگﻭی
dongyu	ﺩﺍﻥگیﻭ
donini	ﺩﻭﻥیﻥی
donn	ﺩﺍﻥ
donnelly	ﺩﺍﻥﻝی
donner	ﺩﺍﻥﺭ
donny	ﺩﺍﻥی
donovan	ﺩﺍﻥﺍﻭﺍﻥ
dooley	ﺩﺍﻝی
dooris	ﺩﻭﺭیﺱ
doortje	ﺩﺭﺕﻩ
doppelt	ﺩﻭپﻝﺕ
doppler	ﺩﻭپﻝﺭ
dora	ﺩﻭﺭﺍ
doraiswamy	ﺩﻭﺭیﺱﻭﻡی
doran	ﺩﻭﺭﺍﻥ
dorathee	ﺩﺭﺍﺕی
dorazio	ﺩﻭﺭﺍﺯیﻭ
dorchuck	ﺩﻭﺭچﺍک
dordal	ﺩﻭﺭﺩﺍﻝ
dorel	ﺩﻭﺭﻝ
doren	ﺩﻭﺭﻥ
dorfman	ﺩﻭﺭﻑﻡﺍﻥ
dorie	ﺩﻭﺭی
dorinda	ﺩﻭﺭیﻥﺩﺍ
doris	ﺩﻭﺭیﺱ
dorken	ﺩﻭﺭکﻥ
dorma	ﺩﻭﺭﻡﺍ
dorn	ﺩﻭﺭﻥ
doron	ﺩﺍﺭﻭﻥ
dorothy	ﺩﻭﺭﻭﺕی
dorsett	ﺩﻭﺭﺱﺕ
dorsey	ﺩﻭﺭﺱی
dortchen	ﺩﺭﺕچﻥ
dorthy	ﺩﻭﺭثی
dorwin	ﺩﻭﺭﻭیﻥ
doseok	ﺩﺍﺱیﻭک
doss	ﺩﺍﺱ
dossing	ﺩﺍﺱیﻥگ
dostalik	ﺩﻭﺱﺕﺍﻝیک
dotson	ﺩﺍﺕﺱﻭﻥ
dottie	ﺩﺍﺕی
dou	ﺩﻭ
douanier	ﺩﻭﺍﻥیﺭ
double	ﺩﺍﺏﻝ
doucas	ﺩﺍکﺍﺱ
doug	ﺩﻭگ
douhour	ﺩﻭﻩﻭﺭ
doulas	ﺩﺍﻝﺍﺱ
doumakes	ﺩﻭﻡیکﺯ
doupnik	ﺩﺍپﻥیک
dout	ﺩﺍﻭﺕ
dov	ﺩﺍﻭ
dove	ﺩﺍﻭ
dovell	ﺩﻭﻭﻝ
dovers	ﺩﺍﻭﺭﺱ
dow	ﺩﺍﻭ
dowaliby	ﺩﻭﺍﻝیﺏﺍی
dowler	ﺩﻭﻝﺭ
down	ﺩﺍﻭﻥ
downes	ﺩﻭﻥﺱ
downey	ﺩﺍﻭﻥی
downing	ﺩﺍﻭﻥیﻥگ
dox	ﺩﺍکﺱ
dozier	ﺩﻭﺯییﺭ
drabek	ﺩﺭﺍﺏک
drachman	ﺩﺭچﻡﻥ
drader	ﺩﺭﺍﺩﺭ
drag	ﺩﺭگ
dragan	ﺩﺭﺍگﺍﻥ
draganis	ﺩﺭﺍگﺍﻥیﺱ
dragomir	ﺩﺭگﻭﻡیﺭ
dragon	ﺩﺭگﻭﻥ
dragons	ﺩﺭگﻭﻥﺱ
draine	ﺩﺭﺍیﻥﻩ
drake	ﺩﺭیک
dralle	ﺩﺭﺍﻝ
dramatis	ﺩﺭﺍﻡﺍﺕیﺱ
draper	ﺩﺭﺍپﺭ
dratman	ﺩﺭﺍﺕﻡﻥ
dream	ﺩﺭیﻡ
dreamer	ﺩﺭیﻡﺭ
dreams	ﺩﺭیﻡﺯ
dreary	ﺩﺭیﺭی
drebes	ﺩﺭﺏﺱ
drees	ﺩﺭیﺱ
dreier	ﺩﺭیﺭ
drenter	ﺩﺭﻥﺕﺭ
dressner	ﺩﺭﺱﻥﺭ
drevik	ﺩﺭﻭیک
drew	ﺩﺭیﻭ
drewe	ﺩﺭیﻭ
drewett	ﺩﺭیﻭﺕ
drexel	ﺩﺭکﺱﻝ
dreyer	ﺩﺭﺍیﺭ
dreyfus	ﺩﺭیﻑﻭﺱ
dridge	ﺩﺭیﺩﺝی
driedger	ﺩﺭیﺝﺭ
drikha	ﺩﺭیخﺍ
drinks	ﺩﺭیﻥکﺱ
driscoll	ﺩﺭیﺱکﻭﻝ
driskill	ﺩﺭیﺱکیﻝ
drnek	ﺩﺭﻥک
drolet	ﺩﺭﺍﻝﺕ
droomer	ﺩﺭﻭﻡﺭ
drop	ﺩﺭﺍپ
dror	ﺩﺭﻭﺭ
drosehn	ﺩﺭﻭﺯﻥ
droste	ﺩﺭﺍﺱﺕ
drover	ﺩﺭﺍﻭﺭ
drown	ﺩﺭﺍﻭﻥ
druding	ﺩﺭﻭﺩیﻥگ
drudis	ﺩﺭﻭﺩیﺱ
druger	ﺩﺭﺍگﺭ
drukman	ﺩﺭﺍکﻡﻥ
drum	ﺩﺭﺍﻡ
drummond	ﺩﺭﻭﻡﺍﻥﺩ
drune	ﺩﺭﻭﻥی
dua	ﺩیﻭﺍ
duan	ﺩﻭﺍﻥ
duarte	ﺩﻭﺍﺭﺕﻩ
dubach	ﺩﺍﺏﺍچ
dubay	ﺩﻭﺏﺍی
dubear	ﺩﻭﺏیﺭ
dubiel	ﺩﺍﺏیﻝ
dubinin	ﺩﻭﺏیﻥیﻥ
dubinsky	ﺩﺍﺏیﻥﺱکی
dubois	ﺩﺍﺏﻭیﺱ
dubose	ﺩﺍﺏﻭﺱ
dubridge	ﺩﻭﺏﺭیﺩﺝ
dubris	ﺩﻭﺏﺭیﺯ
dubuc	ﺩﺍﺏﺍﺱ
duc	ﺩﺍک
ducharme	ﺩﻭچﺍﺭﻡ
duchaylard	ﺩﻭچﺍیﻝﺍﺭﺩ
duchet	ﺩﻭچﺕ
duckering	ﺩﺍکﺭیﻥگ
duckman	ﺩﺍکﻡﻥ
duckworth	ﺩﺍکﻭﺭث
ducloz	ﺩﺍکﻝﻭﺯ
duda	ﺩﻭﺩﺍ
dudgeon	ﺩﺍﺝیﻭﻥ
dudley	ﺩﺍﺩﻝی
dueck	ﺩﻭﺍک
duemler	ﺩﺍﻡﻝﺭ
duening	ﺩﻭیﻥیﻥگ
duerr	ﺩﻭیﺭ
duff	ﺩﺍﻑ
dufour	ﺩﻭﻑﻭﺭ
dug	ﺩﺍگ
dugan	ﺩﺍگﺍﻥ
dugger	ﺩﺍگﺭ
duha	ﺩیﻭﻩﺍ
duhamel	ﺩﺍﻩﺍﻡﻝ
duhon	ﺩﺍﻩﻥ
duickinck	ﺩﻭچیﻥچ
duk	ﺩﺍک
dulberger	ﺩﺍﻝﺏﺭگﺭ
dulfer	ﺩﺍﻝﻑﺭ
dull	ﺩﺍﻝ
dumbbell	ﺩﺍﻡﺏﻝ
dumitru	ﺩﺍﻡیﺕﺭﻭ
dumontet	ﺩﺍﻡﻭﻥﺕﺕ
dumpleton	ﺩﺍﻡپﻝﺕﻭﻥ
dun	ﺩﺍﻥ
dunae	ﺩﻭﻥﺍی
duncan	ﺩﺍﻥکﺍﻥ
dundas	ﺩﺍﻥﺩﺍﺱ
dundee	ﺩﺍﻥﺩی
dunedin	ﺩﺍﻥیﺩیﻥ
dunford	ﺩﺍﻥﻑﺭﺩ
dung	ﺩﺍﻥگ
dungeon	ﺩﺍﻥگیﻭﻥ
dunham	ﺩﺍﻥﻩﺍﻡ
dunki	ﺩﺍﻥکی
dunlap	ﺩﺍﻥﻝﻭپ
dunne	ﺩﺍﻥﻩ
dunphy	ﺩﺍﻥﻑی
dunsmore	ﺩﺍﻥﺱﻡﻭﺭ
dunster	ﺩﺍﻥﺱﺕﺭ
dunten	ﺩﺍﻥﺕﻥ
duparc	ﺩﺍپﺭک
duperre	ﺩﺍپﺭﺭی
dupree	ﺩﺍپﺭی
duprie	ﺩﻭپﺭی
dupuis	ﺩﻭپیﻭیﺱ
dupuy	ﺩﺍپﺍی
durand	ﺩﻭﺭﺍﻥﺩ
durham	ﺩﺍﺭﻩﺍﻡ
duroch	ﺩﻭﺭﻭچ
duross	ﺩﻭﺭﺍﺱ
durr	ﺩﺍﺭ
durrance	ﺩﻭﺭﺭﺍﻥﺱ
durrand	ﺩﺍﺭﺍﻥگ
durupt	ﺩﻭﺭﺍپﺕ
duse	ﺩﻭﺱ
dusen	ﺩﻭﺱﻥ
dusko	ﺩﻭﺱکﻭ
dusty	ﺩﻭﺱﺕی
duthoit	ﺩﺍﺕﻭیﺕ
dutta	ﺩﻭﺕﺍ
dutton	ﺩﺍﺕﻭﻥ
duvivier	ﺩﻭیﻭیﺭ
duy	ﺩﺍی
duyckinck	ﺩﺍیچیﻥچ
duzat	ﺩﻭﺯﺍﺕ
dwain	ﺩﺍیﻥ
dwaine	ﺩﺍیﻥ
dwight	ﺩﺍیﺕ
dworkin	ﺩﻭﺭکیﻥ
dyballa	ﺩﺍیﺏﺍﻝﺍ
dyer	ﺩﺍیﺭ
dykes	ﺩﺍکﺯ
dykins	ﺩیکیﻥﺯ
dyna	ﺩیﻥﺍ
dynamite	ﺩیﻥﺍﻡیﺕ
eachus	ﺍیچﺍﺱ
eadie	ﺍﺩی
eads	ﺍیﺩﺱ
eady	ﺍیﺩی
eaglestone	ﺍگﻝﺱﺕﻭﻥ
eales	ﺍیﻝﺯ
eamon	ﺍیﻡﻭﻥ
eannarino	ﺍیﻥﺍﺭیﻥﻭ
ear	ﺍﺭ
earl	ﺍیﺭﻝ
earle	ﺍﺭﻝ
earley	ﺍﺭﻝی
earnest	ﺍیﺭﻥﺱﺕ
earp	ﺍیﺭپ
eason	ﺍیﺱﺍﻥ
eassa	ﺍیﺱﺍ
eastburn	ﺍیﺱﺕﺏﺭﻥ
easter	ﺍیﺱﺕﺭ
easterbrook	ﺍیﺱﺕﺭﺏﺭﻭک
eastick	ﺍیﺱﺕیک
eastlake	ﺍﺱﺕﻝیک
eastland	ﺍیﺱﺕﻝﻥﺩ
eastman	ﺍیﺱﺕﻡﻥ
eastway	ﺍیﺱﺕﻭی
eastwood	ﺍیﺱﺕﻭﻭﺩ
eater	ﺍیﺕﺭ
ebach	ﺍیﺏﺍچ
ebbert	ﺍﺏﺭﺕ
ebdon	ﺍﺏﺩﻭﻥ
ebe	ﺍﺏی
eberbach	ﺍﺏﺭﺏﺍچ
eberle	ﺍﺏﺭﻝی
ebert	ﺍﺏﺭﺕ
ebina	ﺍﺏیﻥﺍ
eboreime	ﺍﺏﻭﺭیﻡﻩ
ebrahim	ﺍﺏﺭﺍﻩیﻡ
ebright	ﺍﺏﺭﺍیﺕ
ech	ﺍچ
eck	ﺍک
eckam	ﺍیکﺍﻡ
ecker	ﺍکﺭ
eckersand	ﺍکﺭﺱﺍﻥﺩ
eckert	ﺍکﺭﺕ
eckstein	ﺍکﺱﺕیﻥ
eckton	ﺍکﺕﻭﻥ
edara	ﺍﺩﺍﺭﺍ
edberg	ﺍﺩﺏﺭگ
eddey	ﺍﺩی
edenborough	ﺍیﺩﻥﺏﻭﺭگ
edgington	ﺍﺩگیﻥگﺕﻭﻥ
edginton	ﺍﺝیﻥﺕﻭﻥ
edmiston	ﺍﺩﻡیﺱﺕﻭﻥ
edmonds	ﺍﺩﻡﻭﻥﺯ
edsall	ﺍﺩﺱﺍﻝ
eduwart	ﺍﺩﻭﺍﺭﺕ
edvard	ﺍﺩﻭﺍﺭﺩ
edward	ﺍﺩﻭﺍﺭﺩ
edwardsson	ﺍﺩﻭﺍﺭﺩﺱﻥ
egan	ﺍیگﺍﻥ
egerton	ﺍگﺭﺕﻥ
egg	ﺍگ
eggeman	ﺍگﻡﻥ
eggert	ﺍیگﺭﺕ
eggington	ﺍﺝیﻥگﺕﻭﻥ
egilsson	ﺍگیﻝﺱﻭﻥ
egli	ﺍیگﻝی
egmose	ﺍگﻡﻭﺯ
eidam	ﺍیﺩﻡﻥ
eidsson	ﺍﺩﺱﻭﻥ
eileen	ﺍیﻝیﻥ
einke	ﺍیﻥکﻩ
einstein	ﺍﻥیﺵﺕیﻥ
eirik	ﺍیﺭیک
eisele	ﺍیﺯﻝ
eisert	ﺍیﺱﺭﺕ
eisner	ﺍﺵﻥﺭ
eivind	ﺍیﻭﻥﺩ
ekberg	ﺍکﺏﺭگ
ekerslato	ﺍکﺭﺱﺕﻭ
eklof	ﺍکﻝﻭﻑ
eklund	ﺍکﻝﺍﻥﺩ
ekman	ﺍکﻡﺍﻥ
ekmundensis	ﺍکﻡﺍﻥﺩﺱیﺱ
ekstrand	ﺍکﺱﺕﺭﻥﺩ
ekwall	ﺍکﻭﺍﻝ
elangco	ﺍﻝﺍﻥگکﻭ
elbows	ﺍﻝﺏﻭﺯ
eldin	ﺍﻝﺩیﻥ
eldred	ﺍﻝﺩﺭﺩ
eldridge	ﺍﻝﺩﺭیﺝ
eleveld	ﺍﻝﻭﻝﺩ
elf	ﺍﻝﻑ
elfering	ﺍﻝﻑﺭیﻥگ
elford	ﺍﻝﻑﻭﺭﺩ
elia	ﺍﻝیﺍ
eliason	ﺍﻝیﺍﺱﻭﻥ
elie	ﺍﻝی
elin	ﺍﻝیﻥ
eliot	ﺍیﻝﻭﺕ
elison	ﺍﻝیﺱﻭﻥ
elizabeth	ﺍﻝیﺯﺍﺏﺕ
elkan	ﺍﻝکﺍﻥ
elkington	ﺍﻝکیﻥگﺕﻥ
elkinton	ﺍﻝکیﻥﺕﻥ
ellam	ﺍﻝﺍﻡ
ellegaard	ﺍﻝگﺍﺭﺩ
ellen	ﺍﻝﻥ
ellerbeck	ﺍﻝﺭﺏک
ellery	ﺍﻝﺭی
elletson	ﺍﻝﺕﺱﻭﻥ
ellinger	ﺍﻝیﻥگﺭ
elliot	ﺍﻝیﻭﺕ
ellison	ﺍﻝیﺱﻭﻥ
elliston	ﺍﻝیﺱﺕﻭﻥ
ellwood	ﺍﻝﻭﻭﺩ
elman	ﺍﻝﻡﻥ
elmar	ﺍﻝﻡﺍﺭ
elmers	ﺍﻝﻡﺭﺱ
elmo	ﺍﻝﻡﻭ
elmoman	ﺍﻝﻡﻭﻡﺍﻥ
elmore	ﺍﻝﻡﻭﺭ
elmquist	ﺍﻝﻡکﻭﺍﺱﺕ
elof	ﺍﻝﻭﻑ
eloisa	ﺍیﻝﻭیﺯﺍ
elroy	ﺍﻝﺭﻭی
elsie	ﺍﻝﺱی
elsner	ﺍﻝﺱﻥﺭ
elson	ﺍﻝﺱﻭﻥ
elspeth	ﺍﻝﺱپﺩ
eltanin	ﺍﻝﺕﺍﻥیﻥ
elvers	ﺍﻝﻭﺭﺱ
elwin	ﺍﻝﻭیﻥ
elwood	ﺍﻝﻭﻭﺩ
elwyn	ﺍﻝﻭیﻥ
ely	ﺍﻝی
elya	ﺍﻝییﺍ
elyse	ﺍﻝیﺱ
elz	ﺍﻝﺯ
embar	ﺍﻡﺏﺍﺭ
embassy	ﺍﻡﺏﺍﺱی
emberley	ﺍﻡﺏﺭﻝی
emberling	ﺍﻡﺏﺭﻝیﻥگ
emerald	ﺍﻡﺭﺍﻝﺩ
emerging	ﺍﻡﺭﺝیﻥگ
emery	ﺍیﻡﺭی
emilie	ﺍﻡیﻝی
emilio	ﺍﻡیﻝییﻭ
emily	ﺍﻡیﻝی
emit	ﺍﻡیﺕ
emlen	ﺍﻡﻝﻥ
emmanuel	ﺍﻡﺍﻥیﻭﻝ
emmen	ﺍﻡﻥ
emmett	ﺍﻡیﺕ
emona	ﺍﻡﻭﻥﺍ
empereur	ﺍﻡپﺭﻭﺭ
empey	ﺍﻡپی
empson	ﺍﻡپﺱﻭﻥ
emre	ﺍﻡﺭ
ems	ﺍﻡﺱ
emyr	ﺍﻡیﺭ
ender	ﺍﻥﺩﺭ
enderborg	ﺍﻥﺩﺭﺏﻭﺭگ
enderby	ﺍﻥﺩﺭﺏی
endesworth	ﺍیﻥﺩﺱﻭﺭث
endre	ﺍﻥﺩﺭ
endurance	ﺍﻥﺩییﻭﺭﺍﻥﺱ
enete	ﺍﻥﺕ
enfant	ﺍﻥﻑﺍﻥﺕ
enfield	ﺍﻥﻑیﻝﺩ
engaged	ﺍیﻥگیﺝﺩ
engebretsen	ﺍﻥگﺏﺭﺕﺱﻥ
engebretson	ﺍﻥﺝﺏﺭﺕﺱﻭﻥ
engelhardt	ﺍﻥگﻝﻩﺍﺭﺩ
engelholm	ﺍﻥگﻝﻩﻝﻡ
engelhorn	ﺍﻥگﻝﻩﻭﺭﻥ
engelina	ﺍﻥگﻝیﻥﺍ
engels	ﺍﻥگﻝﺯ
engelsma	ﺍﻥگﻝﺍﺱﻡﺍ
engelson	ﺍﻥگﻝﺱﻭﻥ
engeltje	ﺍﻥگﻝﺕﺝ
engi	ﺍﻥﺝی
england	ﺍﻥگﻝﻥﺩ
englander	ﺍﻥگﻝﺍﻥﺩﺭ
english	ﺍیﻥگﻝیﺵ
englund	ﺍﻥگﻝﺍﻥﺩ
enigma	ﺍﻥیﺝﻡﺍ
enkerli	ﺍﻥکﺭﻝی
ennis	ﺍﻥیﺱ
enno	ﺍﻥﻭ
eno	ﺍﻥﻭ
enoksson	ﺍیﻥﻭکﺱﻥ
enos	ﺍﻥﻭﺱ
enotiadis	ﺍﻥﻭﺕییﺍﺩیﺱ
enric	ﺍﻥﺭیک
enrico	ﺍﻥﺭیکﻭ
enrique	ﺍﻥﺭیکیﻭ
enriquez	ﺍﻥﺭیکییﻭﺯ
entrikin	ﺍﻥﺕﺭیکیﻥ
entropy	ﺍﻥﺕﺭﺍپی
envoy	ﺍﻥﻭﻭی
enyart	ﺍﻥیﺍﺭﺕ
enying	ﺍﻥیﻥگ
enyo	ﺍﻥییﻭ
enzinger	ﺍﻥﺯیﻥگﺭ
eoin	ﺍیﻭیﻥ
eos	ﺍیﻭﺱ
eosin	ﺍیﻭﺱیﻥ
epp	ﺍپ
epperly	ﺍپﺭﻝی
epperson	ﺍیپﺭﺱﻭﻥ
eppert	ﺍیپﺭﺕ
eppstein	ﺍپیﺱﺕیﻥ
epshteyn	ﺍپﺵﺕیﻥ
epsilon	ﺍپﺱیﻝﻭﻥ
erach	ﺍﺭﺍﺵ
eran	ﺍﺭﺍﻥ
erasmus	ﺍﺭﺍﺱﻡﻭﺱ
erdmann	ﺍﺭﺩﻡﻥ
ereby	ﺍﺭﺏی
eremin	ﺍﺭﻡیﻥ
erez	ﺍﺭﺯ
erhard	ﺍﺭﻩﺍﺭﺩ
erica	ﺍﺭیکﺍ
erich	ﺍﺭیچ
erick	ﺍﺭیک
erickson	ﺍﺭیکﺱﻭﻥ
ericson	ﺍﺭیکﺱﻭﻥ
erik	ﺍﺭیک
erika	ﺍﺭیکﺍ
eriksen	ﺍﺭیکﺱﻥ
eriksson	ﺍﺭیکﺱﻭﻥ
erin	ﺍﺭیﻥ
ermrey	ﺍﺭﻡﺭی
ernest	ﺍﺭﻥﺱﺕ
eronen	ﺍﺭﻭﻥﻥ
ersheid	ﺍﺭﺵیﺩ
erskine	ﺍﺭﺱکﺍیﻥ
ertle	ﺍﺭﺕﻝ
escalante	ﺍﺱکﺍﻝﺍﻥﺕ
eskeldson	ﺍﺱکﻝﺩﺱﻭﻥ
eskite	ﺍﺱکﺍیﺕ
esler	ﺍﺱﻝﺭ
esparza	ﺍﺱپﺍﺭﺯﺍ
esposito	ﺍﺱپﺯیﺕﻭ
esquivel	ﺍﺱکﻭیﻭیﻝ
estanol	ﺍﺱﺕﺍﻥﻭﻝ
estes	ﺍﺱﺕﺱ
esteves	ﺍﺱﺕیﻭﺱ
estrugo	ﺍیﺱﺕﺭﺍگﻭ
ethilrede	ﺍﺕیﻝﺭﺩ
etienne	ﺍﺕیﻥی
etinzon	ﺍﺕیﻥﺯﻭﻥ
etkins	ﺍﺕکیﻥﺯ
etters	ﺍﺕﺭﺯ
ettinger	ﺍﺕیﻥگﺭ
etue	ﺍﺕﻭ
eugene	ﺍیﻭگﻥﻩ
eugenio	ﺍﻭگﻥیﻭ
eustis	ﺍیﻭﺱﺕیﺱ
evangelista	ﺍﻭﻥگﻝیﺱﺕﺍ
evans	ﺍیﻭﺍﻥﺯ
evelyn	ﺍیﻭﻝیﻥ
evens	ﺍیﻭﻥﺱ
evenson	ﺍﻭﻥﺱﻭﻥ
everhart	ﺍﻭﺭﻩﺭﺕ
evers	ﺍیﻭﺭﺱ
eversberg	ﺍﻭﺭﺱﺏﺭگ
everts	ﺍﻭﺭﺕﺱ
every	ﺍﻭﺭی
ewacha	ﺍﻭﺍچﺍ
ewald	ﺍیﻭﺍﻝﺩ
ewing	ﺍیﻭﺍیﻥگ
ewins	ﺍﻭیﻥﺯ
excretia	ﺍکﺱکﺭیﺕیﺍ
exile	ﺍکﺱﺍیﻝ
eye	ﺍی
eyes	ﺍیﺯ
eyles	ﺍیﻝیﺱ
eyman	ﺍیﻡﻥ
eynon	ﺍیﻥﻭﻥ
eyntje	ﺍیﻥژ
eyre	ﺍیﺭ
eyster	ﺍیﺱﺕﺭ
ezechiel	ﺍﺯچیﻝ
ezor	ﺍﺯﺭ
fabbro	ﻑﺏﺭﻭ
faber	ﻑیﺏﺭ
fabiano	ﻑﺍﺏیﺍﻥﻭ
fabre	ﻑﺍﺏﺭﻩ
fabris	ﻑﺍﺏﺭیﺱ
fabro	ﻑﺍﺏﺭﻭ
fac	ﻑک
face	ﻑیﺱ
fadil	ﻑﺍﺩیﻝ
fadila	ﻑﺍﺩیﻝﺍ
fadl	ﻑﺍﺩﻝ
fagan	ﻑﺍگﺍﻥ
fagans	ﻑﺍگﺍﻥﺱ
fagen	ﻑﺍﺝﻥ
fahd	ﻑﺍﺩ
fair	ﻑیﺭ
fairbairn	ﻑیﺭﺏﺭیﻥ
fairbank	ﻑﺍیﺭﺏﺍﻥک
fairbanks	ﻑیﺭﺏﻥکﺱ
fairhurst	ﻑیﺭﻩﺭﺱﺕ
fairuz	ﻑیﺭﻭﺯ
fairweather	ﻑیﺭﻭﺩﺭ
faiz	ﻑیﺽ
faiza	ﻑیﺽﺍ
faizel	ﻑیﺽﻝ
fakhri	ﻑﺍخﺭی
fakhriyya	ﻑخﺭییﺍ
falchuk	ﻑﺍﻝچﻭک
falco	ﻑﺍﻝکﻭ
falconer	ﻑﺍﻝکﻭﻥﺭ
fales	ﻑﺍﻝﺯ
falk	ﻑﺍﻝک
fallate	ﻑﻝﺍﺕ
fallon	ﻑﺍﻝﻭﻥ
famus	ﻑﺍﻡیﻭﺱ
fan	ﻑﻥ
fandrich	ﻑﺍﻥﺩﺭیچ
fane	ﻑﻥی
fanger	ﻑﻥگﺭ
farag	ﻑﺭگ
farago	ﻑﺍﺭﺍگﻭ
farah	طﺭﺍﺡ
farer	ﻑﺭﺭ
farid	ﻑﺭیﺩ
fariha	ﻑﺭیﺡﺍ
farkas	ﻑﺍﺭکﺍﺱ
farley	ﻑﺍﺭﻝی
farmer	ﻑﺍﺭﻡﺭ
farooq	طﺍﺭﻕ
farouk	ﻑﺭﻭک
farrell	ﻑﺍﺭﻝ
farrior	ﻑﺍﺭیﻭﺭ
farrugia	ﻑﺍﺭﻭگیﺍ
farwaniyah	ﻑﺭﻭﺍﻥیﺍﻩ
fasel	ﻑﺍﺱﻝ
fash	ﻑﺍﺵ
fasig	ﻑﺱیگ
fast	ﻑﺱﺕ
fatima	ﻑﺍطیﻡﺍ
faucett	ﻑﺍﻭﺱﺕ
faulkner	ﻑﺍﻝکﻥﺭ
faultless	ﻑﺍﻝﺕﻝﺱ
faunce	ﻑﺍﻭﻥﺱ
fausett	ﻑﺍﻭﺱﺕ
faust	ﻑﺍﻭﺱﺕ
fauvel	ﻑﺍﻭﻝ
fawaz	ﻑﺍﻭﺍﺯ
fawzi	ﻑﺍﺯی
fawziyya	ﻑﺍﺯیﺍ
fayette	ﻑﺍیﺕ
fayiz	ﻑﺍیﺯ
fayne	ﻑﺍیﻥ
fearn	ﻑیﺭﻥ
feather	ﻑﺩﺭ
fechner	ﻑچﻥﺭ
feder	ﻑﺩﺭ
federle	ﻑﺩﺭﻝ
federman	ﻑﺩﺭﻡﻥ
fedor	ﻑیﺩﻭﺭ
feehan	ﻑیﻩﺍﻥ
feely	ﻑیﻝی
feenan	ﻑیﻥﺍﻥ
feeney	ﻑیﻥی
feil	ﻑیﻝ
feiler	ﻑیﻝﺭ
felawka	ﻑﻝﺍﻭکﺍ
felder	ﻑﻝﺩﺭ
feldman	ﻑﻝﺩﻡﺍﻥ
feldmar	ﻑﻝﺩﻡﺍﺭ
feldspar	ﻑﻝﺩﺱپﺍﺭ
felice	ﻑﻝﺍیﺱ
felices	ﻑﻝیﺱﺯ
felix	ﻑﻝیکﺱ
felizardo	ﻑﻝیﺯﺍﺭﺩﻭ
fellini	ﻑﻝیﻥی
fellows	ﻑیﻝﻭﺯ
felteau	ﻑﻝﺕیﻭ
femea	ﻑﻡیﺍ
femmetje	ﻑیﻡیﺝﻩ
fenchurch	ﻑﻥچﺍﺭچ
fender	ﻑﻥﺩﺭ
feng	ﻑﻥگ
fenn	ﻑﻥ
fenner	ﻑﻥﺭ
fennis	ﻑیﻥیﺱ
fenske	ﻑﻥﺱکی
fentiman	ﻑﻥﺕیﻡﺍﻥ
fenton	ﻑﻥﺕﻭﻥ
fenwick	ﻑﻥﻭیک
fenyes	ﻑﻥیﺱ
fera	ﻑﺭﺍ
ferdig	ﻑﺭﺩیگ
ferdinand	ﻑﺭﺩﺍیﻥﻥﺩ
ferguson	ﻑﺭگﻭﺱﻥ
fernandes	ﻑﺭﻥﺍﻥﺩﺱ
fernandez	ﻑﺭﻥﺍﻥﺩﺯ
fernando	ﻑﺭﻥﺍﻥﺩﻭ
ferran	ﻑﺭﺍﻥ
ferrari	ﻑﺭﺍﺭی
ferree	ﻑﺭی
ferrier	ﻑﺭیﺭ
ferrington	ﻑﺭیﻥگﺕﻭﻥ
ferris	ﻑﺭیﺱ
fertik	ﻑﺭﺕیک
fetch	ﻑﺕچ
fetchen	ﻑﺕچﻥ
fetra	ﻑﺕﺭﺍ
fetter	ﻑﺕﺭ
feustel	ﻑیﻭﺱﺕﻝ
fiabane	ﻑیﺍﺏﺍﻥ
fiasconaro	ﻑیﺍﺱکﻭﻥﺍﺭﻭ
fick	ﻑیک
fidalgo	ﻑیﺩﺍﻝگﻭ
fidel	ﻑیﺩﻝ
fidler	ﻑیﺩﻝﺭ
fielek	ﻑیﻝک
fife	ﻑﺍیﻑ
figard	ﻑیگﺍﺭﺩ
figura	ﻑیگﻭﺭﺍ
fike	ﻑﺍیک
filias	ﻑیﻝیﺍﺱ
fils	ﻑﺍیﻝﺱ
fin	ﻑیﻥ
finan	ﻑیﻥﺍﻥ
finch	ﻑیﻥچ
finelli	ﻑیﻥﻝی
finerty	ﻑﺍیﻥﺭﺕی
finestone	ﻑﺍیﻥﺱﺕﻭﻥ
fink	ﻑیﻥک
finke	ﻑﺍیﻥک
finkle	ﻑیﻥکﻝ
finlay	ﻑیﻥﻝی
finley	ﻑیﻥﻝی
finn	ﻑیﻥ
finnin	ﻑیﻥیﻥ
finstad	ﻑیﻥﺱﺕﺍﺩ
finton	ﻑﺍیﻥﺕﻭﻥ
fiore	ﻑیﻭﺭ
firma	ﻑیﺭﻡﺍ
fish	ﻑیﺵ
fishbein	ﻑیﺵﺏیﻥ
fisher	ﻑیﺵﺭ
fisk	ﻑیﺱک
fitch	ﻑیﺕچ
fitta	ﻑیﺕﺍ
fitzgerald	ﻑیﺕﺯﺝﺭﺍﻝﺩ
fitzwell	ﻑیﺕﺯﻭﻝ
fix	ﻑیکﺱ
flaglelee	ﻑﻝﺍگﻝﻝی
flaherty	ﻑﻝﺍﻩﺭﺕی
flame	ﻑﻝیﻡ
flardinga	ﻑﻝﺍﺭﺩیﻥگﺍ
flat	ﻑﻝﺍﺕ
fleck	ﻑﻝک
fleming	ﻑﻝیﻡیﻥگ
flemmer	ﻑﻝﻡﺭ
flesti	ﻑﻝﺱﺕی
fletje	ﻑﻝیﺝﻩ
fleury	ﻑﻝیﻭﺭی
flickinger	ﻑﻝیکیﻥگﺭ
flinders	ﻑﻝیﻥﺩﺭﺯ
flint	ﻑﻝیﻥﺕ
flodin	ﻑﻝﻭﺩیﻥ
flor	ﻑﻝﻭﺭ
flora	ﻑﻝﻭﺭﺍ
florek	ﻑﻝﻭﺭک
florence	ﻑﻝﻭﺭﻥﺱ
flores	ﻑﻝﻭﺭﺯ
florian	ﻑﻝﻭﺭیﻥ
flowers	ﻑﻝﻭﻭﺭﺯ
floyd	ﻑﻝﻭیﺩ
fluche	ﻑﻝﻭچﻩ
fluckiger	ﻑﻝﺍکیگﺭ
flute	ﻑﻝﻭﺕ
fluur	ﻑﻝﻭﺭ
fly	ﻑﻝﺍی
flygare	ﻑﻝﺍیگیﺭ
fodor	ﻑﺍﺩﻭﺭ
foley	ﻑﺍﻝی
folkins	ﻑﻝکیﻥﺯ
folliot	ﻑﺍﻝیﻭﺕ
folsom	ﻑﺍﻝﺱﺍﻡ
foltak	ﻑﺍﻝﺕﺍک
fondo	ﻑﻭﻥﺩﻭ
fongen	ﻑﻭﻥگﻥ
foniok	ﻑﻭﻥیﻭک
fontenot	ﻑﻭﻥﺕﻥﻭﺕ
fontes	ﻑﺍﻥﺕﺱ
foot	ﻑﻭﺕ
forbes	ﻑﻭﺭﺏﺯ
force	ﻑﻭﺭﺱ
forde	ﻑﻭﺭﺩ
fordham	ﻑﻭﺭﺩﻩﺍﻡ
forero	ﻑﻭﺭﺭﻭ
forget	ﻑﺭگﺕ
forgy	ﻑﻭﺭﺝی
fork	ﻑﻭﺭک
forman	ﻑﻭﺭﻡﻥ
forrer	ﻑﻭﺭﺭ
forrest	ﻑﺍﺭﺱﺕ
forsale	ﻑﻭﺭﺱیﻝ
forsberg	ﻑﺍﺭﺱﺏﺭگ
forsblom	ﻑﻭﺭﺱﺏﻝﺍﻡ
forsyth	ﻑﻭﺭﺱﺍیﺕ
forsythe	ﻑﻭﺭﺱﺍیﺕ
forte	ﻑﻭﺭﺕ
forts	ﻑﻭﺭﺕﺱ
fosdal	ﻑﺱﺩﺍﻝ
foss	ﻑﺍﺱ
fossberg	ﻑﺍﺱﺏﺭگ
fosseng	ﻑﻭﺱﻥگ
fotinos	ﻑﻭﺕیﻥﻭﺱ
fotis	ﻑﺍﺕیﺱ
foulds	ﻑﻭﻝﺩﺯ
foulk	ﻑﻭﻝک
fourney	ﻑﻭﺭﻥی
fournie	ﻑﻭﺭﻥی
fournier	ﻑﻭﺭﻥیﺭ
foust	ﻑﺍﻭﺱﺕ
fouts	ﻑﻭﺕﺱ
fowler	ﻑﻭﻝﺭ
fowlkes	ﻑﻭﻝکﺱ
fownes	ﻑﺍﻭﻥﺱ
fox	ﻑﺍکﺱ
fozzard	ﻑﻭﺯﺍﺭﺩ
fradkin	ﻑﺭﺩکیﻥ
fraenkel	ﻑﺭﺍﻥکﻝ
fragen	ﻑﺭﺝﻥ
frageorgia	ﻑﺭﺍگﻭﺭگیﺍ
frahm	ﻑﺭﺍﻡ
framson	ﻑﺭﺍﻡﺱﻭﻥ
france	ﻑﺭﺍﻥﺱ
francisca	ﻑﺭﺍﻥﺱیﺱکﺍ
franck	ﻑﺭﻥک
francke	ﻑﺭﻥکﻩ
franco	ﻑﺭﺍﻥکﻭ
francois	ﻑﺭﻥﺱﻭیﺱ
francoys	ﻑﺭﺍﻥکﻭی
francyntie	ﻑﺭﺍﻥﺱیﻥﺕی
frandsen	ﻑﺭﺍﻥﺩﺱﻥ
frangakis	ﻑﺭﺍﻥگﺍکیﺱ
franke	ﻑﺭﻥک
frankel	ﻑﺭﺍﻥکﻝ
franklin	ﻑﺭﺍﻥکﻝیﻥ
franko	ﻑﺭﺍﻥکﻭ
frankson	ﻑﺭﻥکﺱﻭﻥ
franscyntje	ﻑﺭﺍﻥﺱیﻥﺕژ
franser	ﻑﺭﺍﻥﺱﺭ
fransiska	ﻑﺭﺍﻥﺱیکﺍ
frantisek	ﻑﺭﺍﻥﺕیﺱک
frantzen	ﻑﺭﺍﻥﺕﺯﻥ
fraser	ﻑﺭیﺯﺭ
frazer	ﻑﺭیﺯﺭ
frazier	ﻑﺭﺍﺯییﺭ
fred	ﻑﺭﺩ
fredda	ﻑﺭﺩﺍ
freddie	ﻑﺭﺩی
freddy	ﻑﺭﺩی
frederick	ﻑﺭﺩﺭیک
frederico	ﻑﺭﺩﺭیکﻭ
frederik	ﻑﺭﺩﺭیک
frederking	ﻑﺭﺩﺭکیﻥگ
fredette	ﻑﺭﺩﺕ
fredrick	ﻑﺭیﺩﺭیک
fredrik	ﻑﺭﺩﺭیک
free	ﻑﺭی
freeburg	ﻑﺭیﺏﺭگ
freedman	ﻑﺭیﺩﻡﻥ
freeland	ﻑﺭیﻝﻥﺩ
freels	ﻑﺭیﻝﺯ
freemal	ﻑﺭیﻡﺍﻝ
freer	ﻑﺭیﺭ
freese	ﻑﺭیﺯ
freeto	ﻑﺭیﺕﻭ
freidin	ﻑﺭیﺩیﻥ
freiling	ﻑﺭیﻝیﻥگ
freilinger	ﻑﺭیﻝیﻥگﺭ
freimuth	ﻑﺭیﻡﻭﺕ
freitag	ﻑﺭیﺕﺍگ
freitas	ﻑﺭیﺕﺍﺱ
freivogel	ﻑﺭیﻭﻭگﻝ
freiwald	ﻑﺭیﻭﺍﻝﺩ
french	ﻑﺭﻥچ
frenkel	ﻑﺭﻥکﻝ
frenzel	ﻑﺭﻥﺯﻝ
fretwell	ﻑﺭیﺕﻭﻝ
freyermuth	ﻑﺭیﺭﻡﺍﺕ
friday	ﻑﺭﺍیﺩی
fridgeir	ﻑﺭیﺩگیﺭ
frieda	ﻑﺭیﺩﺍ
friedberger	ﻑﺭیﺩﺏﺭگﺭ
friedl	ﻑﺭیﺩﻝ
friedman	ﻑﺭیﺩﻡﻥ
friedmar	ﻑﺭیﺩﻡﺍﺭ
fries	ﻑﺭیﺱ
friess	ﻑﺭیﺱ
frink	ﻑﺭیﻥک
fritgersa	ﻑﺭیﺕگﺭﺱﺍ
frith	ﻑﺭیﺕ
frits	ﻑﺭیﺕﺱ
fritton	ﻑﺭیﺕﻥ
fritzius	ﻑﺭیﺕﺯیﻭﺱ
frix	ﻑﺭیکﺱ
frnaciscus	ﻑﺭﺍﻥﺱیﺱکﺍﺱ
frome	ﻑﺭﻡ
fromhein	ﻑﺭﻭﻡیﻥ
fromson	ﻑﺭﺍﻡﺱﺍﻥ
frost	ﻑﺭﺍﺱﺕ
frosti	ﻑﺭﺍﺱﺕی
fry	ﻑﺭﺍی
fubler	ﻑﺍﺏﻝﺭ
fuchs	ﻑﺍچﺱ
fude	ﻑﻭﺩ
fudenberg	ﻑﺍﺩﻥﺏﺭگ
fuess	ﻑﻭیﺱ
fuetterer	ﻑﻭﺕﺭﺭ
fuhrmann	ﻑﻭﺭﻡﻥ
fui	ﻑﻭی
fuji	ﻑﻭﺝی
fujioka	ﻑﻭﺝیﻭکﺍ
fujita	ﻑﻭﺝیﺕﺍ
fujiwara	ﻑﺍﺝیﻭﺍﺭ
fulconis	ﻑﻭﻝکﺍﻥیﺱ
fulghum	ﻑﻭﻝگﺍﻡ
fulkerson	ﻑﺍﻝکﺭﺱﻭﻥ
fullen	ﻑﺍﻝﻥ
fuller	ﻑﻭﻝﺭ
fullman	ﻑﻭﻝﻡﻥ
fuloria	ﻑﻝﻭﺭی
fulton	ﻑﺍﻝﺕﻭﻥ
fumerton	ﻑﻭﻡﺭﺕﻭﻥ
fundal	ﻑﻭﻥﺩﺍﻝ
fungus	ﻑﺍﻥگﻭﺱ
funky	ﻑﻭﻥکی
furat	ﻑﺍﺭﺍﺕ
furdesanden	ﻑﻭﺭﺩﺱﺍﻥﺩﻥ
furey	ﻑﺍﺭی
furlong	ﻑﺭﻝﺍﻥگ
furness	ﻑﺭﻥﺱ
furrows	ﻑﺭﻭﺯ
furtek	ﻑﺍﺭﺕک
fuzzy	ﻑﺍﺯی
gaal	گﺍﻝ
gaba	گﺍﺏﺍ
gabara	گﺍﺏﺍﺭﺍ
gabi	گﺏی
gabler	گﺍﺏﻝﺭ
gabor	گیﺏﻭﺭ
gabriele	گﺍﺏﺭیﻝﻩ
gabrielle	گﺍﺏﺭیﻝﻩ
gabrielsson	گﺍﺏﺭییﻝﺱﻭﻥ
gadbois	گﺍﺩﺏﻭیﺱ
gadbury	گﺍﺩﺏﺭی
gades	گیﺩﺯ
gadi	گﺍﺩی
gadil	گﺍﺩیﻝ
gael	گﺍﻝ
gaeris	گﺍﺭیﺱ
gaetan	گیﺕﻥ
gaetz	گﺍییﺕﺯ
gaffin	گﺍﻑیﻥ
gaffney	گﺍﻑﻥی
gagne	گﺍگﻥﻩ
gaherty	گﺍﻩﺭﺕی
gail	گیﻝ
gaillot	گیﻝﻭﺕ
gainor	گﺍیﻥﻭﺭ
gair	گیﺭ
gaitonde	گیﺕﻭﻥﺩ
galahad	گﺍﻝﺍﻩﺍﺩ
galbavy	گﺍﻝﺏﺍﻭﺍی
gale	گیﻝ
galea	گﺍﻝﺍ
galen	گﺍﻝﻥ
gali	گﺍﻝی
galibert	گﺍﻝیﺏﺭﺕ
galila	گﺍﻝیﻝﺍ
galileo	گﺍﻝیﻝﻩ
galizia	گﺍﻝیﺯیﺍ
galko	گﺍﻝکﻭ
gallagher	گﺍﻝﺍگﺭ
gallant	گﺍﻝﺍﻥﺕ
gallatin	گﺍﻝﺍﺕیﻥ
gallaty	گﺍﻝیﺕی
galley	گﺍﻝی
galli	گﺍﻝی
gallion	گﺍﻝیﻭﻥ
gallop	گﺍﻝپ
galloway	گﺍﻝﺍﻭی
gallula	گﺍﻝﻭﻝﺍ
gallun	گﺍﻝﺍﻥ
galmiche	گﺍﻡیﺵﻩ
galo	گﺍﻝﻭ
galpin	گﺍﻝپیﻥ
gamache	گﺍﻡﺍک
gamage	گﺍﻡیﺝ
gamal	کﻡﺍﻝ
gambino	گﺍﻡﺏیﻥﻭ
gamble	گﻡﺏﻝ
gamero	گﺍﻡﺭﻭ
gammel	گﺍﻡﻝ
gammon	گﺍﻡﻭﻥ
gan	گﺍﻥ
ganapathy	گﺍﻥﺍپﺍﺕی
ganatra	گﺍﻥﺍﺕﺭﺍ
gandy	گﺍﻥﺩی
ganesan	گﺍﻥیﺱﺍﻥ
gang	گﺍﻥگ
gangolli	گﺍﻥگﻭﻝی
gannon	گﺍﻥﻭﻥ
gans	گﺍﻥﺱ
ganter	گﺍﻥﺕﺭ
gantert	گﺍﻥﺕﺭﺕ
ganti	گﺍﻥﺕی
ganzak	گﺍﻥﺯﺍک
gao	گﺍﻭ
gapen	گیپﻥ
garance	گﺍﺭﺍﻥﺱ
garbe	گﺍﺭﺏﻩ
garbee	گﺍﺭﺏی
garces	گﺍﺭﺱﺱ
garcia	گﺍﺭﺱیﺍ
gardner	گﺭﺩﻥﺭ
gareth	گﺭﺕ
garfield	گﺍﺭﻑیﻝﺩ
garfinkel	گﺍﺭﻑیﻥکﻝ
garg	گﺭگ
garito	گﺍﺭیﺕﻭ
garlick	گﺭﻝیک
garms	گﺍﺭﻡﺯ
garner	گﺍﺭﻥﺭ
garnett	گﺍﺭﻥﺕ
garofalo	گﺍﺭﺍﻑﺍﻝﻭ
garon	گﺍﺭﻥ
garrett	گﺍﺭﺕ
garrick	گﺍﺭیک
garrod	گﺍﺭﻭﺩ
garruto	گﺍﺭﻭﺕﻭ
garshol	گﺍﺭﺵﻭﻝ
gartin	گﺍﺭﺕیﻥ
gartmann	گﺍﺭﺕﻡﻥ
gascoyne	گﺍﺱکﻭییﻥ
gashler	گﺍﺵﻝﺭ
gasic	گﺍﺱیک
gaskin	گﺍﺱکیﻥ
gaskins	گﺍﺱکیﻥﺯ
gaspar	گﺍﺱپﺍﺭ
gasper	گﺍﺱپﺭ
gass	گﺱ
gastineau	گﺍﺱﺕیﻥیﻭ
gastli	گﺱﺕﻝ
gat	گﺍﺕ
gatcombe	گﺍﺕکﻭﻡﺏ
gate	گیﺕ
gateley	گﺍﺕﻝی
gates	گیﺕﺱ
gatlin	گﺍﺕﻝیﻥ
gatta	گﺍﺕﺍ
gattis	گﺍﺕیﺯ
gatz	گﺍﺕﺯ
gaudrault	گﺩﺭﺍﻝﺕ
gaudreau	گﺍﺩﺭﻭ
gaut	گﺍﺕ
gauthier	گﺍﻭﺕیﺭ
gavazzeni	گﺍﻭﺍﺯﻥی
gavin	گیﻭیﻥ
gawne	گﺍیﻭﻥ
gaya	گﺍیﺍ
gayda	گﺍیﺩﺍ
gayler	گیﻝﺭ
gayman	گﺍیﻡﻥ
gaynell	گﺍیﻥﻝ
gaynor	گﺍیﻥﻭﺭ
gearhart	گیﺭﻩﺍﺭﺕ
geddis	گﺩیﺱ
gedeck	گﺩک
gee	گی
geertruyd	گﺭﺕﺭﻭیﺩ
geertsen	گیﺭﺕﺱﻥ
geervliet	گﺭیﻭﻝیﺕ
geier	گیﺭ
geiger	گیگﺭ
geiser	ﺝیﺱﺭ
geitgey	گیﺕگی
geldefsman	گﻝﺩﺯﻡﻥ
geleta	گیﻝیﺕﺍ
gell	ﺝﻝ
gellrich	گﻝﺭیک
gelter	گﻝﺕﺭ
gemmell	گیﻡﻝ
gems	ﺝیﻡﺯ
gendreau	ﺝﻥﺩﺭیﺍﻭ
gendrich	ﺝﻥﺩﺭیچ
genks	گیﻥکﺯ
gentges	ﺝﻥﺕﺝﺱ
gentry	ﺝﻥﺕﺭی
geocaris	گﻭیکﺍﺭیﺱ
geoff	گیﻭﻑ
geoffl	ﺝﻭﻑﻝ
georgeu	ﺝﻭﺭﺝیﻭ
georgia	ﺝﻭﺭﺝیﺍ
gepje	چپژ
geraghty	گﺭﺍگﺕی
gerald	ﺝﺭﺍﻝﺩ
gerard	ﺝﺭﺍﺭﺩ
gerardi	ﺝﺭﺍﺭﺩی
gerardin	گﺭﺍﺭﺩیﻥ
gerbes	گﺭﺏﺱ
gerhard	گﺭﻩﺍﺭﺩ
gerhardt	گﺭﻩﺍﺭﺕ
gerhart	گﺭﻩﺍﺭﺕ
germack	گﺭﻡﺍک
germuska	ﺝیﺭﻡﺍﺱکﺍ
gerringe	گﺭیﻥگ
gerritse	گﺭیﺕﺱ
gerrity	ﺝﺭیﺕی
gerritzon	گﺭیﺯﻭﻥ
gersappe	گﺭﺱﺍپﻩ
gersdorf	گﺭﺱﺩﻭﺭﻑ
gerstel	گﺭﺱﺕﻝ
gerstl	ﺝﺭﺱﺕﻝ
gerth	گﺭﺕ
gertrude	گﺭﺕﺭﻭﺩ
geston	ﺝﺱﺕﻭﻥ
gettys	گﺕیﺱ
ghalib	گﻝیﺏ
ghaliya	ﻕﺍﻝیﺍ
gharbiyah	ﻍﺭیﺏیﻩ
ghassan	گﺱﺍﻥ
ghayth	گیﺕ
ghufran	گﺍﻑﺭﺍﻥ
giacobe	ﺝیﺍکﻭﺏ
giancola	گییﺍﻥکﻭﻝﺍ
giannasi	گیﺍﻥﺍﺱی
gianni	ﺝیﺍﻥی
gibbins	ﺝیﺏیﻥﺱ
gibboni	گیﺏﻭﻥی
gibbons	گیﺏﻭﻥﺯ
gibson	گیﺏﺱﻥ
gideon	گیﺩﻭﻥ
gidewall	گﺍیﺩﻭﺍﻝ
giegel	گﺍیگﻝ
gift	گیﻑﺕ
gijsbertus	گیﺝﺱﺏﺭﺕﺍﺱ
gil	گیﻝ
gilbert	گیﻝﺏﺭﺕ
gilby	گیﻝﺏﺍی
gill	گیﻝ
gillam	گیﻝﺍﻡ
gillen	گیﻝﻥ
gillespie	گیﻝﺱپی
gillett	ژیﻝﺕ
gilley	گیﻝی
gilliam	گیﻝیﺍﻡ
gillie	گیﻝی
gillies	گیﻝیﺯ
gillis	گیﻝیﺯ
gillogly	گیﻝﺍگﻝی
gilman	گیﻝﻡﻥ
gilmer	گیﻝﻡﺭ
gilner	گیﻝﻥﺭ
gilpin	گیﻝپیﻥ
gilroy	گیﻝﺭﻭی
gimenez	گیﻡﻥﺯ
gimeno	گیﻡﻥﻭ
ginsburg	گیﻥﺱﺏﺭگ
ginton	گیﻥﺕﻥ
giordani	ﺝیﺍﻭﺭﺩﺍﻥی
giordano	ﺝیﻭﺭﺩﺍﻥﻭ
giovanni	گیﻭﻭﺍﻥی
girard	گیﺭﺍﺭﺩ
girl	گﺭﻝ
gische	گیﺵﻩ
gitlin	گیﺕﻝیﻥ
gitnick	گیﺕﻥیک
gitomer	گیﺕﻭﻡﺭ
gittelman	گیﺕﻝﻡﻥ
giuliani	ﺝﻭﻝیﺍﻥی
giulietti	گیﻭﻝیﺕی
givon	گیﻭﻥ
gizaw	گیﺯﺍﻭ
glacier	گﻝﺍﺱییﺭ
glaciers	گﻝﺱیﺭﺯ
glandorf	گﻝﻥﺩﻭﺭﻑ
glass	گﻝﺍﺱ
glassco	گﻝﺍﺱکﻭ
glatz	گﻝﺍﺕﺯ
gleason	گﻝیﺱﻭﻥ
gleaves	گﻝیﻭﺱ
gleich	گﻝیچ
gleichman	گﻝیچﻡﻥ
gleick	گﻝیک
gleizer	گﻝیﺯﺭ
glenn	گﻝﻥ
glenns	گﻝیﻥﺯ
glicksman	گﻝیکﺱﻡﻥ
gloege	گﻝﻭﺝ
gloria	گﻝﻭﺭیﺍ
gloyer	گﻝﺍیﺭ
glynn	گﻝیﻥ
gnagy	گﻥﺍگی
gnishilda	گیﺵیﻝﺩﺍ
gnosis	گﻥﻭﺱیﺱ
gobble	گﺍﺏﺏﻝ
goble	گﻭﺏﻝ
goch	گﻭﺵ
godau	گﻭﺩﺍ
godbout	گﺍﺩﺏﺕ
goddard	گﺩﺍﺭﺩ
goddijn	گﺍﺩیﺝﻥ
godel	گﻭﺩﻝ
goderre	گﺩﺭ
godewyn	گﺍﺩﻭیﻥ
godfrey	گﺍﺩﻑﺭی
godfroid	گﺍﺩﻑﺭﻭیﺩ
godman	گﺍﺩﻡﻥ
godson	گﺍﺩﺱﻥ
goegan	گﻭگﺍﻥ
goel	گﻭیﻝ
goering	ﺝﻭﺭیﻥگ
goerwitz	ﺝﻭﺭﻭیﺕﺯ
goff	گﺍﻑ
goguen	گﻭگﻭﺍﻥ
goh	گﻭﻩ
gohde	گﻭﻩﺩ
goheen	گﻭﻩیﻥ
goland	گﻭﻝﺍﻥﺩ
gold	گﻝﺩ
goldberg	گﻝﺩﺏﺭگ
goldberger	گﻝﺩﺏﺭگﺭ
golder	گﻝﺩﺭ
goldfoot	گﻝﺩﻑﻭﺕ
golding	گﻝﺩیﻥگ
goldkamp	گﻝﺩکﻡپ
goldman	گﻝﺩﻡﻥ
goldsteen	گﻝﺩﺍﺱﺕییﻥ
goldsworthy	گﻝﺩﺯﻭﺭثی
gollan	گﻭﻝﺍﻥ
golomb	گﻭﻝﻭﻡﺏ
golub	گﻝﻭﺏ
gomes	گﻭﻡﺯ
gomez	گﻭﻡﺯ
gonderzik	گﺍﻥﺩﺭﺯیک
gonna	گﻭﻥﻥﺍ
gonot	گﻭﻥﻭﺕ
gonville	گﺍﻥﻭیﻝ
gony	گﻭﻥی
gonyer	گﺍﻥیﺭ
gonzales	گﻥﺯﺍﻝﺯ
gonzalez	گﺍﻥﺯﺍﻝﺯ
gonzalo	گﻭﻥﺯﺍﻝﻭ
good	گﻭﺩ
goodall	گﻭﺩﺍﻝ
goodenough	گﻭﺩﺍیﻥﺍﻑ
goodger	گﺍﺝﺭ
goodhew	گﻭﺩﻩﻭ
gooding	گﻭﻭﺩیﻥگ
goodman	گﻭﺩﻡﺍﻥ
goodrich	گﻭﺩﺭیچ
goodrum	گﻭﺩﺭﺍﻡ
goodsen	گﻭﺩﺱﻥ
goodwin	گﻭﺩﻭیﻥ
gooijer	گﻭییﺝﺭ
goolsbee	گﻭﻝﺱﺏی
goor	گﻭﺭ
gooshy	گﻭﺵی
gootee	گﻭﺕی
gootjes	گﻭﺕﺝﺱ
gopala	گﻭپﺍﻝﺍ
gopalan	گﻭپﺍﻝﺍﻥ
gopinath	گﻭپیﻥﺍﺕ
gopisetty	گﺍپیﺱﺕی
goralwalla	گﻭﺭﺍﻝﺍﻭﺍﻝﺍ
goran	گﻭﺭﺍﻥ
gorav	گﻭﺭﺍﻭ
gorberg	گﻭﺭﺏﺭگ
gordan	گﺭﺩﺍﻥ
gorde	گﻭﺭﺩ
gorden	گﺭﺩﻥ
gordin	گﻭﺭﺩیﻥ
gore	گﻭﺭ
gorel	گﻭﺭﻝ
gorgon	گﻭﺭگﺍﻥ
gorgons	گﻭﺭگﺍﻥﺯ
gorik	گﻭﺭیک
gorinchem	گﺭﻭیﻥچﻡ
goringe	گﻭﺭیﻥگ
goris	گﻭﺭیﺱ
gorki	گﻭﺭکی
gorm	گﺭﻡ
gornall	گﻭﺭﻥﺍﻝ
gorospe	گﻭﺭﺍﺱپی
gorry	گﻭﺭی
gorton	گﻭﺭﺕﻭﻥ
gorwitz	گﻭﺭﻭیﺕﺯ
gosewitz	گﻭﺯﻭیﺕﺯ
gosling	گﺍﺱﻝیﻥگ
gossard	گﺍﺱﺍﺭﺩ
gossink	گﺍﺱیﻥک
gossler	گﺍﺱﻝﺭ
gosta	گﺍﺱﺕﺍ
gostelow	کﺍﺱﺕﻝﻭ
gostin	گﺍﺱﺕیﻥ
goswell	کﺍﺱﺕﻭﻝ
gothic	گﻭﺕیک
gotseff	گﺍﺕﺱﻑ
gotthard	گﺍﺕﻩﺍﺭﺩ
gottlieb	گﺍﺕﻝیﺏ
gotts	گﺍﺕﺱ
goucher	گﺍچﺭ
gouda	گﻭیﻭﺩﺍ
goudal	گﻭﺩﺍ
goudier	گﻭﺩیﺭ
goudreau	گﻭﺩﺭﻭ
goudswaard	گﺍﺩﺱﻭﺍﺭﺩ
gough	گﺍﻑ
goulden	گﺍﻝﺩﻥ
goulding	گﻭﻝﺩیﻥگ
gourdon	گﻭﺭﺩﻥ
gourlay	گﻭﺭﻝی
gourmet	گﻭﺭﻡﺕ
gouvousis	گﻭﻭﻭﺱیﺱ
goverd	گﺍﻭﺭﺩ
govil	گﻭیﻝ
govind	گﺍﻭیﻥﺩ
govindan	گﺍﻭیﻥﺩﺍﻥ
govinder	گﻭﻭیﻥﺩﺭ
gowan	گﻭﺍﻥ
goward	گﻭﺍﺭﺩ
gowell	گﻭیﻝ
gower	گﺍﻭﺭ
gowlett	گﻭﻝﺕ
gozzi	ﺝﻭﺯی
graae	گﺭﺍیی
graben	گﺭﺍﺏﻥ
grabiner	گﺭﺍﺏیﻥﺭ
grabnar	گﺭﺍﺏﻥﺍﺭ
grace	گﺭیﺱ
grad	گﺭﺍﺩ
graduation	گﺭﺝﻭﺍیﺵﻥ
grady	گﺭﺩی
graf	گﺭﺍﻑ
graft	گﺭﺍﻑﺕ
grah	گﺭﺍﻩ
graham	گﺭﺍﻩﺍﻡ
grahame	گﺭﺍﻩﺍﻡ
grahorna	گﺭﺍﻩﺭﻥﺍ
graifer	گﺭیﻑﺭ
grainger	گﺭیﻥگﺭ
gralian	گﺭﺍﻝیﻥ
gramsas	گﺭﺍﻡﺱﺱ
gran	گﺭﻥ
grand	گﺭﻥﺩ
grande	گﺭﺍﻥﺩ
grandidier	گﺭﻥﺩیﺩیﺭ
grandmaster	گﺭﻥﺩﻡﺱﺕﺭ
granger	گﺭﻥگﺭ
granicher	گﺭﻥیچﺭ
granite	گﺭﺍﻥیﺕ
granli	گﺭﻥﻝی
grant	گﺭﺍﻥﺕ
grantham	گﺭﺍﻥﺕﺍﻡ
granvin	گﺭﺍﻥﻭیﻥ
granzeau	گﺭﺍﻥﺯیﻭ
graphite	گﺭﻑیﺕ
graser	گﺭیﺱﺭ
grass	گﺭﺱ
grasteinen	گﺭﺱﺕیﻥﻥ
grasty	گﺭﺱﺕی
grater	گﺭﺍﺕﺭ
grau	گﺭﺍﻭ
graw	گﺭﺍﻭ
gray	گﺭی
greanias	گﺭیﻥیﺍﺱ
greco	گﺭکﻭ
green	گﺭییﻥ
greenberg	گﺭیﻥﺏﺭگ
greenidge	گﺭیﻥیﺝ
greenop	گﺭیﻥﻭپ
greenough	گﺭیﻥﻭ
greenwald	گﺭییﻥﻭﺍﻝﺩ
greenwood	گﺭیﻥﻭﻭﺩ
greer	گﺭیﺭ
greewnood	گﺭیﻭﻥﻭﺩ
greg	گﺭگ
gregg	گﺭگ
gregoire	گﺭگﻭﺭ
gregor	گﺭگﻭﺭ
greifer	گﺭیﻑﺭ
greiff	گﺭیﻑ
greig	گﺭیگ
gremban	گﺭﻡﺏﺍﻥ
grenander	گﺭﻥﺍﻥﺩﺭ
grensing	گﺭﻥﺱیﻥگ
grenville	گﺭﻥﻭیﻝ
gretchen	گﺭﺕچﻥ
gretta	گﺭﺕﺍ
greuel	گﺭیﻭﻝ
greyson	گﺭیﺱﻭﻥ
gribble	گﺭیﺏﻝ
griefer	گﺭیﻑﺭ
grieger	گﺭیگﺭ
griepenkerl	گﺭیپﻥکﺭﻝ
grieve	گﺭﺍییﻭ
griff	گﺭیﻑ
griffis	گﺭیﻑیﺱ
griffiths	گﺭیﻑیﺕﺯ
griffy	گﺭیﻑی
grilk	گﺭیﻝک
grillenbeck	گﺭیﻝﻥﺏک
grimme	گﺭﺍیﻡ
grindley	گﺭیﻥﺩﻝی
grinham	گﺭیﻥﻩﺍﻡ
grinsven	گﺭیﻥﺱﻭﻥ
griseldis	گﺭیﺱﻝﺩیﺱ
grishilde	گﺭیﺵیﻝﺩ
grismore	گﺭیﺱﻡﻭﺭ
grist	گﺭیﺱﺕ
griswald	گﺭیﺱﻭﺍﻝﺩ
griswold	گﺭیﺱﻭﻝﺩ
grit	گﺭیﺕ
gritz	گﺭیﺕﺯ
grivas	گﺭﺍیﻭﺍﺱ
grizzly	گﺭیﺯﻝی
groat	گﺭﻭﺕ
groce	گﺭﻭﺱ
groebe	گﺭﻭﺏی
groenink	گﺭﻭﻥیﻥک
groenland	گﺭﻭیﻥﻝﻥﺩ
groenveld	گﺭﻭیﻥﻭﻝﺩ
grog	گﺭﺍگ
grohol	گﺭﻭﻩﻭﻝ
groner	گﺭﻭﻥﺭ
groom	گﺭﻭﻡ
groovy	گﺭﻭﻭی
grosek	گﺭﻭﺱک
grosse	گﺭﻭﺱی
grosser	گﺭﺍﺱﺭ
grossjohann	گﺭﻭﺱﺝﻭﻩﺍﻥ
grothause	گﺭﻭﺕﻩﺍﻭﺱ
grout	گﺭﻭﺕ
grov	گﺭﺍﻭ
grove	گﺭﺍﻭ
grover	گﺭﻭﻭﺭ
grubb	گﺭﺍﺏ
gruen	گﺭﻭیﻥ
gruhn	گﺭﺍﻥ
grunberger	گﺭﺍﻥﺏﺭگﺭ
grundstroem	گﺭﺍﻥﺩﺍﺱﺕﺭﻭﻡ
grunewald	گﺭﻭﻥﻭﺍﻝﺩ
gruskin	گﺭﺍﺱکیﻥ
guan	گﻭﺍﻥ
guang	گﻭﺍﻥگ
guanyao	گﻭﺍﻥیﺍﻭ
gubbin	گﺍﺏیﻥ
gudat	گﻭﺩﺍﺕ
gudata	گﻭﺩﺍﺕﺍ
gudgel	گﺍﺩگﻝ
gudrun	گﻭﺩﺭﺍﻥ
guest	گﺱﺕ
guethlein	ﺝﻭﺕﻝیﻥ
gui	گﻭی
guido	گیﺩﻭ
guidry	گیﺩﺭی
guilford	گیﻝﻑﺭﺩ
guillaume	گیﻝﺍﻡ
guillerm	گیﻝﺭﻡ
guillermo	گیﻝﺭﻡﻭ
guillon	گﺍیﻝﻭﻥ
guillory	گیﻝﺭی
guimond	گﺍیﻡﻭﻥﺩ
guitard	گیﺕﺍﺭﺩ
gul	گﻝ
gulch	گﺍﻝچ
gulf	گﻝﻑ
gull	گﺍﻝ
gulledge	گﺍﻝﺝ
gullett	گﺍﻝﺕ
gully	گﺍﻝی
gulovsen	گﺍﻝﻭﺱﻥ
gummerus	گﺍﻡﺭﻭﺱ
gunawan	گﺍﻥﺍﻭﺍﻥ
gunderson	گﺍﻥﺩﺭﺱﻭﻥ
gundlach	گﺍﻥﺩﻝچ
gung	گﺍﻥگ
gunnar	گﺍﻥﺍﺭ
gunnel	گﺍﻥﻝ
gunnerus	گﺍﻥﺭﻭﺱ
gunson	گﺍﻥﺱﻭﻥ
gunter	گﺍﻥﺕﺭ
gunther	گﺍﻥﺕﺭ
gunthorpe	گﺍﻥﺕﺭپ
guntram	گﺍﻥﺕﺭﺍﻡ
guochun	گﻭچﺍﻥ
guoqiano	گﻭکیﺍﻥﻭ
gupta	گﺍپﺕﺍ
gupte	گﻭپﺕﻩ
gupwell	گﻭپﻭﻝ
gural	گﻭﺭﺍﻝ
guralp	گﻭﺭﺍﻝپ
gurdev	گﻭﺭﺩﻑ
gurinder	گﻭﺭیﻥﺩﺭ
gurley	گﺭﻝی
gurney	گﺭﻥی
gurrola	گﺍﺭﻭﻝﺍ
gursky	گﺍﺭﺱکی
guru	گﻭﺭﻭ
gurudevan	گﺍﺭﺍﺩﻭﺍﻥ
gurupartap	گﻭﺭﺍپﺍﺭﺕﺍپ
gurusamy	گﻭﺭﻭﺱﺍﻡی
gus	گﺍﺱ
guscott	گﺍﺱکﺍﺕ
guse	گیﻭﺯ
gusev	گﻭﺱﻑ
guslick	گﺍﺱﻝیک
gussie	گﺍﺱی
gustav	گﻭﺱﺕﺍﻭ
gustavus	گﺍﺱﺕﺍﻭﺱ
gustin	ﺝﺍﺱﺕیﻥ
gutman	گﺍﺕﻡﻥ
gutmann	گﺍﺕﻡﻥ
gutteridge	گﺍﺭﺕﺭیﺝ
gutwein	گﺍﺕﻭیﻥ
gutzwiller	گﺍﺕﺯﻭیﻝﺭ
guy	گﺍی
guyatt	گیﺍﺕ
guyer	گﺍیﺭ
guzek	گﺍﺯک
guzman	گﺍﺯﻡﻥ
gwillim	گﻭییﻝیﻡ
gwin	گﻭیﻥ
gwynn	گیﻥ
haba	ﻩﺍﺏﺍ
haber	ﻩﺍﺏﺭ
habercom	ﻩﺍﺏﺭکﺍﻡ
habereder	ﻩﺍﺏﺭﺩﺭ
haberlach	ﻩﺍﺏﺭﻝچ
haberman	ﻩﺍﺏﺭﻡﻥ
habert	ﻩﺍﺏﺭﺕ
habiba	ﺡﺏیﺏﺍ
habura	ﻩﺍﺏﻭﺭﺍ
hacker	ﻩکﺭ
hackett	ﻩکﺕ
hacking	ﻩﺍکیﻥگ
hackley	ﻩﺍکﻝی
hackshaw	ﻩکﺵﺍﻭ
hadavi	ﻩﺩﺍﻭی
hadaya	ﻩﺩﺍیﺍ
haddad	ﺡﺩﺍﺩ
haddock	ﻩﺩﺍک
haddy	ﻩﺍﺩی
hadil	ﺡﺩیﻝ
hadiya	ﺡﺩیﺍ
hadland	ﻩﺍﺩﻝﻥﺩ
hadley	ﻩﺍﺩﻝی
hadramawt	ﺡﺩﺭﺍﻡﻭﺕ
hafer	ﻩﺍﻑﺭ
hafs	ﺡﺩﺱ
hafsah	ﺡﺩﺱﺍ
haga	ﻩﺍگﺍ
hagan	ﻩﺍگﺍﻥ
hagelin	ﻩﺍگﻝیﻥ
hageman	ﻩﺍگﻡﻥ
hagen	ﻩیگﻥ
hager	ﻩﺍگﺭ
haggard	ﻩﺍگﺍﺭﺩ
hagin	ﻩﺍگیﻥ
hagir	ﺡﺍﺝیﺭ
hagland	ﻩگﻝﻥﺩ
hagler	ﻩﺍگﻝﺭ
haibach	ﻩیﺏﺍخ
haich	ﻩﺍیچ
haidar	ﺡیﺩﺭ
haifa	ﺡیﻑﺍ
haik	ﻩیک
hail	ﺡیﻝ
hailey	ﻩﺍیﻝی
hain	ﻩﺍیﻥ
hainge	ﻩیﻥگ
haj	ﻩﺍﺝ
hajar	ﺡﺝﺭ
hajery	ﻩﺝﺭی
hakim	ﺡکیﻡ
hakulinen	ﻩﺍکﻭﻝیﻥﻥ
halab	ﺡﻝﺍﺏ
halat	ﻩﺍﻝﺍﺕ
haldre	ﻩﺍﻝﺩﺭ
hale	ﻩیﻝ
haleger	ﻩﺍﻝگﺭ
haley	ﻩﺍﻝی
halkedis	ﻩﺍﻝکﺩیﺱ
hall	ﻩﺍﻝ
hallam	ﻩﺍﻝﺍﻡ
halleck	ﻩﺍﻝک
hallen	ﻩﺍﻝﻥ
haller	ﻩﺍﻝﺭ
hallert	ﻩﺍﻝﺭﺕ
halliburton	ﻩﺍﻝیﺏﺭﺕﻭﻥ
halliwell	ﻩﺍﻝیﻭﻝ
halm	ﻩﺍﻝﻡ
halpin	ﻩﺍﻝپیﻥ
halsted	ﻩﺍﻝﺱﺕﺩ
hamachi	ﻩﺍﻡﺍچی
hamad	ﺡﺍﻡﺩ
hamah	ﺡﺍﻡﺍﻩ
hamam	ﺡﻡﺍﻡ
hambidge	ﻩﺍﻡﺏیگ
hamdan	ﺡﻡﺩﺍﻥ
hamel	ﻩﺍﻡﻝ
hami	ﻩﺍﻡی
hamid	ﺡﻡیﺩ
hamill	ﻩﺍﻡیﻝ
hamilton	ﻩﺍﻡیﻝﺕﻥ
hammans	ﻩﺍﻡﺍﻥﺯ
hammarquist	ﻩﺍﻡﺍﺭکﻭییﺱﺕ
hammel	ﻩﺍﻡﻝ
hammer	ﻩﺍﻡﺭ
hammond	ﻩﺍﻡﻭﻥﺩ
hammonds	ﻩﺍﻡﻭﻥﺩﺯ
hamparian	ﻩﺍﻡپﺭیﻭﻥ
hampshire	ﻩﺍﻡپﺵیﺭ
hampton	ﻩﺍﻡپﺕﻭﻥ
hamra	ﺡﻡﺭﺍ
hamza	ﺡﻡﺯ
han	ﻩﺍﻥ
hanaa	ﺡﻥﺍ
hanan	ﺡﻥﺍ
hand	ﻩﻥﺩ
handel	ﻩﺍﻥﺩﻝ
hands	ﻩﻥﺩﺯ
hanebuth	ﻩﺍﻥﺏﻭﺕ
hani	ﺡﻥی
hanifa	ﺡﻥیﻑﺍ
haniyya	ﺡﺍﻥیﻩ
hanke	ﻩﺍﻥکﻩ
hanks	ﻩﺍﻥکﺯ
hannaford	ﻩﺍﻥﺍﻑﻭﺭﺩ
hannemann	ﻩﺍﻥیﻡﻥ
hanney	ﻩﻥی
hannu	ﻩﺍﻥﻭ
hansen	ﻩﺍﻥﺱﻥ
hansher	ﻩﺍﻥﺵﺭ
hanson	ﻩﺍﻥﺱﻭﻥ
hanssen	ﻩﺍﻥﺱﻥ
hansson	ﻩﺍﻥﺱﻭﻥ
hao	ﻩﺍﻭ
har	ﻩﺍﺭ
harald	ﻩﺍﺭﺍﻝﺩ
haraldsen	ﻩﺍﺭﺍﻝﺩﺱﻥ
haramoto	ﻩﺍﺭﻡﻭﺕﻭ
harari	ﻩﺍﺭﺍﺭی
haratz	ﻩﺍﺭﺍﺕﺯ
harber	ﻩﺍﺭﺏﺭ
harbidge	ﻩﺭﺏیﺝ
harbor	ﻩﺍﺭﺏﺭ
harbour	ﻩﺍﺭﺏﺭ
harbud	ﻩﺍﺭﺏﺩ
harburn	ﻩﺍﺭﺏﺭﻥ
harden	ﻩﺍﺭﺩﻥ
hardiman	ﻩﺍﺭﺩیﻡﻥ
hardin	ﻩﺍﺭﺩیﻥ
harding	ﻩﺍﺭﺩیﻥگ
hardison	ﻩﺍﺭﺩیﺱﻭﻥ
hares	ﻩﺍﺭﺱ
hargroves	ﻩﺍﺭگﺭﺍﻭﺯ
haricken	ﻩﺭیکﻥ
hariharan	ﻩﺍﺭیﻩﺍﺭﺍﻥ
harincar	ﻩﺍﺭیﻥکﺍﺭ
harish	ﻩﺍﺭیﺵ
harith	ﺡﺭیث
harkcom	ﻩﺍﺭکﻭﻡ
harker	ﻩﺍﺭکﺭ
harkin	ﻩﺍﺭکیﻥ
harkins	ﻩﺍﺭکیﻥﺯ
harlan	ﻩﺍﺭﻝﻥ
harland	ﻩﺍﺭﻝﻥﺩ
harlow	ﻩﺍﺭﻝﻭ
harman	ﻩﺭﻡﻥ
harmanus	ﻩﺭﻡﻥیﻭﺱ
harms	ﻩﺍﺭﻡﺯ
harold	ﻩﺍﺭﻝﺩ
haroon	ﻩﺍﺭﻭﻥ
haroun	ﻩﺭﻭﺱ
harpe	ﻩﺍﺭپ
harper	ﻩﺍﺭپﺭ
harpold	ﻩﺍﺭپﻭﻝﺩ
harrell	ﻩﺍﺭﻝ
harrer	ﻩﺍﺭﺭ
harries	ﻩﺍﺭیﺯ
harrig	ﻩﺍﺭﺭیگ
harrison	ﻩﺭیﺱﻭﻥ
harrow	ﻩﺍﺭﻭ
harsh	ﻩﺍﺭﺵ
harsha	ﻩﺍﺭﺵﺍ
hartel	ﻩﺍﺭﺕﻝ
harter	ﻩﺍﺭﺕﺭ
hartfield	ﻩﺍﺭﺕﻑیﻝﺩ
hartigan	ﻩﺍﺭﺕیگﺍﻥ
hartlep	ﻩﺍﺭﺕﻝپ
hartley	ﻩﺍﺭﺕﻝی
hartmann	ﻩﺍﺭﺕﻡﻥ
hartog	ﻩﺍﺭﺕﺍگ
hartwell	ﻩﺭیﻭﻝ
haruhisa	ﻩﺍﺭﻭﻩیﺱﺍ
haruni	ﻩﺍﺭﻭﻥی
harv	ﻩﺭﻭ
harvard	ﻩﺍﺭﻭﺍﺭﺩ
harvell	ﻩﺍﺭﻭﻝ
harvey	ﻩﺍﺭﻭی
hasakah	ﺡﺍﺱﺍکﺍﻩ
hasan	ﺡﺱﻥ
hasbrouck	ﻩﺍﺱﺏﺭﻭک
hascall	ﻩﺍﺱکﺍﻝ
haskel	ﻩﺍﺱکﻝ
haskell	ﻩﺍﺱکﻝ
haslum	ﻩﺍﺱﻝﻭﻡ
hasna	ﺡﺱﻥﺍ
hass	ﻩﺍﺱ
hassall	ﻩﺍﺱﺍﻝ
hasse	ﻩﺱ
hassett	ﻩﺍﺱﺕ
haste	ﻩﺱﺕ
hastings	ﻩﺍﺱﺕیﻥگﺯ
hatcher	ﻩﺕچﺭ
hatem	ﻩﺍﺕﻡ
hatmaker	ﻩﺍﺕﻡیکﺭ
hatrell	ﻩﺍﺕﺭﻝ
hatton	ﻩﺍﺕﻭﻥ
hattori	ﻩﺍﺕﻭﺭی
hau	ﻩﺍﻭ
havard	ﻩﺍﻭﺍﺭﺩ
haven	ﻩﺍﻭﻥ
havola	ﻩﺍﻭﻭﻝﺍ
haw	ﻩﺍﻭ
hawdon	ﻩﺍﻭﺩﻭﻥ
hawk	ﻩﺍﻭک
hawken	ﻩﻭکﻥ
hawker	ﻩﺍﻭکﺭ
hawkes	ﻩﺍیﻭکﺯ
hawkin	ﻩﺍﻭکیﻥ
hawkins	ﻩیﻭکیﻥﺯ
hawkinson	ﻩﺍیﻭکیﻥﺱﻭﻥ
hawks	ﻩﺍکﺱ
hawley	ﻩﺍﻭﻝی
hawn	ﻩﺍﻭﻥ
hawtin	ﻩﺍﻭﺕیﻥ
haxel	ﻩﺍکﺱﻝ
hayden	ﻩیﺩﻥ
hayes	ﻩیﺯ
haynes	ﻩیﻥﺯ
haynie	ﻩﺍیﻥی
hayter	ﻩﺍیﺕﺭ
hayward	ﻩیﻭﺍﺭﺩ
hazelton	ﻩﺯﻝﺕﻭﻥ
hazen	ﻩﺍﺯﻥ
head	ﻩﺩ
headland	ﻩﺩﻝﻥﺩ
headley	ﻩﺩﻝی
headlund	ﻩیﺩﻝﺍﻥﺩ
heald	ﻩیﻝﺩ
healey	ﻩیﻝی
healton	ﻩﻝﺕﻭﻥ
hean	ﻩییﻥ
heard	ﻩﺭﺩ
hearley	ﻩیﺭﻝی
hearn	ﻩیﺭﻥ
hearne	ﻩیﺭﻥﻩ
hearth	ﻩﺍﺭﺕ
heathcote	ﻩیﺱکﻭﺕ
heather	ﻩیﺕﺭ
heaton	ﻩیﺕﻭﻥ
hebborn	ﻩیﺏﻭﺭﻥ
hebenton	ﻩﺏﻥﺕﻭﻥ
hecke	ﻩک
hecker	ﻩکﺭ
hecking	ﻩکیﻥگ
hector	ﻩکﺕﻭﺭ
hedin	ﻩﺩیﻥ
hedlund	ﻩﺩﻝﻭﻥﺩ
hedrick	ﻩﺩﺭیک
heelan	ﻩﻝﺍﻥ
heerdegen	ﻩیﺭﺩگﻥ
heetan	ﻩیﺕﻥ
heeter	ﻩیﺕﺭ
heezemans	ﻩیﺯیﻡﻥﺯ
heffler	ﻩیﻑﻝﺭ
heffron	ﻩﻑﺭﻭﻥ
hegarty	ﻩگﺍﺭﺕی
hegermann	ﻩیگﺭﻡﻥ
heggie	ﻩگی
hegyi	ﻩگی
hehman	ﻩﻩﻡﻥ
hei	ﻩی
heiberg	ﻩیﺏﺭگ
heiden	ﻩیﺩﻥ
heiderich	ﻩیﺩﺭیچ
heidmann	ﻩﺍیﺩﻡﻥ
heidner	ﻩیﺩﻥﺭ
heidrich	ﻩیﺩﺭیﺵ
heifetz	ﻩیﻑﺕﺯ
heights	ﻩیﺕﺱ
heigl	ﻩیگﻝ
heikki	ﻩیکی
heiko	ﻩیکﻭ
heil	ﻩیﻝ
heiland	ﻩیﻝﻥﺩ
heim	ﻩیﻡ
heinly	ﻩیﻥﻝی
heino	ﻩیﻥﻭ
heinonen	ﻩیﻥﻭﻥﻥ
heinous	ﻩیﻥﻭﺯ
heintz	ﻩیﻥﺕﺯ
heinz	ﻩیﻥﺯ
heiser	ﻩیﺱﺭ
heiss	ﻩیﺱ
hekezen	ﻩکﺯﻥ
helal	ﻩﻝﺍﻝ
helbig	ﻩﻝﺏیگ
helbing	ﻩﻝﺏیﻥگ
helbling	ﻩﻝﺏﻝیﻥگ
helen	ﻩﻝﻥ
helena	ﻩﻝﻥﺍ
helfman	ﻩﻝﻑﻡﻥ
helga	ﻩﻝگﺍ
helke	ﻩﻝک
hell	ﻩﻝ
hellekant	ﻩﻝکﺍﻥﺕ
hellen	ﻩﻝﻥ
heller	ﻩﺍﻝﺭ
hellerstein	ﻩیﻝیﺭﺵﺕیﻥ
helliwell	ﻩﻝیﻭﻝ
hellmer	ﻩﻝﻡﺭ
hellstrom	ﻩﻝﺱﺕﺭﻭﻡ
hellwege	ﻩﻝﻭﺝ
helman	ﻩﻝﻡﻥ
helmenstine	ﻩﻝﻡﻥﺱﺕﺍیﻥ
helms	ﻩﻝﻡﺯ
helou	ﻩﻝﻭ
helt	ﻩﻝﺕ
hemer	ﻩﻡﺭ
hemmer	ﻩﻡﺭ
hempe	ﻩﻡپ
hemstede	ﻩیﻡﺱﺕﺩ
hendee	ﻩﻥﺩی
henderson	ﻩﺍﻥﺩﺭﺱﻭﻥ
hendrica	ﻩیﻥﺩﺭیکﺍ
hendrickje	ﻩﻥﺩﺭیچی
hendricks	ﻩﻥﺩﺭیکﺱ
hendrickson	ﻩﻥﺩﺭیکﺱﻥ
hendricus	ﻩﻥﺩﺭیچﻭﺯ
hendriks	ﻩﻥﺩﺭیکﺱ
hendrikse	ﻩﻥﺩﺭیکﺱﻩ
henegan	ﻩیﻥگﺍﻥ
henkel	ﻩﻥکﻝ
henle	ﻩﻥﻝ
henley	ﻩﻥﻝی
henneke	ﻩﻥیک
hennenfent	ﻩﻥﻥﻑﻥﺕ
hennigan	ﻩﻥیگﺍﻥ
henningsen	ﻩﻥیﻥگﺱﻥ
henriet	ﻩﻥﺭیﺕ
henrik	ﻩﻥﺭیک
hensley	ﻩﻥﺱﻝی
hentig	ﻩﻥﺕیگ
hentje	ﻩﻥﺕ
henze	ﻩﻥﺯ
hepler	ﻩپﻝﺭ
herbert	ﻩﺭﺏﺭﺕ
herborth	ﻩﺭﺏﻭﺭﺕ
herd	ﻩﺭﺩ
herdsfield	ﻩﺭﺩﺯﻑیﻝﺩ
herlevi	ﻩﺭﻝﻭی
herlindis	ﻩﺭﻝیﻥﺩیﺱ
herman	ﻩﺭﻡﺍﻥ
hermann	ﻩﺭﻡﺍﻥ
hermans	ﻩﺭﻡﺍﻥﺱ
hermes	ﻩﺭﻡﺯ
hermoso	ﻩﺭﻡﻭﺱﻭ
hernacki	ﻩﺭﻥﺍکی
hernandez	ﻩﺭﻥﺍﻥﺩﺯ
herndon	ﻩﺭﻥﺩﻭﻥ
herr	ﻩﺭ
herrera	ﻩﺭﺭﺍ
herrick	ﻩﺭیک
herring	ﻩﺭیﻥگ
herringshaw	ﻩﺭیﻥگﺵﺍﻭ
herrman	ﻩﺭﻡﺍﻥ
herrmann	ﻩﺭﻡﺍﻥ
hertling	ﻩﺭﺕﻝیﻥگ
hertweck	ﻩﺭﺕﻭک
hervey	ﻩﺭﻭی
hesemans	ﻩﺯﻡﻥﺯ
hesse	ﻩﺱ
hester	ﻩﺱﺕﺭ
hethcox	ﻩﺕکﻭکﺱ
hetrick	ﻩﺕﺭیک
hetzler	ﻩﺕﺯﻝﺭ
heuser	ﻩیﻭﺯﺭ
hewing	ﻩﻭیﻥگ
hewitt	ﻩیﻭﻭیﺕ
heyltje	ﻩیﻝیﺕﻩ
heymann	ﻩیﻡﻥ
hibberd	ﻩﺍیﺏﺭﺩ
hibbert	ﻩیﺏﺭﺕ
hibbs	ﻩﺍیﺏﺯ
hickey	ﻩیکی
hickman	ﻩیکﻡﻥ
hidajat	ﻩیﺩﺍﺝﺍﺕ
hiern	ﻩیﺭﻥ
hieronimus	ﻩﺭﻭﻥیﻡﻭﺱ
higdon	ﻩیﺝﺩﺍﻥ
highland	ﻩﺍیﻝﻥﺩ
highlord	ﻩﺍیﻝﻭﺭﺩ
higonnet	ﻩیگﻭﻥﺕ
hikaru	ﻩیکﺍﺭﻭ
hildebrand	ﻩیﻝﺩﺏﺭﺍﻥﺩ
hilker	ﻩیﻝکﺭ
hill	ﻩیﻝ
hillberry	ﻩیﻝﺏﺭی
hille	ﻩیﻝ
hillenbrand	ﻩیﻝﻥﺏﺭﻥﺩ
hillery	ﻩیﻝﺭی
hilletje	ﻩیﻝﺕ
hillis	ﻩیﻝیﺱ
hills	ﻩیﻝﺯ
hillyard	ﻩیﻝیﺍﺭﺩ
hilmer	ﻩیﻝﻡﺭ
hilsenteger	ﻩیﻝﺱﻥﺕیگﺭ
hilson	ﻩیﻝﺱﻭﻥ
hilton	ﻩیﻝﺕﻥ
hiltz	ﻩیﺕﺯ
hime	ﻩﺍیﻡ
hin	ﻩیﻥ
hince	ﻩیﻥﺱ
hinchey	ﻩیﻥچی
hinchley	ﻩیﻥچﻝی
hinchliffe	ﻩﻥچﻝیﻑ
hind	ﻩیﻥﺩ
hine	ﻩﺍیﻥ
hinely	ﻩﺍیﻥﻝی
hiner	ﻩیﻥﺭ
hines	ﻩیﻥﺯ
hinson	ﻩیﻥﺱﻭﻥ
hinton	ﻩیﻥﺕﻭﻥ
hinz	ﻩیﻥﺯ
hiongun	ﻩیﻭﻥگﺍﻥ
hipgrave	ﻩیپگﺭیﻭ
hipp	ﻩیپ
hippely	ﻩﺍیپﻝی
hipps	ﻩیپﺱ
hirai	ﻩیﺭﺍی
hird	ﻩیﺭﺩ
hirota	ﻩیﺭﻭﺕﺍ
hirt	ﻩیﺭﺕ
hisan	ﻩیﺱﺍﻥ
hiscocks	ﻩیﺱکﻭکﺱ
hise	ﻩﺍیﺯ
hisel	ﻩیﺱﻝ
hitchens	ﻩیچﻥﺱ
hitchman	ﻩیچﻡﻥ
hitson	ﻩیﺕﺱﻭﻥ
hitz	ﻩیﺕﺯ
hixon	ﻩیکﺱﻭﻥ
hlavenka	ﻝﺍﻭﻥکﺍ
hlavin	ﻩﻝﺍﻭیﻥ
hoadley	ﻩﻭﺍﺩﻝی
hoar	ﻩﻭﺍﺭ
hobbs	ﻩﺍﺏﺯ
hoberman	ﻩﻭﺏﺭﻡﻥ
hoborough	ﻩﺍﺏﻭﺭگ
hocdet	ﻩﺍکﺩﺕ
hochhalter	ﻩﺍچﻩﺍﻝﺕﺭ
hockey	ﻩﺍکی
hodgeman	ﻩﺍگﻡﻥ
hodgers	ﻩﺍﺝﺭﺯ
hodges	ﻩﺍﺝﺯ
hodgin	ﻩﻭﺩگی
hodgkins	ﻩﺍگکیﻥﺯ
hodson	ﻩﺍﺩﺱﻭﻥ
hoffbeck	ﻩﺍﻑﺏک
hoffman	ﻩﺍﻑﻡﻥ
hoffmann	ﻩﺍﻑﻡﻥ
hofgaard	ﻩﻭﻑگﺍﺭﺩ
hoford	ﻩﻭﻑﺭﺩ
hogan	ﻩﻭگﺍﻥ
hogarty	ﻩﻭگﺍﺭﺕی
hoge	ﻩﻭگ
hogg	ﻩﺍگ
hoggard	ﻩﺍگﺍﺭﺩ
hohensohn	ﻩﻭﻩﻥﺱﻭﻥ
hoiberg	ﻩﻭیﺏﺭگ
hoitink	ﻩﻭیﺕیﻥک
holcomb	ﻩﻭﻝکﺍﻡﺏ
holden	ﻩﻝﺩﻥ
holdsworth	ﻩﻭﻝﺩﺯﻭﺭث
holfelder	ﻩﺍﻝﻑﻝﺩﺭ
holkner	ﻩﺍﻝکﻥﺭ
holland	ﻩﺍﻝﻥﺩ
hollander	ﻩﻝﻥﺩﺭ
holle	ﻩﻝی
holliday	ﻩﺍﻝیﺩی
hollifield	ﻩﺍﻝیﻑیﻝﺩ
hollinden	ﻩﻝیﻥﺩﻥ
hollyman	ﻩﺍﻝیﻡﻥ
holm	ﻩﻭﻝﻡ
holman	ﻩﺍﻝﻡﻥ
holmes	ﻩﻝﻡﺯ
holroyd	ﻩﻭﻝﺭﻭیﺩ
holst	ﻩﺍﻝﺱﺕ
holsten	ﻩﻭﻝﺱﺕﻥ
holtlandensis	ﻩﺍﺕﻝﻥﺩﻥﺱیﺱ
holton	ﻩﺍﻝﺕﻭﻥ
holtsinger	ﻩﺍﻝﺕﺱیﻥگﺭ
holtz	ﻩﺍﻝﺕﺯ
holub	ﻩﺍﻝﻭﺏ
holum	ﻩﻝﻭﻡ
holy	ﻩﻝی
holzen	ﻩﻭﻝﺯﻥ
holzer	ﻩﺍﻝﺯﺭ
holzgang	ﻩﻝﺯگﻥگ
holzman	ﻩﻝﺯﻡﻥ
holzwarth	ﻩﻭﻝﺯﻭﺍﺭث
homan	ﻩﻭﻡﻥ
hon	ﻩﻥ
honig	ﻩﻥیگ
honigberg	ﻩﻭﻥیگﺏﺭگ
honnur	ﺍﻥﻭﺭ
hooft	ﻩﻭﻑﺕ
hoogenboom	ﻩﻭگﻥﺏﻭﻡ
hoogeveen	ﻩﻭگﻭیﻥ
hoogheem	ﻩﻭﻕیﻡ
hoogland	ﻩﻭگﻝﻥﺩ
hook	ﻩﻭک
hooper	ﻩﻭپﺭ
hoos	ﻩﻭﺱ
hooven	ﻩﻭﻭﻥ
hoover	ﻩﻭﻭﺭ
hopcraft	ﻩپکﺭﺍﻑﺕ
hope	ﻩﻭپ
hopkins	ﻩﺍپکیﻥﺯ
hoppe	ﻩﻭپ
hopper	ﻩﺍپﺭ
hopson	ﻩﺍپﺱﻭﻥ
horak	ﻩﺭﺍک
horan	ﻩﺭﺍﻥ
horgan	ﻩﻭﺭگﺍﻥ
horio	ﻩﺍﺭیﻭ
horkan	ﻩﻭﺭکﺍﻥ
horn	ﻩﺭﻥ
horne	ﻩﺭﻥ
hornecker	ﻩﺭﻥکﺭ
horner	ﻩﺍﺭﻥﺭ
hornig	ﻩﻭﺭیﻥگ
hornsby	ﻩﺭﻥﺱﺏﺍی
horowitz	ﻩﻭﺭﻭیﺕﺯ
horree	ﻩﻭﺭی
horrigmo	ﻩﻭﺭیگﻡﻭ
horsfall	ﻩﺭﺱﻑﺍﻝ
horsford	ﻩﻭﺭﺱﻑﻭﺭﺩ
horst	ﻩﻭﺭﺱﺕ
hortmann	ﻩﻭﺭﺕﻡﻥ
horvat	ﻩﻭﺭﻭﺍﺕ
hosain	ﺡﺱیﻥ
hoskins	ﻩﺍﺱکیﻥﺯ
hosn	ﺡﺱﻥ
hoss	ﻩﺍﺱ
hostetler	ﻩﺍﺱﺕﺕﻝﺭ
hotopp	ﻩﺍﺕﺍپ
houck	ﻩﺍک
houde	ﻩﻭﺩ
hough	ﻩﻭ
houghtailing	ﻩگﺕیﻝیﻥگ
houghten	ﻩﺍگﺕﻥ
houghton	ﻩﺍﻭﺕﻭﻥ
houle	ﻩﺍیﻭﻝ
hourcle	ﻩﺍﺭکﻝ
hourihan	ﻩﻭﺭیﻩﺍﻥ
house	ﻩﺍﻭﺱ
houseman	ﻩﻭﺱﻡﻥ
houser	ﻩﺍﻭﺱﺭ
houston	ﻩﺍﺱﺕﻭﻥ
hovey	ﻩﺍﻭی
howarth	ﻩﻭﻭﺍﺭﺕ
howe	ﻩﻭ
howell	ﻩﺍﻭﻝ
howells	ﻩﺍﻭﻝﺯ
howerter	ﻩﻭﺭﺕﺭ
howes	ﻩﺍﻭیﺱ
howk	ﻩﺍﻭک
hoyman	ﻩﻭیﻡﺍﻥ
hrabi	ﻩﺭﺍﺏی
hranicky	ﻩﺭﺍﻥیکی
hua	ﻩﻭیﺍ
hubein	ﻩﺍﺏیﻥ
huber	ﻩﺍﺏﺭ
huck	ﻩﺍک
huckaby	ﻩﺍکﺍﺏﺍی
huckvale	ﻩﺍکﻭیﻝ
hudaydah	ﺡﺩیﺩﻩ
huddleston	ﻩﺍﺩﻝﺱﺕﻭﻥ
hudoba	ﻩﺍﺩﻭﺏﺍ
hudson	ﻩﺍﺩﺱﻥ
huffman	ﻩﺍﻑﻡﻥ
hugdahl	ﻩﺍگﺩﺍﻝ
huggard	ﻩﻭگﺍﺭﺩ
hugh	ﻩیﻭ
hughes	ﻩیﻭﺯ
hughson	ﻩﺍگﺱﻭﻥ
hugo	ﻩﻭگﻭ
huhtala	ﻩﺍﻩﺕﺍﻩﺍ
huigen	ﻩیﻭگﻥ
huisken	ﻩﻭییﺱکﻥ
huizing	ﻩﺭﺍیﺯیﻥگ
hulan	ﻩﺍﻝﺍﻥ
hulse	ﻩﻭﻝﺱ
hultgren	ﻩﺍﻝﺕگﺭﻥ
hume	ﻩیﻭﻡ
humm	ﻩﻭﻡ
hummock	ﻩﻭﻡﺍک
humpherys	ﻩﺍﻡﻑﺭیﺯ
humphrey	ﻩﺍﻡﻑﺭی
humphreys	ﻩﺍﻡﻑﺭیﺯ
hung	ﻩﺍﻥگ
hungerford	ﻩﺍﻥگﺭﻑﻭﺭﺩ
hunkler	ﻩﺍﻥکﻝﺭ
hunsaker	ﻩﺍﻥﺱﺍکﺭ
hunt	ﻩﺍﻥﺕ
huntington	ﻩﺍﻥﺕیﻥگﺕﻭﻥ
hurt	ﻩﺍﺭﺕ
hurtah	ﻩﺍﺭﺕﺍﻩ
husain	ﺡﺱیﻥ
husby	ﻩﺍﺱﺏی
husemann	ﻩﺍﺱﻡﻥ
husik	ﻩﺍﺱیک
husk	ﻩﺍﺱک
hussain	ﺡﺱیﻥ
hussein	ﺡﺱیﻥ
hutcheson	ﻩﺍﺕچﺱﻭﻥ
hutchins	ﻩﺍچیﻥﺯ
hutchinson	ﻩﺍچیﻥﺱﻭﻥ
hutchison	ﻩﺍچیﺱﻭﻥ
huth	ﻩﺍﺕ
hutter	ﻩﺍﺕﺭ
huttley	ﻩﺍﺕﻝی
hutton	ﻩﺍﺕﻭﻥ
huyer	ﻩﺍیﺭ
huyser	ﻩﻭیﺱﺭ
hvezda	ﻭﺯﺩﺍ
hviid	ﻩﻭیﺩ
hvinden	ﻭیﻥﺩﻥ
hyde	ﻩﺍیﺩ
hyland	ﻩیﻝﻥﺩ
hyman	ﻩیﻡﻥ
hynes	ﻩیﻥﺯ
hyslop	ﻩیﺱﻝﺍپ
hyson	ﻩﺍیﺱﻭﻥ
hyunsoo	ﻩیﻭﻥﺱﻭ
hyvonen	ﻩﺍﻭﻭﻥﻥ
iacoletti	یﺍکﻭﻝﺕی
iain	یﺍیﻥ
iarla	یﺍﺭﻝﺍ
ibar	ﺍیﺏﺍﺭ
ibironke	ﺍیﺏیﺭﻭﻥک
ibrahim	ﺍﺏﺭﺍﻩیﻡ
ibrini	ﺍﺏﺭیﻥی
icarus	ﺍیکﺍﺭﻭﺱ
ice	ﺍیﺱ
icefalls	ﺍیﺱﻑﺍﻝﺯ
icelic	ﺍیﺱﻝیک
iceport	ﺍیﺱپﻭﺭﺕ
ichiro	ﺍیچیﺭﻭ
iclozan	ﺍیکﻝﻭﺯﺍﻥ
ida	ﺍیﺩﺍ
idris	ﺍﺩﺭیﺱ
idun	ﺍیﺩﺍﻥ
idury	ﺍیﺩﻭﺭی
ienatch	ﺍیﻥﺍچ
ierardi	ﺍیﺭﺍﺭﺩی
ifje	ﺍیﻑ
ifo	ﺍیﻑﻭ
igloo	ﺍیگﻝﻭ
igoe	ﺍیگﻭ
igor	ﺍیگﻭﺭ
ijuin	ﺍیﺝﻭیﻥ
ikbal	ﺍﻕﺏﺍﻝ
ike	ﺍیکﻩ
ilan	ﺍیﻝﺍﻥ
ilana	ﺍیﻝﺍﻥﺍ
ileen	ﺍیﻝیﻥ
iler	ﺍیﻝﺭ
ilia	ﺍیﻝیﺍ
ilidio	ﺍیﻝیﺩیﻭ
ilieve	ﺍیﻭ
iliff	یﻝیﻑ
ilkka	ﺍیﻝکﺍ
ilmin	ﺍیﻝﻡیﻥ
ilpo	ﺍیﻝپﻭ
ilyess	ﺍیﻝیﺱ
imants	ﺍیﻡﺍﻥﺕﺯ
imar	ﺍیﻡﺍﺭ
inan	ﺍیﻥﺍﻥ
inanna	ﺍیﻥﺍﻥﺍ
inauen	ﺍیﻥﺍیﻥ
inch	ﺍیﻥچ
incognita	ﺍیﻥکﻭگﻥیﺕﺍ
indewey	ﺍیﻥﺩﻭی
indiresan	ﺍیﻥﺩﺍیﺭﺱﻥ
indra	ﺍیﻥﺩﺭﺍ
indrajit	ﺍیﻥﺩﺭﺍﺝیﺕ
indranil	ﺍیﻥﺩﺭﺍﻥیﻝ
indrelee	ﺍیﻥﺩﺭﻝی
indulis	ﺍیﻥﺩﺍﻝیﺱ
ines	ﺍیﻥﺱ
inez	ﺍیﻥﺯ
ing	ﺍیﻥگ
ingalls	ﺍیﻥگﺍﻝﺯ
inge	ﺍیﻥگ
ingegneri	ﺍیﻥﺝﺝﻥﺭی
ingemar	ﺍیﻥگﻡﺍﺭ
ingle	ﺍیﻥگﻝ
ingles	ﺍیﻥگﻝﺱ
inglis	ﺍیﻥگﻝیﺱ
ingmar	ﺍیﻥگﻡﺍﺭ
ingold	ﺍیﻥگﻝﺩ
ingolf	ﺍیﻥگﻝﻑ
ingraham	ﺍیﻥگﺭﺍﻩﺍﻡ
ingram	ﺍیﻥگﺭﺍﻡ
ingresole	ﺍیﻥگﺭیﺱﻝ
ingria	ﺍیﻥگﺭیﺍ
ingrid	ﺍیﻥگﺭیﺩ
ingvar	ﺍیﻥگﻭﺍﺭ
inho	ﺍیﻥﻩﻭ
inman	ﺍیﻥﻡﻥ
inna	ﺍیﻥﺍ
inner	ﺍیﻥﺭ
innes	ﺍیﻥﺯ
innocent	ﺍیﻥﻭﺱﻥﺕ
institut	ﺍﻥﺱﺕیﺕﻭ
intelsat	ﺍیﻥﺕﻝﺱﺍﺕ
internet	ﺍیﻥﺕﺭﻥﺕ
interrante	ﺍیﻥﺕﺭﻥﺕ
intyre	ﺍیﻥﺕﺍیﺭ
inzhenery	ﺍیﻥﺯﻩﻥﺭی
iowa	ﺍیﻭﺍ
irbid	ﺍﺭﺏیﺩ
ireland	ﺍیﺭﻝﻥﺩ
irizarry	ﺍیﺭیﺯﺍﺭی
irvin	ﺍیﺭﻭیﻥ
irving	ﺍﺭﻭیﻥگ
irwin	ﺍیﺭﻭییﻥ
isaac	ﺍیﺱﺍک
isaacs	ﺍیﺱﺍکﺱ
isacq	ﺍیﺯﺍک
isakson	ﺍیﺯﺍکﺱﻭﻥ
isbell	ﺍیﺱﺏﻝ
isecke	ﺍیﺱک
iselt	ﺍیﺱﻝﺕ
ishizaki	ﺍیﺵیﺯﺍکی
iskander	ﺍیﺱکﺍﻥﺩﺭ
isman	ﺍیﺯﻡﻥ
israel	ﺍﺱﺭﺍییﻝ
israt	ﺍیﺱﺭﺍﺕ
isthmus	ﺍیﺱﺕﻡﺍﺱ
istian	ﺍیﺱﺕیﻥ
itamar	ﺍیﺕﺍﻡﺍﺭ
itchon	ﺍیﺕچﻭﻥ
iunn	یﻭﻥ
ivar	ﺍیﻭﺍﺭ
iverson	ﺍیﻭﺭﺱﻭﻥ
ivery	ﺍیﻭﺭی
ivetic	ﺍیﻭﺕیک
iyer	ﺍیﺭ
izadi	ﺍیﺯﺩی
izroda	ﺍیﺯﺭﻭﺩﺍ
izzo	ﺍیﺯﻭ
jaantje	ژﺍﻥﺕ
jabir	ﺝﺏیﺭ
jack	ﺝک
jackman	ﺝکﻡﻥ
jackson	ﺝکﺱﻭﻥ
jacobje	ژﺍکﻭﺏ
jacobs	ﺝکﺏﺱ
jacobson	ﺝﺍکﻭﺏﺱﻭﻥ
jacobsson	ﺝﺍکﻭﺏﺱﻭﻥ
jacoby	ﺝﺍکﻭﺏی
jacomyntie	ژﺍکﻭﻡیﻥﺕﺍی
jacques	ژﺍکیﻭﺱ
jaepje	ﺝیپﻩ
jagard	ﺝﺍگﺍﺭﺩ
jager	ﺝﺍگﺭ
jago	ﺝﺍگﻭ
jahamane	ﺝﻩﺍﻡﺍﻥﻩ
jahmane	ﺝﺍﻩﻡﺍﻥﻩ
jahnke	ﺝﺍﻥک
jahra	ﺯﻩﺭﺍ
jain	ﺝیﻥ
jakeman	ﺝکﻡﻥ
jakobsson	ﺝکﻭﺏﺱﻭﻥ
jala	ﺝﺍﻝﺍ
jalal	ﺝﻝﺍﻝ
jalonen	ﺝﺍﻝﻭﻥﻥ
jamal	ﺝﻡﺍﻝ
james	ﺝیﻡﺯ
jameson	ﺝیﻡﺱﻭﻥ
jamie	ﺝیﻡی
jamil	ﺝﻡیﻝ
jamilah	ﺝﻡیﻝﺍ
jamulla	ﺝﻡﻭﻝﺍ
jamuna	ﺝﺍﻡﻭﻥﺍ
jan	ﺝﺍﻥ
jana	ﺝﺍﻥﺍ
janairo	ﺝﻥیﺭﻭ
janakiraman	ﺝیﻥﺍکیﺭﺍﻡﺍﻥ
janardhan	ﺝﺍﻥﺍﺭﺩﻩﺍﻥ
janches	ﺝﺍﻥچﺱ
janecek	ﺝیﻥیک
janecka	ﺝﺍﻥیکﺍ
janes	ﺝیﻥﺯ
jang	ﺝﺍﻥگ
jann	ﺝﺍﻥ
janotje	ﺝﺍﻥﺕ
jansje	ژﺍﻥﺱ
jansky	ﺝﺍﻥﺱکی
janssen	ﺝﺍﻥﺱﻥ
jarash	ﺍﺭﺵ
jarbot	ﺝﺍﺭﺏﻭﺕ
jardine	ﺝﺍﺭﺩیﻥ
jarrett	ﺝﺍﺭﺕ
jarvis	ﺝﺭﻭیﺱ
jarwala	ﺝﺍﺭﻭﺍﻝﺍ
jaschek	ﺝﺍﺱچک
jasper	ﺝﺍﺱپﺭ
jaspers	ﺝﺍﺱپﺭﺯ
jasvinder	ﺝﺍﺱﻭیﻥﺩﺭ
jatinder	ﺝﺍﺕیﻥﺩﺭ
javed	ﺝﺍﻭیﺩ
javier	ﺝﺍﻭیﺭ
jayan	ﺝﺍیﺍﻥ
jayant	ﺝﺍیﺍﻥﺕ
jayaram	ﺝﺍیﺍﺭﺍﻡ
jaymes	ﺝیﻡﺯ
jayne	ﺝیﻥ
jean	ﺝیﻥ
jedi	ﺝﺩی
jee	ﺝی
jeff	ﺝﻑ
jeffcock	ﺝﻑکک
jeffrey	ژﻑﺭی
jeffries	ﺝﻑﺭیﺯ
jehan	ﺝﻩﺍﻥ
jeltje	ژﻝﺕﺝ
jelvemark	ﺝﻝﻭﻡﺍﺭک
jen	ﺝﻥ
jenah	ﺝﻥﺍﺡ
jeng	ﺝﻥگ
jenings	ﺝﻥیﻥگﺯ
jenkinson	ﺝﺍﻥکیﻥﺱﻭﻥ
jenks	ﺝﻥکﺱ
jenneke	ژﻥک
jennifer	ﺝﻥیﻑﺭ
jeppesen	ﺝپﺱﻥ
jerada	ﺝﺭﺍﺩﺍ
jeremias	ﺝﺭﻡیﺍﺱ
jeremic	ﺝﺭﻡیک
jeremy	ﺝﺭﻡی
jergens	ﺝﺭگﻥﺯ
jeronimus	ﺝﺭﻭﻥیﻡﻭﺱ
jesper	ﺝﺱپﺭ
jess	ﺝیﺱ
jesse	ﺝیﺱﻩ
jessica	ﺝﺱیکﺍ
jessick	ﺝﺱیک
jester	ﺝیﺱﺕﺭ
jesus	ﺝیﺱﻭﺯ
jethro	ﺝﺕﺭﻭ
jetsam	ﺝﺕﺱﺍﻡ
jewell	ﺝیﻭیﻝ
jewett	ﺝﻭیﺕ
jezire	ﺝﺯیﺭﻩ
jhang	ﺝﻩﺍﻥگ
jia	ﺝیﺍ
jian	ﺝیﺍﻥ
jigang	ﺝیگﺍﻥگ
jilles	ﺝیﻝﺯ
jillian	ﺝیﻝیﺍﻥ
jim	ﺝیﻡ
jiminey	ﺝیﻡیﻥی
jin	ﺝیﻥ
jing	ﺝیﻥگ
jiok	ﺝیﻭک
jirousek	ﺝیﺭﻭﺱک
jitta	ﺝیﺕﺍ
jizan	ﺝیﺯﺍﻥ
joab	ﺝﻭﺍﺏ
joan	ﺝﻭﺍﻥ
joao	ﺝﻭﺍﻭ
jobje	ژﺍﺏژ
joel	ژﻭﻝ
joergen	ﺝﻭﺭﺝﻥ
joesph	ﺝﻭیﺱﻑ
joffe	ﺝﻭﻑ
jog	ﺝﺍگ
johanes	ﺝﻭﻩﺍﻥﺯ
johann	ﺝﻭﻩﺍﻥ
johanna	ﺝﻭﻩﺍﻥﺍ
johannes	ژﻭﻩﺍﻥﺱ
johannesen	ﺝﻭﻩﺍﻥﺱﻥ
johannson	ﺝﻭﻩﺍﻥﺱﻭﻥ
johansen	ﺝﻭﻩﺍﻥﺱﻥ
johansson	ژﻭﻩﺍﻥﺱﻥ
john	ژﺍﻥ
johnny	ﺝﺍﻥی
johns	ﺝﺍﻥﺯ
joiner	ﺝﻭیﻥﺭ
jokin	ﺝکیﻥ
jolee	ﺝﻭﻝی
jolene	ﺝﻝﻥی
jolliff	ﺝﻭﻝیﻑ
jolly	ژﻭﻝی
joltes	ﺝﻭﻝﺕﺯ
joly	ﺝﻭﻝی
jonas	ﺝﻭﻥﺍﺱ
jonathon	ﺝﺍﻥﺍﺕﻭﻥ
jong	ﺝﺍﻥگ
jongtae	ﺝﺍﻥگﺕﺍیی
jonin	ﺝﻭﻥیﻥ
jonn	ﺝﻭﻥ
jonsson	یﻭﻥﺱﻭﻥ
jooss	ﺝﻭﺱ
joppru	ﺝﻭپﺭﻭ
jorge	ﺝﻭﺭﺝ
jorgen	ﺝﻭﺭﺝﻥ
jorritsma	ﺝﺭیﺕﺱﻡﺍ
jory	ﺝﻭﺭی
joseph	ژﻭﺯﻑ
josephus	ﺝﻭﺯﻑﻭﺱ
josey	ﺝﻭﺯی
josh	ﺝﺍﺵ
joshua	ﺝﺍﺵﻭﺍ
josi	ﺝﻭﺯی
josie	ﺝﻭﺯیﻩ
josip	ﺝﻭﺱیپ
joslin	ﺝﻭﺱﻝیﻥ
jost	ﺝﺍﺱﺕ
jostein	ﺝﺍﺱﺕیﻥ
joswig	ﺝﻭﺱﻭیگ
joubb	ﺝﻭﺏ
joubin	ﺝﻭﺏیﻥ
jougla	ﺝﻭگﻝﺍ
joungane	ﺝﻭﻥگﺍﻥ
jouni	ﺝﻭﻥی
joura	ﺝﻭﺭﺍ
jouravlev	ﺝﻭﺭﺍﻭﻝﻭ
jovica	ﺝﺍﻭیکﺍ
jowett	ﺝﻭیﺕ
joyce	ﺝﻭیﺱ
joydeep	ﺝﻭیﺩیپ
joyner	ﺝﻭیﻥﺭ
juan	ﺝﻭﺍﻥ
juana	ﺝﻭﺍﻥﺍ
juang	ﺝﻭﺍﻥگ
juanita	ﺝﻭﺍﻥیﺕﺍ
juay	ﺝﻭﺍی
jubal	ﺝﻭﺏﺍﻝ
jubb	ﺝﺍﺏ
jud	ﺝﺍﺩ
judas	ﺝﻭﺩﺍﺱ
judd	ﺝﺍﺩ
jude	ﺝﺍﺩ
judi	ﺝﻭﺩی
judy	ﺝﻭﺩی
juhani	ﺝﻭﻩﺍﻥی
juliaantje	ﺝﻭﻝیﺍﻥﺕ
jun	ﺝﺍﻥ
june	ﺝﻭﻥ
jung	ﺝﺍﻥگ
junger	ﺝﺍﻥگﺭ
junghans	ﺝﻭﻥگﺍﻥﺯ
jungnickel	ﺝﺍﻥگﻥیکﻝ
junior	ﺝﻭﻥیﻭﺭ
junk	ﺝﺍﻥک
juno	ﺝﻭﻥﻭ
jurah	ﺝﻭﺭﺍﻩ
jurek	ﺝﻭﺭک
jurgens	ﺝﻭﺭگﻥﺯ
jurisica	ژﻭﺭیﺱیکﺍ
jurran	ﺝﻭﺭﺍﻥ
justham	ﺝﺍﺱﺕﺍﻡ
justice	ﺝﺍﺱﺕیﺱ
justin	ﺝﺍﺱﺕیﻥ
justine	ﺝﺍﺱﺕیﻥ
justje	ﺝﺍﺱﺕیﻩ
justus	ﺝﺍﺱﺕﺍﺱ
juvander	ﺝﻭﺍﻥﺩﺭ
juza	ﺝﻭﺯﺍ
kabakian	کﺏﺍکیﺍﻥ
kabakibo	کﺏﺍکیﺏﻭ
kabir	کﺏیﺭ
kacalek	کﺍکﺍﻝک
kacandes	کﺍکﺍﻥﺩﺱ
kaden	کﺍﺩﻥ
kadin	کﺍﺩیﻥ
kado	کﺍﺩﻭ
kadribasic	کﺍﺩﺭیﺏیﺱیک
kagle	کﺍگﻝ
kahane	کﺍﻩﺍﻥ
kai	کﺍی
kailas	کﺍیﻝﺍﺱ
kailasa	کیﺍﻝﺍﺱﺍ
kain	کیﻥ
kairoff	کﺍیﺭﻭﻑ
kaki	کﺍکی
kakodkar	کﺍکﺩکﺍﺭ
kakure	کﺍکیﻭﺭ
kalafatas	کﺍﻝﺍﻑﺍﺕﺍﺱ
kalafut	کﺍﻝﺍﻑﻭﺕ
kalathur	کﺍﻝﺍﺕﻭﺭ
kalb	کﺍﻝﺏ
kaldis	کﺍﻝﺩیﺱ
kale	کیﻝ
kaleb	کﺍﻝﺏ
kalemis	کﺍﻝﻡیﺱ
kalia	کﺍﻝیﺍ
kalila	کﺍﻝیﻝﺍ
kalish	کﺍﻝیﺵ
kalisiak	کﺍﻝیﺱیﺍک
kalkan	کﺍﻝکﺍﻥ
kalle	کﺍﻝ
kalliany	کﺍﻝیﺍﻥی
kalman	کﺍﻝﻡﺍﻥ
kalpak	کﺍﻝپﺍک
kalpana	کﺍﻝپﺍﻥﺍ
kalpesh	کﺍﻝپﺵ
kalyan	کﺍﻝیﺍﻥ
kam	کﺍﻡ
kamal	کﺍﻡﺍﻝ
kamala	کﺍﻡﺍﻝﺍ
kamath	کﺍﻡﺍﺕ
kamb	کﺍﻡﺏ
kamdar	کﺍﻡﺩﺍﺭ
kame	کﺍﻡ
kamel	کﺍﻡﻝ
kamelen	کﺍﻡﻝﻥ
kamen	کﺍﻡﻥ
kamens	کﺍﻡﻥﺱ
kamerud	کﺍﻡﺭﻭﺩ
kamholz	کﺍﻡﻩﻭﻝﺯ
kamien	کﺍﻡیﻥ
kamilah	کﻡیﻝﺍ
kamiya	کﺍﻡیﺍ
kamlish	کﺍﻡﻝیﺵ
kammeyer	کﻡیﺭ
kampe	کﺍﻡپ
kamper	کﺍﻡپﺭ
kamphuis	کﻡﻑﻭیﺱ
kamskaya	کﺍﻡﺱکﺍیﺍ
kana	کﺍﻥﺍ
kanak	کﺍﻥﺍک
kanakakorn	کﺍﻥﺍکﺍکﻭﺭﻥ
kanamori	کﻥﺍﻡﻭﺭی
kanda	کﺍﻥﺩﺍ
kandell	کﻥﺩﻝ
kandi	کﺍﻥﺩی
kandolf	کﻥﺩﻭﻝﻑ
kane	کیﻥ
kang	کﺍﻥگ
kania	کﺍﻥیﺍ
kannan	کﺍﻥﺍﻥ
kant	کﺍﻥﺕ
kanter	کﺍﻥﺕﺭ
kanze	کﺍﻥﺯی
kao	کیﻭ
kaos	کﺍﻭﺱ
kapanga	کﺍپﺍﻥگﺍ
kapetan	کپﺕﺍﻥ
kapila	کﺍپیﻝﺍ
kapje	کپﺝﻩ
kaplan	کﺍپﻝﺍﻥ
kaplenk	کﺍپﻝیﻥک
kapner	کﺍپﻥﺭ
kapoor	کﺍپﻭﺭ
kapp	کﺍپ
kappa	کﺍپﺍ
kapral	کﺍپﺭﺍﻝ
kapson	کﺍپﺱﻭﻥ
kara	کﺍﺭﺍ
karabulut	کﺍﺭﺍﺏﻭﻝﻭﺕ
karaca	کﺍﺭﺍﺱﺍ
karakash	کﺍﺭکﺍﺵ
karan	کﺍﺭﺍﻥ
karas	کﺭﺍﺭﺍﺱ
karasu	کﺍﺭﺍﺱﻭ
karayel	کﺍﺭﺍیﻝ
karbala	کﺭﺏﻝﺍ
kardal	کﺭﺩﺍﻝ
kardel	کﺍﺭﺩﻝ
kardelis	کﺍﺭﺩﻝیﺱ
karen	کﺍﺭﻥ
kari	کﺍﺭی
karida	کﺭیﺩﺍ
kariger	کﺍﺭیﺝﺭ
karim	کﺭیﻡ
karish	کﺍﺭیﺵ
karl	کﺍﺭﻝ
karlquist	کﺍﺭﻝکﻭیﺱﺕ
karlsson	کﺍﺭﺱﻭﻥ
karmann	کﺍﺭﻡﺍﻥ
karn	کﺍﺭﻥ
karner	کﺍﺭﻥﺭ
karp	کﺍﺭپ
karplus	کﺍﺭپﻝﺍﺱ
karr	کﺭ
karras	کﺍﺭﺍﺱ
karridian	کﺍﺭیﺩیﺍﻥ
kartik	کﺍﺭﺕیک
karty	کﺍﺭﺕی
karumuri	کﺭﺍﻡﺍﺭی
karwin	کﺍﺭﻭیﻥ
kasai	کﺱﺍی
kasama	کﺍﺱﺍﻡﺍ
kasat	کﺍﺱﺍﺕ
kasouf	کﺍﺱﻭﻑ
kasprzak	کﺍﺱپﺭﺯﺍک
kassam	کﺍﺱﺍﻡ
kassem	کﺍﺱﻡ
kassirer	کﺍﺯیﺭﺭ
kast	کﺱﺕ
kastein	کﺍﺱﺕیﻥ
kasterchem	کﺍﺱﺕﺭچﻡ
kastner	کﺍﺱﺕﻥﺭ
kastrup	کﺱﺕﺭﺍپ
kasturi	کﺍﺱﺕﻭﺭی
kasun	کﺍﺱﻭﻥ
kateb	کﺍﺕﺏ
katen	کﺍﺕﻥ
kateri	کﺍﺕﺭی
kates	کیﺕﺱ
kathol	کﺍﺕﻝ
kathy	کﺕی
kati	کﺍﺕی
katie	کیﺕی
katishna	کﺍﻥیﺵﻥﺍ
katleman	کﺍﺕﻝﻡﻥ
katopis	کﺍﺕﻭپیﺱ
katrin	کﺍﺕﺭیﻥ
katrina	کﺍﺕﺭیﻥﺍ
katryntje	کﺍﺕﺭیﻥ
katta	کﺍﺕﺍ
kattan	کﺍﺕﺍﻥ
katwala	کﺍﺕﻭﺍﻝﺍ
katz	کﺍﺕﺯ
kauk	کﺍیک
kave	کﺍﻭﻩ
kaveh	کﺍﻭﻩ
kavita	کﺍﻭیﺕﺍ
kawai	کﺍﻭﺍیی
kaya	کﺍیﺍ
kayak	کﺍیﺍک
kayser	کﺍیﺱﺭ
kazdan	کﺍﺯﺩﺍﻥ
kazi	کﺍﺯی
kazmaier	کﺍﺯﻡﺍیﺭ
kazuhiro	کﺍﺯﻭﻩیﺭﻭ
kazunori	کﺍﺯﻭﻥﻭﺯی
kean	کیﻥ
keane	کیﻥ
keanini	کیﻥیﻥی
keasha	کیﺵﺍ
keat	کیﺕ
keath	کیﺕ
keating	کیﺕیﻥگ
keay	کی
keber	کﺏﺭ
kebir	کﺏیﺭ
kecheng	کچﻥگ
keck	کک
kedar	کﺩﺭ
kee	کی
keeble	کیﺏﻝ
keebler	کیﺏﻝﺭ
keefe	کیﻑ
keegan	کیگﺍﻥ
keelan	کیﻝﺍﻥ
keele	کیﻝ
keeler	کیﻝﺭ
keen	کیﻥ
keep	کیپ
keeping	کیپیﻥگ
keerthi	کیﺭﺕی
kees	کیﺱ
keesee	کیﺱی
keet	کیﺕ
kehle	کﻝ
kehoe	کیﻩﻭ
kei	کی
keidra	کیﺩﺭﺍ
keifer	کیﻑﺭ
keijo	کیﺝﻭ
keil	کیﻝ
keim	کیﻡ
keinanen	کیﻥﺍﻥﻥ
keinknen	کیﻥکﻥﻥ
keir	کیﺭ
keiron	کیﺭﻭﻥ
keithley	کیﺕﻝی
kelimoff	کﻝیﻡﻭﻑ
kelkar	کﻝکﺍﺭ
kellar	کﻝﺍﺭ
kellen	کﻝﻥ
keller	کیﻝﺭ
kellman	کﻝﻡﻥ
kellner	کﻝﻥﺭ
kellogg	کﻝﺍگ
kelly	کﻝی
keltner	کﻝﺕﻥﺭ
kelvinen	کﻝﻭیﻥﻥ
kemker	کﻡکﺭ
kemp	کﻡپ
kempe	کﻡپ
kemper	کﻡپﺭ
kempster	کﻡپﺍﺱﺕﺭ
ken	کﻥ
kendall	کﻥﺩﺍﻝ
kendi	کﻥﺩی
kendig	کﻥﺩیگ
kendrick	کﻥﺩﺭیک
keng	کﻥگ
kenn	کﻥ
kennaway	کﻥﺍﻭﺍی
kennepohl	کﻥپﻭﻝ
kenner	کﻥﺭ
kenney	کﻥی
kenning	کﻥﻥیﻥگ
kennington	کﻥیﻥگﺕﻭﻥ
kensingto	کﻥﺱیﻥگﺕﻭ
kensiski	کﻥیﺱکی
kenta	کﻥﺕﺍ
kentaro	کﻥﺕﺍﺭﻭ
keny	کﻥی
kenyon	کﻥیﻥ
kenz	کﻥﺯ
keong	کیﻭﻥگ
kephart	کﻑﺍﺭﺕ
kepley	کپﻝی
keppel	کپﻝ
kerbel	کﺭﺏﻝ
keren	کﺭﻥ
kerger	کﺭگﺭ
kerhong	کﺭﻩﺍﻥگ
kerien	کﺭیﻥ
kerila	کﺭیﻝﺍ
kerins	کﺭیﻥﺯ
kermit	کﺭﻡیﺕ
kern	کﺭﻥ
kernie	کﺭﻥﺍی
keromitis	کﺭﻭﻡیﺕﺱ
kerrie	کﺭﺍی
kerrigan	کﺭیگﺍﻥ
kerry	کﺭی
kershner	کﺭﺵﻥﺭ
kerslake	کﺭﺱﻝیک
kert	کﺭﺕ
kerwood	کﺭﻭﺩ
kesavan	کﺱﻭﺍﻥ
kesek	کﺱک
keshav	کﺵﺍﻭ
keshavan	کﺵﺍﻭﺍﻥ
keshlan	کﺵﻝﻥ
keskin	کﺱکیﻥ
kessler	کﺱﻝﺭ
kesson	کﺱﻭﻥ
kesterson	کﺱﺕﺭﺱﻭﻥ
ket	کﺕ
ketan	کﺕﺍﻥ
ketcham	کﺕچﺍﻡ
ketil	کﺕیﻝ
ketley	کﺕﻝی
ketola	کﺕﻭﻝﺍ
kettell	کﺕﻝ
keulen	کﻝﻥ
keven	کﻭﻥ
kevin	کﻭیﻥ
kevran	کﻭﺭﺍﻥ
kevyn	کﻭیﻥ
kewitz	کﻭییﺕﺯ
key	کی
keyne	کیﻥ
keyser	کیﺱﺭ
khai	خﺍی
khalidah	خﺍﻝیﺩﻩ
khan	خﺍﻥ
kheong	کﻭﺍﻥگ
kiat	کیﺍﺕ
kibbe	کیﺏﻩ
kibler	کیﺏﻝﺭ
kibo	کیﺏﻭ
kick	کیک
kid	کیﺩ
kidd	کیﺩ
kiddle	کیﺩﻝ
kief	کیﻑ
kieffer	کیﻑﺭ
kiehl	کیﻩﻝ
kiehne	کیﻥﻩ
kielhorn	کیﻝﻩﻭﺭﻥ
kiely	کیﻝی
kien	کیﻥ
kiera	کیﺭﺍ
kieran	کیﺭﺍﻥ
kieras	کیﺭﺍﺱ
kieth	کیﺕ
kiggins	کیگیﻥﺯ
kight	کﺍیﺕ
kikuma	کیکﻭﻡﺍ
kilbane	کیﻝﺏیﻥ
kilby	کیﻝﺏی
kilg	کیﻝگ
kilgore	کیﻝگﻭﺭ
kille	کیﻝﻩ
killebrew	کیﻝﺏﺭﻭ
killer	کیﻝﺭ
killermet	کیﻝﺭﻡﺕ
killion	کیﻝیﻭﻥ
killpack	کیﻝپک
kills	کیﻝﺯ
kim	کیﻡ
kimball	کیﻡﺏﺍﻝ
kimberey	کیﻡﺏﺭی
kimberly	کیﻡﺏﺭﻝی
kimes	کیﻡﺯ
kimmo	کیﻡﻭ
kimon	کیﻡﻭﻥ
kimppa	کیﻡپﺍ
kimura	کیﻡﻭﺭﺍ
kin	کیﻥ
kina	کیﻥﺍ
kinane	کیﻥﺍﻥ
kinard	کیﻥﺍﺭﺩ
kinchen	کیﻥچﻥ
kingery	کیﻥگﺭی
kingfai	کیﻥگﻑﺍی
kingsford	کیﻥگﺱﻑﻭﺭﺩ
kingston	کیﻥگﺯﺕﻥ
kinkade	کیﻥکیﺩ
kinky	کیﻥی
kinman	کیﻥﻡﻥ
kinnersley	کیﻥﺭﺱﻝی
kinney	کیﻥی
kinns	کیﻥﺯ
kinsell	کیﻥﺱﻝ
kinsella	کیﻥﺱﻝﺍ
kinsey	کیﻥﺯی
kinsman	کیﻥﺯﻡﺍﻥ
kinson	کیﻥﺱﻭﻥ
kint	کیﻥﺕ
kintel	کیﻥﺕﻝ
kinyon	کیﻥیﻭﻥ
kiong	کیﻭﻥگ
kipling	کیپﻝیﻥگ
kipp	کیپ
kirby	کیﺭﺏی
kirill	کﺭیﻝ
kirin	کﺭیﻥ
kirishi	کیﺭیﺵی
kirk	کیﺭک
kiser	کیﺱﺭ
kish	کیﺵ
kislo	کیﺱﻝﻭ
kiss	کیﺱ
kissane	کیﺱیﻥ
kissinger	کیﺱیﻥﺝﺭ
kitaguchi	کیﺕﺍگﻭچی
kitamura	کیﺕﺍﻡﻭﺭﺍ
kitch	کیﺕچ
kitchen	کیچﻥ
kitchin	کیچیﻥ
kitt	کیﺕ
kittel	کیﺕﻝ
kiuchi	کیﻭچی
kivivalli	کیﻭیﻭﺍﻝی
kizer	کیﺯﺭ
klaartje	کﻝﺍﺭﺕ
klammer	کﻝﺍﻡﺭ
klassa	کﻝﺍﺱﺍ
klassen	کﻝﺍﺱﻥ
klatt	کﻝﺍﺕ
klausmeier	کﻝﺍﺱﻡیﺭ
klawiter	کﻝﺍﻭیﺕﺭ
klazura	کﻝﺍژﻭﺭﺍ
klee	کﻝی
kleier	کﻝیﺭ
klein	کﻝیﻥ
kleinsorge	کﻝیﻥﺱﻭﺭگ
klemans	کﻝﻡﺍﻥﺯ
klemmer	کﻝیﻡﺭ
klemp	کﻝﻡپ
klinck	کﻝیﻥک
kline	کﻝیﻥ
klossner	کﻝﺍﺱﻥﺭ
klotz	کﻝﺍﺕﺯ
kloubek	کﻝﻭﺏک
kloukinas	کﻝﻭکیﻥﺍﺱ
klug	کﻝﺍگ
klute	کﻝﻭﺕﻩ
klyber	کﻝیﺏﺭ
knaff	ﻥﺍﻑ
knapp	ﻥپ
knauff	ﻥﺍﻑ
knefel	ﻥﻑﻝ
knel	ﻥﻝ
knepper	کپﺭ
kneusel	ﻥﻭﺱﻝ
knickerbacker	کﻥیکﺭﺏکﺭ
kniffin	ﻥیﻑیﻥ
knight	کیﻥﺕ
knippenberg	ﻥیپﻥﺏﺭگ
knispel	ﻥیﺱپﻝ
knob	کﻥﻭﺏ
knobel	ﻥﻭﺏﻝ
knoefel	ﻥﻭیﻑﻝ
knoell	ﻥﻭیﻝ
knoke	ﻥﺍک
knoll	کﻥﻭﻝ
knop	ﻥﺍپ
knoph	ﻥﺍﻑ
knox	ﻥﻭکﺱ
knufinke	کﻥﻭﻑیﻥکﻩ
knutsen	ﻥﺍﺕﺱﻥ
knutzen	ﻥﻭﺕﺯﻥ
kobb	کﻭﺏ
kobben	کﻭﺏﻥ
koberg	کﺏﺭگ
kobsa	کﻭﺏﺱﺍ
koci	کﺍﺱی
kocian	کﻭﺵیﻥ
kocourek	کﻭکﻭﺭک
koenraad	کﻥﺭﺍﺩ
kogias	کﻭﺝیﺍﺱ
kogoma	کﻭگﻭﻡﺍ
koichi	کﻭیچی
koike	کﻭیک
kokal	کﻭکﺍﻝ
kokenge	کﻭکﻥﺝ
kokkonen	کﻭکﻭﻥﻥ
koktavy	کﻭکﺕﺍﻭﺍی
kolasa	کﻭﻝﺍﺱﺍ
kole	کﻝ
kolen	کﻭﻝﻥ
kolesar	کﻭﻝﺱﺍﺭ
kolichala	کﻭﻝیچﺍﻝﺍ
koliha	کﻭﻝیﻩﺍ
kolkka	کﻭﻝکﺍ
koller	کﺍﻝﺭ
kolluri	کﺍﻝﺭی
kolodney	کﻝﺩﻥی
kolte	کﻭﻝﺕ
koma	کﻡﺍ
komorita	کﻭﻡﻭﺭیﺕﺍ
kompar	کﺍﻡپﺍﺭ
kon	کﻭﻥ
konerding	کﻥﺭﺩیﻥگ
konestabo	کﺍﻥﺱﺕﺍﺏﻭ
kong	کﺍﻥگ
konganda	کﻭگﺍﻥﺩﺍ
konig	کﺍﻥیگ
koning	کﻭﻥیﻥگ
kono	کﻭﻥﻭ
konopka	کﻭﻥﻭپکﺍ
kook	کﻭک
koolen	کﻭﻝﻥ
koolish	کﻭﻝیﺵ
koorapaty	کﻭﺭﺍپﺍﺕی
koosje	کﻭﺯی
koper	کﻭپﺭ
kopp	کﻭپ
koppes	کﻭپﺱ
kordas	کﻭﺭﺩﺍﺱ
kordes	کﻭﺭﺩﺱ
kordic	کﻭﺭﺩیک
korey	کﻭﺭی
kornele	کﻭﺭﻥﻝﻩ
korp	کﻭﺭپ
korsten	کﻭﺭﺱﺕﻥ
korte	کﻭﺭﺕﻩ
kortright	کﻭﺭﺕﺭﺍیﺕ
kory	کﻭﺭی
kosenko	کﻭﺱﻥکﻭ
kosinski	کﺍﺱیﻥﺱکی
koskimaki	کﻭﺱکیﻡﺍکی
koslov	کﻭﺱﻝﻭ
kosmicki	کﺍﺱﻡیچی
kossack	کﻭﺱﺍک
kosta	کﻭﺱﺕﺍ
kostelak	کﺱﺕﻝﺍک
kosten	کﻭﺱﺕﻥ
koster	کﺍﺱﺕﺭ
kostis	کﻭﺱﺕیﺱ
kosuge	کﻭﺱﻭگﻩ
kotara	کﺕﺍﺭﺍ
kotla	کﻭﺕﻝﺍ
kotte	کﺕی
kottmeier	کﻭﺕﻡﺍیﺭ
kou	کﻭ
kouba	کﻭﺏﺍ
koukalik	کﻭکﺍﻝیک
kousky	کﻭﺱکی
kovalcik	کﻭﺍﻝﺱیک
kovar	کﻭﻭﺍﺭ
kovarski	کﻭﺍﺭﺱکی
koven	کﺍﻭﻥ
kowal	کﻭﺍﻝ
kowalik	کﻭیﺍﻝیک
kowalski	کﻭیﺍﻝﺱکی
kowitt	کﻭیﺕ
kozo	کﻭﺯﻭ
kraack	کﺭﺍک
kraaij	کﺭﺍیﺝ
krab	کﺭﺍﺏ
kraig	کﺭﺍیگ
krasen	کﺭﺍﺯﻥ
krasic	کﺭﺍﺱیک
krasner	کﺭﺱﻥﺭ
krasnow	کﺭﺱﻥﻭ
krattiger	کﺭﺍﺕیگﺭ
kratzer	کﺭﺍﺕﺯﺭ
kre	کﺭﻩ
krebser	کﺭﺏﺱﺭ
krech	کﺭچ
kregg	کﺭگ
krelius	ﺭﻝیﻭﺯ
krenn	کﺭﻥ
krenz	کﺭﻥﺯ
kresh	کﺭﺵ
kresna	کﺭﺯﻥﺍ
kress	کﺭﺱ
kresten	کﺭﺱﺕﻥ
kretzer	کﺭﺕﺯﺭ
kreuer	کﺭﻭیﺭ
krey	کﺭی
krieg	کﺭیگ
krieger	کﺭیگﺭ
kriger	کﺭیگﺭ
kriman	کﺭیﻡﻥ
kris	کﺭیﺱ
krishan	کﺭیﺵﺍﻥ
krisje	ﺭیﺱﺝی
krisoijn	ﺭﺱیﻭیﻥ
krissy	کﺭیﺱی
krista	کﺭیﺱﺕﺍ
krister	کﺭیﺱﺕﺭ
kristian	کﺭیﺱﺕیﺍﻥ
kristijntje	ﺭیﺱﺕیﻥﺕﺝی
kristin	کﺭیﺱﺕیﻥ
kristina	کﺭیﺱﺕیﻥﺍ
kristine	کﺭیﺱﺕیﻥ
kristler	کﺭیﺱﺕﻝﺭ
kriston	کﺭیﺱﺕﻭﻥ
kristopher	کﺭیﺱﺕﻭﻑﺭ
kriwonos	کﺭیﻭﻭﻥﻭﺯ
krob	کﺭﻭﺏ
krok	کﺭﻭک
kromann	کﺭﻭﻡﻥ
kromer	کﺭﻭﻡﺭ
kropik	کﺭﻭپیک
kroum	کﺭﻭﻡ
krug	کﺭﻭگ
kruk	کﺭﺍک
krumm	کﺭﻭﻡ
krupp	کﺭﺍپ
kruschen	ﺭﺍﺱچﻥ
kube	کﺍﺏ
kubla	کﻭﺏﻝﺍ
kubo	کﻭﺏﻭ
kucera	کﻭﺱیﺭﺍ
kuchar	کﻭچﺍﺭ
kuchling	کﺍچﻝیﻥگ
kudlacek	کﺍﺩﻝﺍﺱک
kudreikis	کﺍﺩﺭیکیﺱ
kuhlmann	کﺍﻝﻡﻥ
kuin	کﻭیﻥ
kuiper	کﻭیپﺭ
kukulies	کیﻭکیﻭﻝیﺱ
kulbida	کﺍﻝﺏیﺩﺍ
kuldell	کﺍﻝﺩﻝ
kulesh	کﻭﻝﺵ
kullmann	کﺍﻝﻡﻥ
kumar	کیﻭﻡﺭ
kummer	کﺍﻡﺭ
kumoro	کﻭﻡﻭﺭﻭ
kundu	کﺍﻥﺩﻭ
kunst	کﺍﻥﺕ
kupec	کﺍپک
kuper	کﻭپﺭ
kurger	کﺭگﺭ
kurilla	کﻭﺭیﻝﺍ
kurke	کﺭک
kursun	کﻭﺭﺱﻥ
kurt	کﺍﺭﺕ
kusack	کﺍﺱﺍک
kushay	کﻭﺵﺍی
kushnir	کﺍﺵﻥیﺭ
kusterman	کﻭﺱﺕﺭﻡﻥ
kusumoto	کیﻭﺱﻡﺍﺕﻭ
kutz	کﻭﺕﺯ
kuwayt	کﻭیﺕ
kuyper	کﺍیپﺭ
kwa	کﻭﺍ
kwan	کﻭﺍﻥ
kwang	کﻭﺍﻥگ
kwast	کﻭﺍﺱﺕ
kwong	کﻭﺍﻥگ
kyle	کﺍیﻝ
kyrus	کﺍیﺭﺍﺱ
kyte	کﺍیﺕ
laakso	ﻝﺍکﺱﻭ
laan	ﻝﺍﻥ
labatt	ﻝﺍﺏﺍﺕ
labdon	ﺍﻝﺏﻭﻥ
labella	ﻝﺍﺏﻝﺍ
labelle	ﻝﺍﺏﻝ
laberge	ﻝیﺏﺭگ
labore	ﻝﺏﻭﺭ
labrinidis	ﻝﺏﺭیﻥیﺩیﺱ
labriola	ﻝﺍﺏﺭیﻭﻝﺍ
labroad	ﻝﺍﺏﺭﺍﺩ
lacelle	ﻝﺍکﻝﻩ
lachance	ﻝﺍچﻥﺱ
lachlan	ﻝﺍچﻝﻥ
lachman	ﻝچﻡﻥ
lackey	ﻝﺍکی
lacoste	ﻝکﻭﺱﺕ
lacouture	ﻝﺍکﻭﺕﻭﺭﻩ
lacross	ﻝکﺭﻭﺱ
lacy	ﻝیﺱی
ladak	ﻝﺩک
ladasky	ﻝﺍﺩﺍﺱکی
lade	ﻝیﺩ
lademann	ﻝیﺩﻡﺍﻥ
laderoute	ﻝﺍﺩﺭﻭﺕ
ladeuil	ﻝﺍﺩیﻭیﻝ
ladic	ﻝﺍﺩیک
ladonne	ﻝﺍﺩﻭﻥ
ladwig	ﻝﺍﺩﻭیگ
laffey	ﻝﺍﻑی
lafountaine	ﻝﺍﻑﺍﻭﻥﺕیﻥ
lafourcade	ﻝﺍﻑﻭﺭکﺍﺩ
lagerberg	ﻝﺍﺝﺭﺏﺭگ
lagerling	ﻝﺍگﺭﻝیﻥگ
lagerstrom	ﻝﺍگﺭﺵﺕﺭﻭﻡ
lagomorph	ﻝﺍگﻭﻡﻭﺭﻭﻑ
lagoon	ﻝﺍگﻭﻥ
lahelma	ﻝﺍﻩﻝﻡﺍ
lahij	ﻝﺍﻩیﺝ
lai	ﻝﺍی
laiho	ﻝﺍیﻩﻭ
laine	ﻝیﻥ
laing	ﻝﺍیﻥگ
laird	ﻝﺍیﺭﺩ
lakesha	ﻝﺍکیﺵﺍ
lakewood	ﻝﺍکﻭﻭﺩ
laky	ﻝﺍکﺍی
lal	ﻝﺍﻝ
lalit	ﻝﺍﻝیﺕ
laly	ﻝﺍﻝی
lam	ﻝﺍﻡ
lamark	ﻝﺍﻡﺍﺭک
lamastus	ﻝﺍﻡﺍﺱﺕﻭﺱ
lambda	ﻝﺍﻡﺏﺩﺍ
lambert	ﻝﺍﻡﺏﺭﺕ
lamboley	ﻝﺍﻡﺏﻭﻝی
lamborn	ﻝﺍﻡﺏﺭﻥ
lambourne	ﻝﺍﻡﺏﻭﺭﻥ
lambros	ﻝﺍﻡﺏﺭﻭﺱ
lamers	ﻝﻡﺭﺯ
lamm	ﻝﺍﻡ
lammers	ﻝﺍﻡﺭﺱ
lamorce	ﻝﺍﻡﻭﺭﺱ
lamp	ﻝﻡپ
lampen	ﻝﺍﻡپﻥ
lampi	ﻝﺍﻡپی
lamping	ﻝﻡپیﻥگ
lampitt	ﻝﺍﻡپیﺕ
lamplight	ﻝﺍﻡپﻝﺍیﺕ
lamykin	ﻝﺍﻡیکیﻥ
lan	ﻝﺍﻥ
lana	ﻝﺍﻥﺍ
lance	ﻝﺍﻥﺱ
lancetes	ﻝﺍﻥﺱﺕﺯ
lancing	ﻝﺍﻥﺱیﻥگ
land	ﻝﺍﻥﺩ
landahl	ﻝﻥﺩﺍﻩﻝ
landauer	ﻝﺍﻥﺩﺍیﺭ
landers	ﻝﺍﻥﺩﺭﺯ
landi	ﻝﻥﺩی
landin	ﻝﺍﻥﺩیﻥ
landis	ﻝﺍﻥﺩیﺱ
landman	ﻝﺍﻥﺩﻡﻥ
landon	ﻝﺍﻥﺩﻥ
landrum	ﻝﺍﻥﺩﺭﻭﻡ
landry	ﻝﺍﻥﺩﺭی
lands	ﻝﻥﺩﺯ
lanett	ﻝﺍﻥﺕ
lanetta	ﻝﺍﻥﺕﺍ
langdon	ﻝﺍﻥگﺩﻭﻥ
lange	ﻝﺍﻥژ
langley	ﻝﺍﻥگﻝی
langmaid	ﻝﻥگﻡیﺩ
langmead	ﻝﻥگﻡیﺩ
langnes	ﻝﺍﻥگﻥﺯ
langseth	ﻝﻥگﺱث
langston	ﻝﺍﻥگﺱﺕﻭﻥ
lani	ﻝﺍﻥی
lanka	ﻝﺍﻥکﺍ
lankton	ﻝﺍﻥکﺕﻭﻥ
lann	ﻝﺍﻥ
lanner	ﻝﺍﻥﺭ
lannie	ﻝﺍﻥی
lannom	ﻝﺍﻥﻭﻡ
lanson	ﻝﻥﺱﻭﻥ
lanterman	ﻝﺍﻥﺕﺭﻡﺍﻥ
lantlosamade	ﻝﺍﻥﺕﻝﻭﺱﺍﻡﺍﺩ
lantz	ﻝﺍﻥﺕﺯ
lanusse	ﻝﺍﻥﻭﺱی
lao	ﻝﺍیﻭ
lap	ﻝپ
lapaso	ﻝﺍپﺍﺱﻭ
lapham	ﻝﺍﻑﺍﻡ
lapidary	ﻝﺍپیﺩﺍﺭی
laplaine	ﻝﺍپﻝﺍیﻥ
laporta	ﻝپﻭﺭﺕﺍ
laputa	ﻝﺍپﻭﺕﺍ
lapworth	ﻝپﻭﺭث
lara	ﻝﺍﺭﺍ
laralee	ﻝﺍﺭﺍﻝی
lareef	ﻝﺍﺭیﻑ
larga	ﻝﺍﺭﺝﺍ
large	ﻝﺍﺭژ
larissa	ﻝﺍﺭیﺱﺍ
lariviere	ﻝﺍﺭیﻭیﺭ
laroche	ﻝﺍﺭﻭچ
larocque	ﻝﺍﺭﻭکﻭیﻩ
larren	ﻝﺍﺭﻥ
larson	ﻝﺍﺭﺱﻥ
larter	ﻝﺍﺭﺕﺭ
larue	ﻝﺍﺭﻭ
larurel	ﻝﺍﺭﻭﺭﻝ
las	ﻝﺍﺱ
lascala	ﻝﺍﺱکﺍﻝﺍ
lascari	ﻝﺍﺱکﺍﺭی
laser	ﻝیﺯﺭ
lash	ﻝﺍﺵ
lashley	ﻝﺵﻝی
laska	ﻝﺍﺱکﺍ
laskos	ﻝﺍﺱکﻭﺱ
lasnik	ﻝﺍﺱﻥیک
last	ﻝﺍﺱﺕ
lastra	ﻝﺍﺱﺕﺭﺍ
latala	ﻝﺍﺕﺍﻝﺍ
latham	ﻝﺍﺕﺍﻡ
lathbury	ﻝﺍﺕﺏﺭی
latta	ﻝﺍﺕﺍ
lau	ﻝی
lauener	ﻝﺍﻥﺭ
laura	ﻝﻭﺭﺍ
laurent	ﻝﻭﺭﻥﺕ
lauritsen	ﻝﺍیﻭﺭیﺕﺱﻥ
laursen	ﻝﺍﺭﺱﻥ
lauverjat	ﻝﻭﻭﺭﺝﺍﺕ
lauzac	ﻝﺍﻭﺯﺍک
lavalie	ﻝﻭﺍﻝﺍی
lavigne	ﻝﺍﻭیگﻥﻩ
lavonius	ﻝﺍﻭﻥیﻭﺱ
law	ﻝﺍﻭ
lawande	ﻝﺍﻭﺍﻥﺩﻩ
lawless	ﻝﺍﻝﺱ
lawrance	ﻝﺍﺭﻥﺱ
lawrence	ﻝﺍﺭﻥﺱ
lawrie	ﻝﺍﻭﺭﺍی
lawton	ﻝﺍﻭﺕﻥ
lax	ﻝکﺱ
lazara	ﻝﺍﺯﺍﺭﺍ
lazard	ﻝﺍﺯﺍﺭﺩ
lazzaro	ﻝﺍﺯﺍﺭﻭ
lea	ﻝی
leach	ﻝیچ
leahy	ﻝیﻩی
leair	ﻝیﺭ
leake	ﻝیک
leas	ﻝیﺱ
leason	ﻝیﺱﻥ
leatherock	ﻝیﺩﺭﺍک
lebed	ﻝیﺏیﺩ
lebel	ﻝیﺏﻝ
leben	ﻝﺏﻥ
lebon	ﻝﺏﻭﻥ
lebrun	ﻝیﺏﺭﻥ
lechelle	ﻝچﻝﻩ
lechmere	ﻝچﻡﺭ
lechner	ﻝچﻥﺭ
leckie	ﻝکی
lecomber	ﻝکﺍﻡﺏﺭ
lecren	ﻝکﺭﻥ
lection	ﻝکﺵﻥ
ledford	ﻝﺩﻑﻭﺭﺩ
ledge	ﻝﺝ
ledwidge	ﻝﺩﻭﺍیﺩﺝ
lee	ﻝی
leeder	ﻝیﺩﺭ
leelynde	ﻝیﻝیﻥﺩ
leeuw	ﻝیﻭ
lefaive	ﻝیﻑﺍیﻭ
leff	ﻝﻑ
leffler	ﻝﻑﻝﺭ
legg	ﻝگ
lehan	ﻝﻩﺍﻥ
lehle	ﻝﻩﻝﻩ
lehman	ﻝﻩﻡﺍﻥ
lehmann	ﻝﻩﻡﺍﻥ
lehne	ﻝیﻥ
lehnerer	ﻝﻩﻥﺭﺭ
lehnert	ﻝﻥﺭﺕ
lehrian	ﻝﻩﺭیﺍﻥ
lei	ﻝی
leibowitz	ﻝیﺏﻭیﺕﺯ
leiderdorp	ﻝیﺩﺭﺩﺭپ
leighton	ﻝیﺕﻭﻥ
leila	ﻝیﻝﺍ
leinonen	ﻝیﻥﻭﻥﻥ
lemer	ﻝﻡیﺭ
lemon	ﻝﻡﻭﻥ
lence	ﻝﻥﺱ
lendino	ﻝﻥﺩیﻥﻭ
lendl	ﻝیﻥﺩﻝ
lendvai	ﻝﻥﺩﻭﺍی
lengeling	ﻝﻥگﻝیﻥگ
lenkei	ﻝﻥکی
lennon	ﻝیﻥﺍﻥ
lentin	ﻝﻥﺕیﻥ
leon	ﻝیﻭﻥ
leonard	ﻝیﻭﻥﺍﺭﺩ
leonardo	ﻝیﻭﻥﺍﺭﺩﻭ
leonora	ﻝیﻥﻭﺭﺍ
lepage	ﻝیپیﺝ
lepard	ﻝپﺍﺭﺩ
leppart	ﻝپﺍﺭﺕ
leppla	ﻝپﻝﺍ
lerbs	ﻝﺭﺏﺯ
lerman	ﻝﺭﻡﻥ
lerup	ﻝﺭﺍپ
lesesne	ﻝیﺱیﻥ
lesher	ﻝﺵﺭ
lesht	ﻝﺵﺕ
lesiak	ﻝﺱیﺍک
lesion	ﻝیﺯﻥ
lessard	ﻝﺱﺍﺭﺩ
lesser	ﻝﺱﺭ
leto	ﻝیﺕﻭ
levavy	ﻝیﻭیﻭی
levey	ﻝﻭی
levi	ﻝﻭی
levine	ﻝیﻭیﻥ
levinson	ﻝﻭیﻥﺱﻭﻥ
leviseur	ﻝﻭیﺱیﻭﺭ
lewendon	ﻝیﻭﺍﻥﺩﻥ
lewin	ﻝﻭیﻥ
lewis	ﻝیﻭیﺱ
ley	ﻝی
leybourne	ﻝیﺏﻭﺭﻥ
leyden	ﻝیﺩﻥ
leythen	ﻝیﺕﻥ
leyton	ﻝیﺕﻭﻥ
liam	ﻝیﺍﻡ
lian	ﻝﺍیﺍﻥ
lianez	ﻝیﺍﻥﺯ
liang	ﻝیﺍﻥگ
liao	ﻝیﺍﻭ
liau	ﻝیﻭ
libannord	ﻝیﺏﺍﻥﻥﺭﺩ
libbey	ﻝیﺏی
liberchuk	ﻝیﺏﺭچﺍک
liberty	ﻝیﺏﺭﺕی
libes	ﻝﺍیﺏﺯ
liblit	ﻝیﺏﻝیﺕ
librik	ﻝیﺏﺭیک
licharson	ﻝیچﺍﺭﺱﻭﻥ
lichorowic	ﻝیچﻭﺭﻭییﺱ
lichten	ﻝیچﺕﻥ
lidal	ﻝیﺩﺍﻝ
lidor	ﻝیﺩﻭﺭ
lidwina	ﻝیﺩﻭیﻥﺍ
lie	ﻝی
liebchen	ﻝیﺏچﻥ
liebman	ﻝیﺏﻡﻥ
liebson	ﻝیﺏﺱﻥ
lien	ﻝیﻥ
lier	ﻝیﺭ
lieuwe	ﻝییﻭﻭﻩ
liewe	ﻝیﻭ
liggio	ﻝیگیﻭ
lightburn	ﻝﺍیﺕﺏﺭﻥ
lightman	ﻝﺍیﺕﻡﻥ
lightning	ﻝﺍیﺕﻥیﻥگ
ligne	ﻝﺍیﻥ
likes	ﻝﺍیکﺯ
lila	ﻝیﻝﺍ
lilback	ﻝیﻝﺏک
lilienthal	ﻝیﻝیﻥﺕﺍﻝ
lilley	ﻝیﻝی
lilli	ﻝیﻝی
lim	ﻝیﻡ
limace	ﻝﺍیﻡﺍک
limb	ﻝﺍیﻡﺏ
limbach	ﻝیﻡﺏﺍخ
limburg	ﻝیﻡﺏﻭﺭگ
liming	ﻝیﻡیﻥگ
limmer	ﻝیﻡﺭ
lin	ﻝیﻥ
linares	ﻝیﻥﺍﺭﺱ
lincke	ﻝیﻥکﻩ
lincoln	ﻝیﻥکﻝﻥ
lind	ﻝیﻥﺩ
lindal	ﻝیﻥﺩﺍﻝ
lindback	ﻝیﻥﺩﺏک
lindberg	ﻝیﻥﺩﺏﺭگ
linde	ﻝیﻥﺩ
lindemann	ﻝیﻥﺩﻡﻥ
linden	ﻝیﻥﺩﻥ
lindenmuth	ﻝیﻥﺩﻥﻡﻭﺕ
linder	ﻝیﻥﺩﺭ
linderman	ﻝیﻥﺩﺭﻡﻥ
lindgard	ﻝیﻥﺩگﺍﺭﺩ
lindgren	ﻝیﻥﺩگﺭﻥ
lindholm	ﻝیﻥﺩﻩﻝﻡ
lindman	ﻝیﻥﺩﻡﻥ
lindroth	ﻝیﻥﺩﺭﻭﺕﺱ
lindsey	ﻝیﻥﺩﺯی
lindvall	ﻝیﻥﻭﺍﻝ
linehan	ﻝیﻥﻩﺍﻥ
lingley	ﻝیﻥگﻝی
lingus	ﻝیﻥگﺍﺱ
link	ﻝیﻥک
linkous	ﻝیﻥکﻭیﺱ
linstruth	ﻝیﻥﺱﺕﺭﺍﺕ
lionel	ﻝیﻭﻥﻝ
lions	ﻝیﻭﻥﺯ
liow	ﻝیﻭ
lipkin	ﻝیپکیﻥ
lippard	ﻝیپﺍﺭﺩ
lipscombe	ﻝیپﺱکﺍﻡﺏ
lipset	ﻝیپﺱﺕ
liquori	ﻝیکیﻭﺭی
liren	ﻝیﺭﻥ
lisa	ﻝیﺯﺍ
liscano	ﻝیﺱکﺍﻥﻭ
lisken	ﻝیﺱکﻥ
liskey	ﻝیﺱکی
lison	ﻝیﺱﻭﻥ
lissa	ﻝیﺯﺍ
lisson	ﻝیﺱﻭﻥ
lister	ﻝیﺱﺕﺭ
liston	ﻝیﺱﺕﻭﻥ
litchfield	ﻝیچﻑیﻝﺩ
litel	ﻝیﺕﻝ
litt	ﻝیﺕ
littleton	ﻝیﺕﻝﺕﻭﻥ
littmann	ﻝیﺕﻡﻥ
littrell	ﻝیﺕﺭﻝ
litvin	ﻝیﺕﻭیﻥ
lively	ﻝﺍیﻭﻝی
livengood	ﻝیﻭﻥگﻭﺩ
livesay	ﻝﺍیﻭﺱﺍی
livian	ﻝیﻭیﻥ
livingston	ﻝیﻭیﻥگﺱﺕﻭﻥ
liviu	ﻝیﻭیﻭ
livius	ﻝیﻭیﻭﺱ
liz	ﻝیﺯ
lizard	ﻝیﺯﺍﺭﺩ
lizards	ﻝیﺯﺍﺭﺩﺯ
lizotte	ﻝیﺯﻭﺕ
loarie	ﻝﻭﺭی
loats	ﻝﻭﺍﺕﺱ
lobb	ﻝﺍﺏ
lobo	ﻝﻭﺏﻭ
lobser	ﻝﺍﺏﺱﺭ
loc	ﻝﺍک
loch	ﻝﻭچ
lock	ﻝﺍک
lockard	ﻝﻭکﺍﺭﺩ
locke	ﻝﺍک
locker	ﻝﺍکﺭ
lockshin	ﻝﺍکﺵیﻥ
loco	ﻝﻭکﻭ
lodder	ﻝﺍﺩﺭ
lodewijk	ﻝﺩﻭیک
lodge	ﻝﺍﺝ
lodman	ﻝﻭﺩﻡﻥ
lofaro	ﻝﻭﻑﺍﺭﻭ
lofaso	ﻝﻭﻑﺍﺱﻭ
lofgren	ﻝﺍﻑگﺭیﻥ
lofstrom	ﻝﻭﻑﺱﺕﺭﻭﻡ
loftus	ﻝﻑﺕﻭﺱ
logendra	ﻝﻭگﻥﺩﺭﺍ
loges	ﻝﻭگﺯ
logic	ﻝﻭﺝیک
lohrentz	ﻝﻩﺭﻥﺕﺯ
loiselle	ﻝﻭییﺱﺍﻝی
loizzo	ﻝﻭییﺯﻭ
lok	ﻝﻭک
loke	ﻝﻭک
loken	ﻝﻭکﻥ
lomas	ﻝﻭﻡﺍﺱ
lombard	ﻝﺍﻡﺏﺍﺭﺩ
lombardo	ﻝﺍﻡﺏﺍﺭﺩﻭ
lommel	ﻝﻭﻡﻝ
lon	ﻝﺍﻥ
londre	ﻝﺍﻥﺩﺭ
lonely	ﻝﻭﻥﻝی
lones	ﻝﻭﻥﺯ
loney	ﻝﻭﻥی
long	ﻝﺍﻥگ
longshaw	ﻝﺍﻥگﺵﺍ
longstaff	ﻝﺍﻥکﺱﺕﺍﻑ
longyear	ﻝﺍﻥگیﺭ
lonkart	ﻝﺍﻥکﺍﺭﺕ
lonn	ﻝﻭﻥ
lonnemo	ﻝﻭﻥﻡﻭ
lonnie	ﻝﻭﻥی
lonningdal	ﻝﻭﻥیﻥگﺩﺍﻝ
lonon	ﻝﻭﻥﺍﻥ
lonsdale	ﻝﺍﻥﺱﺩیﻝ
loo	ﻝﻭ
loofburrow	ﻝﻭﻑﺏﺍﺭﻭ
look	ﻝﻭک
loop	ﻝﻭپ
loosmore	ﻝﻭﺱﻡﻭﺭ
lopez	ﻝﻭپﺯ
lopp	ﻝﺍپ
lopresti	ﻝﻭپﺭﺱﺕی
lora	ﻝﻭﺭﺍ
lorch	ﻝﻭﺭچ
lord	ﻝﺭﺩ
loreena	ﻝﻭﺭﻥﺍ
loren	ﻝﻭﺭﻥ
lorentzen	ﻝﻭﺭﻥﺕﺯﻥ
lorenz	ﻝﻭﺭﻥﺯ
lorenzen	ﻝﻭﺭﻥﺯﻥ
lorenzi	ﻝﻭﺭﻥﺯی
lorenzo	ﻝﻭﺭﻥﺯﻭ
loreti	ﻝﻭﺭﺕی
lorgio	ﻝﻭﺭﺝیﻭ
lori	ﻝﻭﺭی
lorton	ﻝﻭﺭﺕﻭﻥ
lory	ﻝﻭﺭی
los	ﻝﻭﺱ
losantos	ﻝﻭﺱﺍﻥﺕﻭﺱ
losecco	ﻝﻭﺱﺱکﻭ
losinger	ﻝﺍﺱیﻥگﺭ
losito	ﻝﻭﺱیﺕﻭ
loss	ﻝﺍﺱ
losset	ﻝﻭﺱﺕ
lotempio	ﻝﻭﺕﻡپیﻭ
lotridge	ﻝﺕﺭیﺝ
lott	ﻝﺍﺕ
louboutin	ﻝﻭﺏﻭﺕیﻥ
loud	ﻝﺍﻭﺩ
loughe	ﻝﻭگﻩ
lounsbery	ﻝیﻭﻥﺱﺏﺭی
louvet	ﻝﻭﻭﺕ
loveman	ﻝﺍﻭﻡﻥ
lovera	ﻝﻭﻭﺭﺍ
lovitt	ﻝﺍﻭیﺕ
lovstad	ﻝﺍﻭﺱﺕﺍﺩ
low	ﻝﻭ
lowman	ﻝﻭﻡﻥ
lownie	ﻝﻭﻥی
loyd	ﻝﻭیﺩ
lozano	ﻝﻭﺯﺍﻥﻭ
lozier	ﻝﻭﺯیﺭ
lubin	ﻝﺍﺏیﻥ
lubkin	ﻝﺍﺏکیﻥ
lucas	ﻝﻭکﺍﺱ
luce	ﻝﺍک
lucero	ﻝﻭﺱﺭﻭ
lucey	ﻝﻭﺱی
luchini	ﻝﺍچیﻥی
lucie	ﻝﻭﺱی
lucy	ﻝﺍکی
ludorf	ﻝﻭﺩﻭﺭﻑ
ludovica	ﻝﺍﺩﻭﻭیکﺍ
ludovicus	ﺍیﺩﻭﺍیﺱﻭﺯ
luinge	ﻝﻭییﻥگ
luk	ﻝﻭک
luke	ﻝﻭک
lukes	ﻝﻭکﺱ
lukka	ﻝﻭکﺍ
lulkin	ﻝﺍﻝکیﻥ
lum	ﻝﻭﻡ
lumbley	ﻝﺍﻡﺏﻝی
lunau	ﻝﻭﻥﺍﻭ
lund	ﻝﺍﻥﺩ
lundager	ﻝﺍﻥﺩﺍگﺭ
lundberg	ﻝﺍﻥﺩﺏﺭگ
lundeen	ﻝﺍﻥﺩیﻥ
lundell	ﻝﺍﻥﺩﻝ
lundgren	ﻝﺍﻥﺩگﺭیﻥ
lundquist	ﻝﺍﻥﺩکﻭییﺱﺕ
lundstrom	ﻝﺍﻥﺩﺍﺱﺕﺭﻭﻡ
lung	ﻝﺍﻥگ
lungu	ﻝﺍﻥگﻭ
lunsford	ﻝﺍﻥﺱﻑﺭﺩ
luntz	ﻝﺍﻥﺕﺯ
lunz	ﻝﻭﻥﺯ
lupatkin	ﻝﻭپﺍﺕکیﻥ
luper	ﻝﻭپﺭ
lupher	ﻝﻭﻑﺭ
lupien	ﻝﻭپیﻥ
luppescu	ﻝﺍپیﺱکﻭ
lurie	ﻝﻭﺭی
lusk	ﻝﺍﺱک
luster	ﻝﺍﺱﺕﺭ
lustig	ﻝﺍﺱﺕیﻥگ
lustri	ﻝﺍﺱﺕﺭی
lusty	ﻝﻭﺱﺕی
luther	ﻝﻭﺕﺭ
lutins	ﻝﻭﺕیﻥﺯ
lutkins	ﻝﺍﺕکیﻥﺯ
luttbeg	ﻝﻭﺕﺏگ
lutz	ﻝﺍﺕﺯ
luxton	ﻝﻭکﺱﺕﻭﻥ
lydea	ﻝیﺩیﺍ
lydia	ﻝیﺩیﺍ
lye	ﻝﺍی
lyell	ﻝییﻝ
lylah	ﻝیﻝﺍ
lyle	ﻝﺍیﻝ
lymn	ﻝیﻡﻥ
lyn	ﻝیﻥ
lyndel	ﻝیﻥﺩﻝ
lyndon	ﻝیﻥﺩﺍﻥ
lynds	ﻝیﻥﺩﺯ
lynn	ﻝیﻥ
lynne	ﻝیﻥ
lyric	ﻝیﺭیک
lyrical	ﻝیﺭیکﺍﻝ
lysbethje	ﻝیﺯﺏﺕی
lytle	ﻝیﺕﻝی
lyubovny	ﻝیﻭﺏﻭﻥی
mabanag	ﻡﺍﺏﺍﻥﺍگ
mac	ﻡک
macaraeg	ﻡﺍکﺍﺭﺍیگ
macauley	ﻡﺍکﺍیﻭﻝی
macdonald	ﻡکﺩﻭﻝﻥﺩ
macek	ﻡﺍکک
macfarlane	ﻡکﻑﺍﺭﻝیﻥ
macgowan	ﻡکگﻭﻭﺍﻥ
mach	ﻡﺍخ
machine	ﻡﺍﺵیﻥ
machteld	ﻡچﺕﻝﺩ
maciek	ﻡﺍﺱیک
macisaac	ﻡﺍکیﺱﺍک
mack	ﻡک
mackay	ﻡکﻭی
mackerras	ﻡﺍکیﺭﺍﺱ
mackinnon	ﻡﺍکیﻥﻭﻥ
macko	ﻡﺍکﻭ
macky	ﻡکی
maclachlan	ﻡیکﻝﺍچﻝﻥ
maclaren	ﻡکﻝﺍﺭﻥ
maclaughlin	ﻡکﻝﺍگﻝیﻥ
maclean	ﻡکﻝیﻥ
macmahon	ﻡکﻡﺍﻩﻭﻥ
macmillan	ﻡکﻡیﻝﺍﻥ
macneil	ﻡکﻥیﻝ
macomber	ﻡﺍکﻭﻡﺏﺭ
maconochie	ﻡﺍکﻭﻥﻭچی
macra	ﻡکﺭﺍ
macrae	ﻡکﺭﺍی
macready	ﻡکﺭﺩی
macris	ﻡکﺭیﺱ
macrone	ﻡکﺭﻭﻥ
macsen	ﻡکﺱﻥ
mactavish	ﻡکﺕﺍﻭیﺵ
macucci	ﻡﺍکﻭﺱی
macvoy	ﻡکﻭی
madaba	ﻡﺍﺩﺍﺏﺍ
madah	ﻡﺩﻩ
madden	ﻡﺍﺩﻥ
maddi	ﻡﺍﺩی
maddineni	ﻡﺩیﻥﻥی
maddison	ﻡﺩیﺱﻭﻥ
maddux	ﻡﺍﺩﺍکﺱ
madej	ﻡﺍﺩﺝ
madeleine	ﻡﺍﺩﻝیﻥ
madeline	ﻡﺍﺩﻝیﻥ
madelyn	ﻡﺍﺩﻝیﻥ
madeo	ﻡﺍﺩیﻭ
mader	ﻡیﺩﺭ
maderer	ﻡﺩﺭﺭ
madigan	ﻡﺍﺩیگﺍﻥ
madinat	ﻡﺩیﻥﺕ
madis	ﻡﺍﺩیﺱ
madison	ﻡﺍﺩیﺱﻭﻥ
madon	ﻡﺍﺩﻭﻥ
madrone	ﻡﺍﺩﺭﻭﻥ
mads	ﻡﺩﺱ
madsen	ﻡﺍﺩﺱﻥ
madurai	ﻡﺍﺩﻭﺭﺍی
maffray	ﻡﺍﻑﺭی
mafraq	ﻡﻑﺭک
magagna	ﻡﺍگﺍگﻥﺍ
magda	ﻡگﺩﺍ
magdaleentje	ﻡکﺩﺍﻝﻥ
magee	ﻡگی
mager	ﻡیگﺭ
magesh	ﻡگیﺵ
maggard	ﻡﺍگﺍﺭﺩ
maggi	ﻡگی
maggie	ﻡگی
maggio	ﻡگیﻭ
maggs	ﻡﺍگﺱ
magic	ﻡژیک
magical	ﻡﺝیکﺍﻝ
magill	ﻡﺍگیﻝ
maginel	ﻡگیﻥﻝ
magion	ﻡژیﻭﻥ
magliaro	ﻡﺍگﻝیﺭﻭ
maglott	ﻡگﻝﺍﺕ
magnan	ﻡگﻥﺍﻥ
magne	ﻡگﻥی
magnuson	ﻡگﻥﺍﺱﻥ
magruder	ﻡﺍگﺭﻭﺩﺭ
maguire	ﻡﺍگﻭیﺭ
mah	ﻡﻩ
maha	ﻡﺍﻩﺍ
mahadevan	ﻡﺍﻩﺍﺩﻭﺍﻥ
mahajan	ﻡﺍﻩﺍﺝﺍﻥ
mahaly	ﻡﺍﻩﺍﻝی
mahault	ﻡﺍﻩﺍﻝﺕ
mahrah	ﻡﺡﺭﺍﻩ
mahto	ﻡﺍﻩﺕﻭ
mahwit	ﻡﺡﻭیط
mai	ﻡی
maimone	ﻡﺍیﻡﻭﻥ
main	ﻡیﻥ
maine	ﻡیﻥ
mains	ﻡیﻥﺯ
mainwaring	ﻡیﻥﻭﺍﺭیﻥگ
mair	ﻡیﺭ
maison	ﻡیﺯﻭﻥ
maitawa	ﻡیﺕﺍﻭﺍ
maj	ﻡﺝ
majdal	ﻡﺝﺩﻝ
majee	ﻡﺍﺝی
majere	ﻡیﺝﺭی
majid	ﻡﺝیﺩ
majoe	ﻡﺍﺝﻭ
mak	ﻡک
makil	ﻡکیﻝ
makoto	ﻡکﻭﺕﻭ
makuch	ﻡکﻭچ
malamood	ﻡﺍﻝﺍﻡﻭﺩ
malan	ﻡﺍﻝﺍﻥ
malay	ﻡﻝی
malberg	ﻡﺍﻝﺏﺭگ
malcolm	ﻡﺍﻝکﻭﻡ
malde	ﻡﺍﻝﺩ
malibu	ﻡﻝیﺏﻭ
malini	ﻡﻝیﻥی
mallchok	ﻡﺍﻝکﻭک
mallick	ﻡﺍﻝیک
malnar	ﻡﺍﻝﻥﺭ
malone	ﻡﺍﻝﻥ
malpartida	ﻡﺍپﺍﺭﺕیﺩﺍ
malte	ﻡﻝﺕﻩ
maltin	ﻡﺍﻝﺕیﻥ
mama	ﻡﺍﻡﺍ
mame	ﻡﻡﻩ
mammen	ﻡﺍﻡﻥ
mamta	ﻡﻡﺕﺍ
mana	ﻡﺍﻥﺍ
manager	ﻡﻥیﺝﺭ
manama	ﻡﺍﻥﺍﻡﺍ
manber	ﻡﺍﻥﺏﺭ
manca	ﻡﺍﻥکﺍ
mancus	ﻡﺍﻥکﻭﺱ
mancuso	ﻡﻥکیﻭﺱ
manda	ﻡﺍﻥﺩﺍ
mandal	ﻡﺍﻥﺩﺍﻝ
mandar	ﻡﺍﻥﺩﺭ
mandaville	ﻡﺍﻥﺩﺍﻭیﻝ
mandel	ﻡﺍﻥﺩﻝ
mandible	ﻡﻥﺩیﺏﻝ
mandl	ﻡﻥﺩﻝ
mandle	ﻡﻥﺩﻝ
mandy	ﻡﻥﺩی
mane	ﻡﻥﻩ
manetta	ﻡﺍﻥﺕﺍ
manfull	ﻡﻥﻑﻭﻝ
mangan	ﻡﺍﻥگﺍﻥ
mangin	ﻡﺍﻥگیﻥ
mangione	ﻡﻥﺝیﻭﻥ
manglani	ﻡﺍﻥگﻝﺍﻥی
mangus	ﻡﻥگﺱ
mani	ﻡﺍﻥی
manija	ﻡﺍﻥیﺝﺍ
manin	ﻡﻥیﻥ
manish	ﻡﺍﻥیﺵ
maniskas	ﻡﺍﻥیﺱکﺍﺱ
manith	ﻡﺍﻥیﺕ
manjeet	ﻡﺍﻥﺝیﺕ
manjit	ﻡﺍﻥﺝیﺕ
manley	ﻡﺍﻥﻝی
mann	ﻡﺍﻥ
manna	ﻡﺍﻥﺍ
manning	ﻡﺍﻥیﻥگ
mannix	ﻡﺍﻥیکﺱ
manno	ﻡﺍﻥﻭ
manns	ﻡﺍﻥﺯ
manny	ﻡﻥی
mano	ﻡﺍﻥﻭ
manoli	ﻡﺍﻥﻭﻝی
manolo	ﻡﺍﻥﻭﻝی
manoury	ﻡﺍﻥﻭﺭی
mansa	ﻡﻥﺱﺍ
manson	ﻡﺍﻥﺱﻥ
mansoor	ﻡﻥﺹﻭﺭ
mansour	ﻡﻥﺹﻭﺭ
mansur	ﻡﻥﺹﻭﺭ
mansuri	ﻡﻥﺹﻭﺭی
mantey	ﻡﺍﻥﺕی
manti	ﻡﻥﺕی
mantle	ﻡﺍﻥﺕﻝ
mantor	ﻡﺍﻥﺕﻭﺭ
mantsinen	ﻡﻥﺕﺱیﻥﻥ
manu	ﻡﺍﻥیﻭ
many	ﻡﻥی
mao	ﻡﺍﻭ
maohai	ﻡﺍیﻭﻩﺍی
maple	ﻡپﻝ
maples	ﻡﺍپﻝﺯ
mapple	ﻡپﻝ
maqsood	ﻡﻕﺹﻭﺩ
mar	ﻡﺍﺭ
maranda	ﻡﺭﻥﺩﺍ
marani	ﻡﺍﺭﺍﻥی
marat	ﻡﺍﺭﺍﺕ
marazas	ﻡﺍﺭﺍﺯﺍﺱ
marbach	ﻡﺍﺭﺏﺍچ
marble	ﻡﺍﺭﺏﻝ
marc	ﻡﺍﺭک
marcel	ﻡﺍﺭﺱﻝ
marcela	ﻡﺍﺭﺱﻝﺍ
marcelino	ﻡﺍﺭﺱﻝیﻥﻭ
marcelo	ﻡﺍﺭﺱﻝﻭ
march	ﻡﺍﺭچ
marchington	ﻡﺍﺭکیﻥگﺕﻭﻥ
marchiondo	ﻡﺍﺭچیﻥﺩﻭ
marco	ﻡﺍﺭکﻭ
marcopoli	ﻡﺍﺭکﻭپﻭﻝی
marcos	ﻡﺍﺭکﻭﺱ
marcum	ﻡﺍﺭکﻭﻡ
marcus	ﻡﺍﺭکییﻭﺱ
marcy	ﻡﺍﺭﺱی
marder	ﻡﺍﺭﺩﺭ
mares	ﻡﺍﺭﺱ
margarietie	ﻡﺍﺭگﺭیﺕیﻩ
margarietje	ﻡﺍﺭگﺭیﺕﻩ
margolin	ﻡﺍﺭگﻝیﻥ
margolis	ﻡﺍﺭگﻭﻝیﺱ
margretha	ﻡﺍﺭگﺭیﺕﺍ
margrietje	ﻡﺍﺭگﺭیﺕ
margulieux	ﻡﺍﺭگﻭﻝیﻭکﺱ
maria	ﻡﺍﺭیﺍ
mariani	ﻡﺍﺭییﺍﻥی
mariano	ﻡﺍﺭیﺍﻥﺍ
maricondo	ﻡﺍﺭیکﺍﻥﺩﻭ
marijken	ﻡﺍﺭیکﻥ
marin	ﻡﺍﺭیﻥ
marinelli	ﻡﺭیﻥﻝی
marino	ﻡﺍﺭیﻥﻭ
mario	ﻡﺍﺭیﻭ
maritje	ﻡﺍﺭیﺕ
marius	ﻡﺍﺭیﻭﺱ
mark	ﻡﺍﺭک
markey	ﻡﺍﺭکی
markham	ﻡﺍﺭکﻩﺍﻡ
markiel	ﻡﺍﺭکیﻝ
markku	ﻡﺍﺭکﻭ
markley	ﻡﺍﺭکﻝی
markowitz	ﻡﺍﺭکﻭﺯ
marksteiner	ﻡﺍﺭکﺱﺕیﻥﺭ
marla	ﻡﺍﺭﻝﺍ
marlatt	ﻡﺍﺭﻝﺍﺕ
marley	ﻡﺍﺭﻝی
marlin	ﻡﺍﺭﻝیﻥ
marocchi	ﻡﺍﺭﻭچی
maroney	ﻡﺍﺭﻭﻥی
maroon	ﻡﺍﺭﻭﻥ
marple	ﻡﺍﺭپﻝ
marques	ﻡﺍﺭکﻭﺱ
marquette	ﻡﺍﺭکﻭیﺕ
marqueza	ﻡﺍﺭکﻭیﺯﺍ
marregante	ﻡﺍﺭگﺍﻥﺕ
marritje	ﻡﺭیﺝ
marrone	ﻡﺍﺭﻭﻥ
marrs	ﻡﺍﺭﺱ
marshall	ﻡﺍﺭﺵﺍﻝ
marston	ﻡﺍﺭﺱﺕﻭﻥ
martell	ﻡﺍﺭﺕﻝ
marten	ﻡﺍﺭﺕﻥ
martens	ﻡﺍﺭﺕیﻥﺯ
marthinus	ﻡﺍﺭﺕیﻥﺯ
marti	ﻡﺍﺭﺕی
martijn	ﻡﺍﺭﺕیژﻥ
martijntje	ﻡﺍﺭﺕیژﻥﺕﺝ
martino	ﻡﺍﺭﺕیﻥﻭ
martins	ﻡﺍﺭﺕیﻥﺯ
martinsen	ﻡﺍﺭﺕیﻥﺱﻥ
martland	ﻡﺍﺭﺕﻝﻥﺩ
marty	ﻡﺍﺭﺕی
martyn	ﻡﺍﺭﺕیﻥ
martyntje	ﻡﺍﺭﺕیﻥﺕ
martz	ﻡﺍﺭﺕﺯ
marv	ﻡﺍﺭﻭ
marvin	ﻡﺍﺭﻭیﻥ
marvit	ﻡﺍﺭﻭیﺕ
marwah	ﻡﺭﻭﺍﺡ
marwaha	ﻡﺍﺭﻭﺍﻩﺍ
marwan	ﻡﺭﻭﺍﻥ
marwin	ﻡﺍﺭﻭیﻥ
marx	ﻡﺍﺭکﺱ
marxen	ﻡﺍﺭکﺱﻥ
mary	ﻡﺍﺭی
maryanne	ﻡﺍﺭیﺍﻥ
marylynn	ﻡﺍﺭیﻝیﻥ
maryse	ﻡﺭیﺱ
marz	ﻡﺍﺭﺯ
marzec	ﻡﺍﺭﺯک
masahiro	ﻡﺍﺱﺍﻩیﺭﻭ
masalkhi	ﻡﺱﺍﻝخی
masao	ﻡﺍﺱﺍیﻭ
masaru	ﻡﺍﺱﺍﺭﺍ
masataka	ﻡﺍﺱﺍﺕﺍکﺍ
masato	ﻡﺍﺱﺍﺕﻭ
mascari	ﻡﺍﺱکﺍﺭی
mascias	ﻡﺍﺱکیﺍﺱ
masek	ﻡﺍﺱک
mashburn	ﻡﺵﺏﺍﺭﻥ
mashey	ﻡﺍﺵی
mashtare	ﻡﺍﺵﺕیﺭ
masin	ﻡﺱیﻥ
maskell	ﻡﺍﺱکﻝ
maslin	ﻡﺱﻝیﻥ
masna	ﻡﺍﺱﻥﺍ
masnaa	ﻡﺍﺱﻥﺍ
masoner	ﻡیﺱﻭﻥﺭ
masselli	ﻡﺍﺱﻝﻝی
masserman	ﻡﺍﺱﺭﻡﻥ
massif	ﻡﺱیﻑ
massimo	ﻡﺍﺱیﻡﻭ
massios	ﻡﺱیﻭﺱ
masson	ﻡﺍﺱﻭﻥ
mast	ﻡﺱﺕ
mastan	ﻡﺱﺕﺍﻥ
masten	ﻡﺍﺱﺕﻥ
masters	ﻡﺱﺕﺭﺯ
masud	ﻡﺱﻉﻭﺩ
mat	ﻡﺕ
mata	ﻡﺍﺕﺍ
matako	ﻡﺍﺕﺍکﻭ
matana	ﻡﺍﺕﺍﻥﺍ
matar	ﻡﺍﺕﺍﺭ
mateen	ﻡﺕیﻥ
matejka	ﻡﺍﺕﺝکﺍ
mathai	ﻡﺍﺕﺍی
matheis	ﻡﺍﺕیﺱ
matheson	ﻡﺕﺱﻭﻥ
mathew	ﻡﺕیﻭ
mathieu	ﻡﺕیﻭ
mathur	ﻡﺍﺕﻭﺭ
matin	ﻡﺕیﻥ
matlin	ﻡﺕﻝیﻥ
maton	ﻡیﺕﻭﻥ
matrow	ﻡﺕﺭﻭ
matsuda	ﻡﺍﺕﺱﻭﺩﺍ
matsumoto	ﻡﺍﺕﺱﻭﻡﻭﺕﻭ
matt	ﻡﺕ
matthew	ﻡﺍﺕیﻭ
matthews	ﻡﺍﺕیﻭﺱ
matthewson	ﻡﺕیﻭﺱﻭﻥ
mattis	ﻡﺍﺕیﺱ
mattson	ﻡﺍﺕﺱﻭﻥ
mattu	ﻡﺍﺕﻭ
matula	ﻡﺍﺕﻭﻝﺍ
matyas	ﻡﺕیﻭﺱ
mau	ﻡﺍﻭ
mauer	ﻡﺍﻭﺭ
maumee	ﻡﺍﻡی
maun	ﻡﺍﻭﻥ
maupin	ﻡﺍﻭپیﻥ
mauro	ﻡﻭﺭﻭ
maurstad	ﻡﻭﺭﺱﺕﺍﺩ
maury	ﻡﺭی
mautino	ﻡﺍﺕیﻥﻭ
mavers	ﻡﺍﻭﺭﺱ
maw	ﻡﺍﻭ
mawby	ﻡﺍﺏی
mawk	ﻡﺍک
maxfield	ﻡکﺱﻑیﻝﺩ
maxi	ﻡﺍکﺱی
maxim	ﻡﺍکﺯیﻡ
maximilian	ﻡﺍکﺱیﻡیﻝیﺍﻥ
maximov	ﻡکﺱیﻡﻭ
maxwells	ﻡﺍکﺱﻭﻝ
may	ﻡی
maycock	ﻡیکک
mayeen	ﻡﺍیﻥ
mayerfeld	ﻡیﺭﻑﻝﺩ
mayfield	ﻡﺍیﻑیﻝﺩ
maynard	ﻡیﻥﺍﺭﺩ
mayne	ﻡیﻥ
mayo	ﻡیﻭ
mayr	ﻡﺍیﺭ
maysan	ﻡیثﺍﻥ
maytag	ﻡﺍیﺕﺍگ
mazdeh	ﻡﺯﺩﻩ
maze	ﻡیﺯ
mazera	ﻡﺍﺯﺭﺍ
mcaleer	ﻡکﺍﻝیﺭ
mcardle	ﻡکﺍﺭﺩﻝ
mccann	ﻡککﺍﻥ
mccarthy	ﻡککﺍﺭﺕی
mccarty	ﻡککﺍﺭﺕی
mccauley	کﺍﻭﻝی
mccown	ﻡککﺍﻭﻥ
mccracken	ﻡککﺭکﻥ
mcdermott	ﻡکﺩﺭﻡﻭﺕ
mcdonald	ﻡکﺩﻭﻥﺍﻝﺩ
mcdowell	ﻡکﺩﻭیﻝ
mcfarland	ﻡکﻑﺍﺭﻝﻥﺩ
mcfarlane	ﻡکﻑﺭﻝیﻥ
mcgavin	ﻡکگﺍﻭیﻥ
mcgeary	ﻡکگیﺭی
mcgrath	ﻡکگﺭﺍﺕ
mcguire	ﻡکگﻭیﺭ
mcguirk	ﻡکگﻭیﺭک
mchenry	ﻡکﻩﻥﺭی
mckenna	ﻡککﻥﺍ
mckenney	ﻡککﻥی
mckenzie	ﻡککﻥﺯی
mclean	ﻡکﻝیﻥ
mcloughlin	ﻡکﻝﺍﻭﻝیﻥ
mcmahan	ﻡکﻡﺍﻩﺍﻥ
mcmahon	ﻡکﻡﺍﻩﻭﻥ
mcmanis	ﻡکﻡﺍﻥیﺱ
mcmullen	ﻡکﻡﻭﻝﻥ
mcneill	ﻡکﻥیﻝ
mcnutt	ﻡکﻥﺍﺕ
meachen	ﻡیچﻥ
meagher	ﻡیگﺭ
meaker	ﻡیکﺭ
mean	ﻡیﻥ
meaney	ﻡیﻥی
meara	ﻡیﺭﺍ
mears	ﻡیﺭﺯ
measat	ﻡیﺱﺍﺕ
mecca	ﻡکﺍ
medawar	ﻡﺩﺍﻭﺭ
medd	ﻡیﺩ
medea	ﻡیﺩی
median	ﻡﺩیﻥ
medina	ﻡﺩیﻥﺍ
medlin	ﻡﺩﻝیﻥ
mednick	ﻡﺩﻥیک
medrek	ﻡﺩﺭک
meechan	ﻡیچﺍﻥ
meehan	ﻡیﻩﺍﻥ
meek	ﻡیک
meekings	ﻡیکیﻥگ
meekins	ﻡیکیﻥﺯ
meeks	ﻡیکﺯ
meewes	ﻡیﻭﺯ
meger	ﻡگﺭ
megyesi	ﻡگیﺱی
mehl	ﻡﻩﻝ
mei	ﻡی
meier	ﻡییﺭ
meighen	ﻡیگﻥ
meijer	ﻡیﺝﺭ
meindert	ﻡیﺍیﻥﺩﺭﺕ
meiners	ﻡیﻥﺭﺯ
mejia	ﻡﺝیﺍ
mekkah	ﻡککﺍﻩ
melander	ﻡﻝﺍﻥﺩﺭ
melanie	ﻡﻝﺍﻥی
melara	ﻡیﻝﺍﺭﺍ
melby	ﻡﻝﺏﺍی
melcher	ﻡﻝچﺭ
melchior	ﻡﻝچیﺭ
meleedy	ﻡﻝیﺩی
melen	ﻡیﻝﻥ
melka	ﻡﻝکﺍ
mella	ﻡﻝﺍ
mellin	ﻡﻝیﻥ
mellinger	ﻡﻝیﻥگﺭ
mellor	ﻡﻝﺭ
melman	ﻡیﻝﻡﺍﻥ
melo	ﻡﻝﻭ
meloon	ﻡﻝﻭﻥ
menard	ﻡیﻥﺍﺭﺩ
mendell	ﻡﻥﺩﻝ
mendes	ﻡﻥﺩﺯ
mendoza	ﻡﻥﺩﻭﺯﺍ
mendyke	ﻡﻥﺩیک
menes	ﻡیﻥﺯ
menestrina	ﻡﻥﺱﺕﺭیﻥﺍ
menezes	ﻡﻥﺯﺱ
meng	ﻡﻥگ
menge	ﻡﻥگﻩ
menhardt	ﻡﻥﻩﺍﺭﺕ
menke	ﻡﻥک
menth	ﻡﻥﺕ
mentzer	ﻡﻥﺕﺯﺭ
menzies	ﻡﻥﺯیﺯ
meranda	ﻡﺭﺍﻥﺩﺍ
mercer	ﻡﺭکﺭ
merchant	ﻡﺭکﻥﺕ
meredith	ﻡیﺭیﺩیﺕ
merginio	ﻡﺭﺝیﻥیﻭ
meritt	ﻡﺭیﺕ
merkel	ﻡﺭکﻝ
merkle	ﻡﺭکﻝی
merolle	ﻡیﺭﻭﻝ
merrick	ﻡﺭیک
merricks	ﻡﺭیکﺱ
merrigan	ﻡﺭیگﺍﻥ
merriman	ﻡﺭیﻡﺍﻥ
merry	ﻡﺭی
mersereau	ﻡﺭﺱﺭیﺍ
mertens	ﻡﺭﺕﻥﺯ
merz	ﻡﺭﺯ
mesa	ﻡیﺱﺍ
mesander	ﻡﺱﺍﻥﺩﺭ
meskes	ﻡﺱکﺱ
messer	ﻡﺱﺭ
messina	ﻡﺱیﻥﺍ
messinger	ﻡﺱیﻥگﺭ
mest	ﻡﺱﺕ
metternich	ﻡﺕﺭیﻥچ
metzger	ﻡﺕﺯگﺭ
metzing	ﻡﺕﺯیﻥگ
meuser	ﻡیﻭﺯﺭ
meyer	ﻡیﺭ
meyers	ﻡییﺭﺱ
miao	ﻡیﺍﻭ
micha	ﻡیچﺍ
michaelis	ﻡیچﺍیﻝیﺱ
michalak	ﻡیکﺍﻝک
michele	ﻡیﺵﻝ
micheltjen	ﻡیچﻝﺕیﻥ
mickelson	ﻡیکﻝﺱﻭﻥ
mickhael	ﻡیکﺍییﻝ
micklem	ﻡیکﻝﻡ
mickna	ﻡیکﻥﺍ
micohn	ﻡﺍیکﻥ
middlebro	ﻡیﺩﻝﺏﺭﻭ
middleton	ﻡیﺩﻝﺕﻥ
miehe	ﻡییﻩ
mier	ﻡیﺭ
mierwa	ﻡیﺭﻭﺍ
miettunen	ﻡیﺕﻭﻥﻥ
might	ﻡﺍیﺕ
mighty	ﻡﺍیﺕی
mignerey	ﻡیگﻥﺭی
migneron	ﻡیگﻥﺭﺍﻥ
miguel	ﻡیگﻭیﻝ
mihalick	ﻡیﻩﺍﻝیک
mikael	ﻡیکﺍیﻝ
mike	ﻡﺍیک
miket	ﻡیکﺕ
mikkelsen	ﻡیکﻝﺱﻥ
mikko	ﻡیکﻭ
mikolic	ﻡیکﻭﻝیک
mikoss	ﻡیکﺍﺱ
mikus	ﻡیکﺱ
milacic	ﻡیﻝﺍﺱیﺱ
milad	ﻡیﻝﺍﺩ
milam	ﻡیﻝﺍﻡ
milbert	ﻡیﻝﺏﺭﺕ
mildred	ﻡیﻝﺩﺭﺩ
milestone	ﻡیﻝﺱﺕﻭﻥ
milgram	ﻡیﻝگﺭﺍﻡ
milind	ﻡیﻝیﻥﺩ
milko	ﻡیﻝکﻭ
milks	ﻡیﻝکﺱ
milky	ﻡیﻝکی
millan	ﻡیﻝﺍﻥ
millar	ﻡیﻝﺍﺭ
millard	ﻡیﻝﺍﺭﺩ
millennium	ﻡیﻝﻥیﻭﻡ
miller	ﻡیﻝﺭ
millett	ﻡیﻝﺕ
milley	ﻡیﻝی
millham	ﻡیﻝﺍﻡ
milli	ﻡیﻝی
millians	ﻡیﻝیﺍﻥﺯ
millican	ﻡیﻝیکﻥ
millie	ﻡیﻝی
milligan	ﻡیﻝیگﺍﻥ
millman	ﻡیﻝﻡﺍﻥ
milmoe	ﻡیﻝﻡﻭ
milne	ﻡﺍیﻝﻥ
milner	ﻡیﻝﻥﺭ
milnor	ﻡیﻝﻥﻭﺭ
milo	ﻡیﻝﻭ
milos	ﻡیﻝﻭﺱ
milt	ﻡیﻝﺕ
milton	ﻡیﻝﺕﻭﻥ
milut	ﻡیﻝﻭﺕ
milward	ﻡیﻝﻭﺍﺭﺩ
mimas	ﻡیﻡﺍﺱ
mime	ﻡیﻡی
min	ﻡیﻥ
mina	ﻡیﻥﺍ
minamo	ﻡیﻥﺍﻡﻭ
minarik	ﻡیﻥﺍﺭیک
mincer	ﻡیﻥﺱﺭ
mincey	ﻡیﻥﺱی
mindt	ﻡیﻥﺕ
miner	ﻡیﻥﺭ
mineral	ﻡیﻥﺭﺍﻝ
minerva	ﻡیﻥﺭﻭﺍ
mingo	ﻡیﻥگﻭ
minna	ﻡیﻥﺍ
minqi	ﻡیﻥکی
minstrel	ﻡیﻥﺱﺕﺭﻝ
mintaqah	ﻡیﻥﺕکﺍ
minter	ﻡیﻥﺕﺭ
minton	ﻡیﻥﺕﻭﻥ
mintz	ﻡیﻥﺕﺯ
minyard	ﻡیﻥیﺍﺭﺩ
mir	ﻡیﺭ
miranker	ﻡیﺭﺍﻥکﺭ
mirashi	ﻡیﺭﺵی
mire	ﻡﺍیﺭ
mirmak	ﻡیﺭﻡﺍک
mirti	ﻡیﺭﺕی
mirut	ﻡیﺭﻭﺕ
misik	ﻡیﺱیک
miskin	ﻡﺱکیﻥ
mislove	ﻡیﺱﻝﺍﻭ
misra	ﻡیﺱﺭﺍ
missal	ﻡﺍیﺱﺍﻝ
missel	ﻡﺍیﺱﻝ
mistick	ﻡیﺱﺕیک
mistry	ﻡیﺱﺕﺭی
mitchell	ﻡیچﻝ
mitchem	ﻡیﺕچﻡ
mithal	ﻡیﺕﺍﻝ
mitham	ﻡﺍیﺕﻩﺍﻡ
mitnick	ﻡیﺕﻥیک
mito	ﻡیﺕﻭ
mitrovic	ﻡیﺕﺭﻭﻭیک
mitu	ﻡیﺕﻭ
miura	ﻡیﺭﺍ
mix	ﻡیکﺱ
mize	ﻡیﺯ
mizera	ﻡیﺯیﺭﺍ
mobley	ﻡﻭﺏﻝی
mockridge	ﻡﺍکﺭیﺝ
mod	ﻡﻭﺩ
moffat	ﻡﻭﻑﺍﺩ
moganti	ﻡﻭگﺍﻥﺕی
mogged	ﻡﺍگﺩ
moghrabi	ﻡﻕﺭﺏی
mohan	ﻡﻭﻩﺍﻥ
mohar	ﻡﻭﻩﺭ
moile	ﻡﻭیﻝ
moises	ﻡﻭیﺱﺱ
mok	ﻡﻭک
molaire	ﻡﻝﺍییﺭ
molander	ﻡﻭﻝﺍﻥﺩﺭ
molinari	ﻡﻭﻝیﻥﺍﺭی
moll	ﻡﻭﻝ
moller	ﻡﻭﻝﺭ
molloy	ﻡﻭﻝﻭی
monack	ﻡﻭﻥﺍک
monaco	ﻡﻭﻥﺍکﻭ
monagan	ﻡﻭﻥﺍگﺍﻥ
moncur	ﻡﻭﻥکﺍﺭ
mondfrans	ﻡﻭﻥﺩﻑﺭﺍﻥﺱ
mondor	ﻡﺍﻥﺩﺍﺭ
mondore	ﻡﻭﻥﺩﻭﺭ
money	ﻡﺍﻥی
monger	ﻡﺍﻥگﺭ
monk	ﻡﺍﻥک
monkey	ﻡﺍﻥکی
monks	ﻡﺍﻥکﺱ
monolith	ﻡﻭﻥﻭﻝیﺕ
monroe	ﻡﻥﺭﻭ
monster	ﻡﺍﻥﺱﺕﺭ
monta	ﻡﻭﻥﺕﺍ
montag	ﻡﻭﻥﺕﺍگ
montagu	ﻡﻭﻥﺕﺍگﻭ
montalbano	ﻡﻭﻥﺕﺍﻝﺏﺍﻥﻭ
montanaro	ﻡﻭﻥﺕﺍﻥﺍﺭﻭ
montano	ﻡﻭﻥﺕﺍﻥﻭ
montero	ﻡﻭﻥﺕﺭﻭ
montgomery	ﻡﻭﻥﺕگﻡﺭی
montijo	ﻡﻭﻥﺕیﺝﻭ
montoya	ﻡﻭﻥﺕﻭیﺍ
montreal	ﻡﻭﻥﺕﺭﺍﻝ
montrose	ﻡﺍﻥﺕﺭﺍﺱ
moody	ﻡﻭﺩی
moon	ﻡﻭﻥ
moore	ﻡﻭﺭ
moorhouse	ﻡﻭﺭﻩﺍﻭﺱ
moorman	ﻡﻭﺭﻡﺍﻥ
moosavi	ﻡﻭﺱﻭی
mooseface	ﻡﻭﺱﻑیﺱ
moqbara	ﻡﻕﺏﺭﻩ
morabito	ﻡﻭﺭﺍﺏیﺕﻭ
moraines	ﻡﻭﺭﺍیﻥﺱ
morales	ﻡﻭﺭﺍﻝﺱ
moran	ﻡﻭﺭﺍﻥ
morando	ﻡﻭﺭﺍﻥﺩﻭ
morano	ﻡﻭﺭﺍﻥﻭ
moras	ﻡﻭﺭﺍﺱ
moravan	ﻡﻭﺭﺍﻭﺍﻥ
moray	ﻡﻭﺭﺍی
morch	ﻡﻭﺭچ
morehouse	ﻡﺭﻩﺍﻭﺱ
morel	ﻡﻭﺭﻝ
mores	ﻡﻭﺭﺱ
morey	ﻡﻭﺭی
morin	ﻡﻭﺭیﻥ
morison	ﻡﻭﺭیﺱﻭﻥ
morita	ﻡﻭﺭیﺕﺍ
morkel	ﻡﻭﺭکﻝ
morken	ﻡﻭﺭکﻥ
morlan	ﻡﻭﺭﻝﺍﻥ
morley	ﻡﻭﺭﻝی
morlidge	ﻡﻭﺭﻝیﺝ
morning	ﻡﻭﺭﻥیﻥگ
moroney	ﻡﻭﺭﻭﻥی
morreale	ﻡﻭﺭﺍﻝ
morrell	ﻡﻭﺭﻝ
morrill	ﻡﻭﺭیﻝ
morrison	ﻡﺍﺭیﺱﻭﻥ
morse	ﻡﻭﺭﺱ
morss	ﻡﻭﺭﺱ
mortimer	ﻡﻭﺭﺕیﻡﺭ
mortimore	ﻡﻭﺭﺕیﻡﺭ
morton	ﻡﺭﺕﻥ
morville	ﻡﻭﺭﻭیﻝ
moses	ﻡﺱﺱ
moshier	ﻡﻭﺵیﺭ
mossburg	ﻡﺍﺱﺏﺭگ
mosses	ﻡﻭﺱﺯ
mossman	ﻡﺱﻡﺍﻥ
motor	ﻡﻭﺕﻭﺭ
motors	ﻡﻭﺕﻭﺭﺯ
mott	ﻡﻭﺕ
motta	ﻡﻭﺕﺍ
moudgill	ﻡﻭﺩگیﻝ
moulden	ﻡﺍﻝﺩﻥ
mouli	ﻡﻭﻝی
moulk	ﻡﻭﻝک
mount	ﻡﻭﻥﺕ
mountains	ﻡﺍﻥﺕﻥﺯ
mounzer	ﻡﻥﺯﺭ
mouser	ﻡﺍﻭﺱﺭ
moye	ﻡﻭی
moyer	ﻡﺍیﺭ
moynes	ﻡﻭیﻥﺯ
moynihan	ﻡﻭیﻥیﻩﺍﻥ
mozina	ﻡﻭﺯیﻥﺍ
mubarak	ﻡﺏﺍﺭک
much	ﻡﺍچ
mudie	ﻡﻭﺩی
mueller	ﻡﻭﺍﻝﺭ
muenzer	ﻡﻭﺍﻥﺯﺭ
muenzler	ﻡﻭﻥﺯﻝﺭ
muessig	ﻡﻭﺱیگ
muffin	ﻡﺍﻑیﻥ
muh	ﻡﻭ
muhamma	ﻡﺡﺍﻡﺍ
muharraq	ﻡﺡﺭک
muir	ﻡﻭیﺭ
muise	ﻡﻭیﺯ
mukasa	ﻡﻭکﺍﺱﺍ
muller	ﻡﻭﻝﺭ
mulligan	ﻡﺍﻝیگﺍﻥ
mulrooney	ﻡﺍﻝﺭﻭﻥی
mumford	ﻡﺍﻡﻑﻭﺭﺩ
mummert	ﻡﺍﻡﺭﺕ
mun	ﻡﻭﻥ
munch	ﻡﺍﻥخ
munday	ﻡﺍﻥﺩی
muniz	ﻡﻭﻥیﺯ
munkert	ﻡﺍﻥکﺭﺕ
muno	ﻡﺍﻥﻭ
munoz	ﻡﻭﻥﺍﺯ
munro	ﻡﺍﻥﺭﻭ
muns	ﻡﻭﻥﺱ
munsil	ﻡﺍﻥﺱیﻝ
munsinger	ﻡﺍﻥﺱیﻥگﺭ
mura	ﻡﻭﺭﺍ
murad	ﻡﻭﺭﺍﺩ
murali	ﻡﺍﺭﺍﻝی
muralt	ﻡﻭﺭﺍﻝﺕ
murdoch	ﻡﺍﺭﺩﻭچ
muren	ﻡﺍﺭﻥ
murie	ﻡﺍﺭیﻩ
murphy	ﻡﺍﺭﻑی
murrell	ﻡﺍﺭﺭﻝ
murthy	ﻡﻭﺭﺕی
mury	ﻡﺍﺭی
musa	ﻡﻭﺱی
muschall	ﻡﻭﺵﺍﻝ
muse	ﻡﻭﺱ
musella	ﻡﻭﺱﻝﺍ
muthanna	ﻡﺕﻥﺍ
mutiso	ﻡﻭﺕیﺱﻭ
mutlu	ﻡﺍﺕﻝﻭ
mutt	ﻡﺍﺕ
muysson	ﻡیﻭﺱﻥ
myer	ﻡﺍیﺭ
myers	ﻡیﺭﺯ
myiesha	ﻡیﺵﺍ
myreen	ﻡﺍیﺭﻥ
myrick	ﻡﺍیﺭیک
mystic	ﻡﺍیﺱﺕیک
myth	ﻡﺍیﺕ
nabatiye	ﻥﺏﺍﺕی
nabil	ﻥﺍﺏیﻝ
nadig	ﻥﺍﺩیگ
nadkarni	ﻥﺩکﺍﺭﻥی
nadolny	ﻥﺍﺩﻭﻝﻥی
nafeeza	ﻥﺍﻑﺯﺍ
nagasaki	ﻥﺍگﺍﺱﺍکی
nagasiva	ﻥﺍگﺍﺱیﻭﺍ
nager	ﻥﺍﺝﺭ
nagy	ﻥگی
nahnah	ﻥﻩﻥﻩ
nahum	ﻥﺍﻩﺍﻡ
naidoo	ﻥﺍیﺩﻭ
naimah	ﻥیﻡﺍ
nair	ﻥیﺭ
najaf	ﻥﺝﺍﻑ
najiyah	ﻥﺍﺝیﺍﻩ
najwa	ﻥﺝﻭﺍ
najya	ﻥﺍﺝیﺍ
nakagaki	ﻥﺍکﺍگﺍکی
nakamura	ﻥﺍکﺍﻡﻭﺭﺍ
nakashima	ﻥﺍکﺍﺵیﻡﺍ
nakasora	ﻥﺍکﺍﺱﻭﺭﺍ
nallick	ﻥﺍﻝیک
nam	ﻥﺍﻡ
namazi	ﻥﻡﺍﺯی
nan	ﻥﺍﻥ
nance	ﻥﺍﻥﺱ
nancy	ﻥﺍﻥﺱی
nandwani	ﻥﺍﻥﺩﻭﺍﻥی
napolitano	ﻥﺍپﻭﻝیﺕﺍﻥﻭ
napora	ﻥپﻭﺭﺍ
napton	ﻥپﺕﻭﻥ
naquin	ﻥﺍکﻭییﻥ
narad	ﻥﺍﺭﺍﺩ
nardi	ﻥﺍﺭﺩی
nardo	ﻥﺍﺭﺩﻭ
nardone	ﻥﺍﺭﺩﻥ
narla	ﻥﺍﺭﻝﺍ
naro	ﻥﺍﺭﻭ
narsavage	ﻥﺍﺭﺱﺍﻭﺍگ
nas	ﻥﺍﺱ
nashida	ﻥﺵیﺩﺍ
nashwa	ﻥﺵﻭﺍ
nasiha	ﻥﺱیﻩ
nasira	ﻥﺱیﺭﺍ
nass	ﻥﺍﺱ
nassau	ﻥﺍﺱﺍﻭ
nathan	ﻥﺍﺕﺍﻥ
nathanson	ﻥﺍﺩﺍﻥﺱﻭﻥ
nathifa	ﻥطیﻑﺍ
national	ﻥﺵﻥﺍﻝ
nau	ﻥﺍﻭ
naunton	ﻥﺍﻥﺕﻭﻥ
navarro	ﻥﺍﻭﺍﺭﻭ
navas	ﻥﺍﻭﺍﺱ
nave	ﻥﺍﻭ
navia	ﻥﺍﻭیﺍ
navis	ﻥﻭیﺱ
nawar	ﻥﺍﻭﺍﺭ
nawaz	ﻥﻭﺍﺯ
nayar	ﻥیﺭ
nayfeh	ﻥﺍیﻑﻩ
naylor	ﻥﺍیﻝﺭ
nazahah	ﻥﺯﺍﺡﺍ
nazaretian	ﻥﺍﺯﺍﺭیﺕیﺍﻥ
nazario	ﻥﺍﺯﺍﺭیﻭ
nazirah	ﻥﺯیﺭﺍ
nebel	ﻥﺏﻝ
nebres	ﻥﺏﺭﺱ
neden	ﻥﺩﻥ
nedin	ﻥﺩیﻥ
nedved	ﻥﺩﻭﺩ
needles	ﻥیﺩﻝﺯ
neefjan	ﻥیﻑﺝﺍﻥ
neelmegh	ﻥیﻝﻡگ
neeltje	ﻥیﻝﺕﺝ
nefedow	ﻥﻑﺩﻭ
negative	ﻥگﺕیﻭ
neill	ﻥیﻝ
neisen	ﻥیﺱﻥ
nelkin	ﻥﻝکیﻥ
neri	ﻥﺭی
nery	ﻥﺭی
nesley	ﻥﺱﻝی
ness	ﻥیﺱ
nethacker	ﻥﺕﺍکﺭ
netherton	ﻥﺕﺭﺕﻭﻥ
neuen	ﻥیﻭﺍﻥ
neuhaus	ﻥﻩﺍﻭﺱ
neuman	ﻥیﻭﻡﺍﻥ
nevejans	ﻥﻭیﺝﺍﻥﺯ
nevel	ﻥﻭﻝ
nevile	ﻥﻭﺍیﻝ
neville	ﻥﻭیﻝ
nevison	ﻥیﻭیﺱﻭﻥ
newark	ﻥیﻭﺍﺭک
newberry	ﻥیﻭﺏﺭی
newbery	ﻥیﻭﺏﺭی
newby	ﻥیﻭﺏﺍی
newcomb	ﻥییﻭکﺍﻡﺏ
newington	ﻥیﻭییﻥگﺕﻭﻥ
newland	ﻥیﻭﻝﻥﺩ
newman	ﻥیﻭﻡﺍﻥ
newmeyer	ﻥیﻭﻡیﺭ
newquist	ﻥیﻭکﻭیﺱﺕ
newsham	ﻥیﻭﺵﺍﻡ
newton	ﻥییﻭﺕﻥ
nibby	ﻥیﺏی
nic	ﻥیک
nicholas	ﻥیچﻭﻝﺍﺱ
nicholls	ﻥیکﻝﺯ
nichols	ﻥیچﻭﻝﺱ
nicholson	ﻥیکﻝﺱﻥ
nick	ﻥیک
nickel	ﻥیکﻝ
nickell	ﻥیکﻝ
nickelsen	ﻥیکﻝﺱﻥ
nickerson	ﻥیکﺭﺱﻭﻥ
nickey	ﻥیکی
nicki	ﻥیکی
nicko	ﻥکﻭ
nickolay	ﻥیکﻭﻝی
niclas	ﻥیکﻝﺱ
nico	ﻥکﻭ
nicol	ﻥیکﻝ
nicola	ﻥیکﻭﻝﺍ
nicolaes	ﻥیکﻝﺍﺱ
nicolas	ﻥیکﺍﻝﺍﺱ
nicolaus	ﻥیکﻝﺍﺱ
nicole	ﻥیکﻝ
nicoll	ﻥیکﻭﻝ
nicolo	ﻥیکﻝﻭ
nid	ﻥیﺩ
nida	ﻥیﺩﺍ
nidal	ﻥیﺩﺍﻝ
niek	ﻥیک
niekolaas	ﻥیکﻝﺍﺱ
niel	ﻥیﻝ
niels	ﻥیﻝﺯ
niemi	ﻥیﻡی
nien	ﻥیﻥ
niermann	ﻥﺍیﺭﻡﻥ
nigg	ﻥیگ
niggli	ﻥیگﻝی
night	ﻥﺍیﺕ
nigra	ﻥیگﺭﺍ
nihalani	ﻥیﻩﺍﻝﺍﻥی
niki	ﻥیکی
nikki	ﻥیکی
niklas	ﻥکﻝﺍﺱ
niknaz	ﻥکﻥﺯ
nikolay	ﻥیکﻭﻝی
nikolic	ﻥیکﻭﻝیک
nikos	ﻥیکﺱ
niland	ﻥیﻝﻥﺩ
niles	ﻥﺍیﻝﺯ
nilesh	ﻥیﻝﺵ
nils	ﻥیﻝﺱ
nilse	ﻥیﻝﺱ
nilsen	ﻥﻝﺱﻥ
nimrod	ﻥیﻡﺭﺍﺩ
nimtz	ﻥیﻡﺕﺯ
nin	ﻥیﻥ
nina	ﻥﺍیﺍ
ninedek	ﻥیﻥﺩک
ninja	ﻥیﻥﺝﺍ
ninnis	ﻥیﻥﺱ
nino	ﻥیﻥﻭ
ninoys	ﻥیﻥﻭیﺱ
ninstar	ﻥیﻥﺱﺕﺍﺭ
nipple	ﻥپﻝ
nippon	ﻥپﺍﻥ
niss	ﻥیﺱ
nitin	ﻥیﺕیﻥ
nix	ﻥﺍیکﺱ
nixon	ﻥیکﺱﻭﻥ
noble	ﻥﺍﺏﻝ
noda	ﻥﻭﺩﺍ
noko	ﻥﻭکﻭ
nolan	ﻥﻭﻝﺍﻥ
nolde	ﻥﻭﻝﺩ
nolf	ﻥﻭﻝﻑ
noorda	ﻥﻭﺭﺩﺍ
noorddorp	ﻥﻭﺭﺩﺭﺍپ
norby	ﻥﻭﺭﺏﺍی
norcott	ﻥﻭﺭکﺍﺕ
nordborg	ﻥﻭﺭﺩﺏﻭﺭگ
nordby	ﻥﻭﺭﺩﺏﺍی
nordenfelt	ﻥﺭﺩﻥﻑﻝﺕ
nordenstrom	ﻥﻭﺭﺩﻥﺱﺕﻭﺭﻡ
nordt	ﻥﻭﺭﺩﺕ
noren	ﻥﻭﺭﻥ
norha	ﻥﻭﺭﻩﺍ
northcutt	ﻥﻭﺭﺕکﺍﺕ
northorpe	ﻥﺭﺕﺭﻭپ
northrup	ﻥﻭﺭثﺭﺍپ
norup	ﻥﺭﻭپ
norwood	ﻥﻭﺭﻭﻭﺩ
nosack	ﻥﻭﺱﺍک
nose	ﻥﻭﺯ
nossum	ﻥﺱﻭﻡ
notz	ﻥﻭﺕﺯ
novella	ﻥﻭﺍﻝﺍ
novick	ﻥﻭیک
novik	ﻥﻭﻭیک
novillo	ﻥﺍﻭیﻝﻭ
novosel	ﻥﻭﻭﺱﻝ
noxon	ﻥﺍکﺱﻭﻥ
noya	ﻥﻭیﺍ
noyles	ﻥﻭیﻝﺱ
nuding	ﻥﻭﺩیﻥگ
nugent	ﻥﺍگﻥﺕ
nunis	ﻥﻭﻥیﺱ
nunley	ﻥﺍﻥﻝی
nuri	ﻥﻭﺭی
nurse	ﻥﺭﺱ
nuth	ﻥﻭﺕ
nutt	ﻥﺍﺕ
nyffeler	ﻥﺍیﻑﻝﺭ
nyikos	ﻥﺍیکﺱ
oakins	ﺍﻭکیﻥﺯ
oakley	ﺍکﻝی
obadja	ﺍﺏﺍﺝﺍ
obbingem	ﺍﺏیﻥگﻡ
ober	ﺍﻭﺏﺭ
oberdorfer	ﺍﻭﺏﺭﺩﻭﺭﻑﺭ
oberheim	ﺍﻭﺏﺭﻩیﻡ
oberholz	ﺍﻭﺏﺭﻩﻭﻝﺯ
oberle	ﺍﺏﺭﻝ
oberreuter	ﺍﺏﺭﻭﺕﺭ
obertas	ﺍﻭﺏﺭﺕﺍﺱ
oborg	ﺍﺏﺭگ
obremski	ﺍﺏﺭﻡﺱکی
obrien	ﺍﺏﺭیﻥ
obst	ﺍﺏﺱﺕ
obstgarten	ﺍﺏﺱﺕگﺍﺭﺕﻥ
ochs	ﺍﻭچﺯ
ocker	ﺍﻭکﺭ
oddy	ﺍﻭﺩﺩی
odell	ﺍﺩﻝ
odonnell	ﺍﺩﺍﻥﻝ
odum	ﺍﻭﺩیﻭﻡ
odwak	ﺍﻭﺩﻭﺍک
oetje	ﺍیﺕﺝ
office	ﺍﻑیﺱ
officer	ﺍﻑیﺱﺭ
ogborn	ﺍگﺏﺭﻥ
ohalloran	ﺍﻭﻩﺍﻝﻭﺭﺍﻥ
ohlund	ﺍﻩﻝﺍﻥﺩ
ohmaki	ﺍﻭﻡﺍکی
ohman	ﺍﻩﻡﻥ
ohmann	ﺍﻩﻡﺍﻥ
ohrman	ﺍﻭﻩﺭﻡﻥ
ojaste	ﺍﺝﺍﺱﺕ
ojeda	ﺍﺝﺩﺍ
oke	ﺍک
okeefe	ﺍکیﻑ
olafson	ﺍﻭﻝﺍﻑﺱﻭﻥ
olah	ﺍﻭﻝﺍ
oldcorn	ﺍﻭﻝﺩکﻭﺭﻥ
olds	ﺍﻝﺩﺯ
ole	ﺍﻭﻝی
olea	ﺍﻝی
oleinik	ﺍﻝیﻥیک
olematon	ﺍﻝﻡﺍﺕﻭﻥ
olguin	ﺍﻝگﺍیﻥ
olhsson	ﺍﻝﺱﻥ
olin	ﺍﻝیﻥ
oliva	ﺍﻝیﻭﺍ
oliveira	ﺍﻝیﻭﺭیﺍ
olivie	ﺍﻭﻝیﻭیﻩ
olivier	ﺍﻭﻝیﻭیﺭ
olivola	ﺍﻭﻝﺍیﻭﻭﻝﺍ
olli	ﺍﻭﻝی
olney	ﺍﻝﻥی
olsen	ﺍﻝﺱﻥ
olson	ﺍﺱﻝﻭﻥ
olsson	ﺍﻝﺱﺍﻥ
oltmann	ﺍﻝﺕﻡﻥ
oltz	ﺍﻝﺕﺯ
omaggio	ﺍﻡﺍگیﻭ
omega	ﺍﻭﻡگﺍ
ommer	ﺍﻭﻡﺭ
onat	ﺍﻭﻥﺍﺕ
oneal	ﺍﻥیﻝ
oneill	ﺍﻥیﻝ
oner	ﺍﻥﺭ
onesty	ﺍﻭﻥﺱﺕی
ong	ﺍﻭﻥگ
onosko	ﺍﻭﻥﻭﺱکﻭ
oostendorp	ﺍﻭﺱﺕﻥﺩﻭﺭپ
oppedal	ﺍپیﺩﺍﻝ
oram	ﺍﺭﺍﻡ
orban	ﺍﻭﺭﺏﻥ
orbi	ﺍﺭﺏی
orchard	ﺍﺭچﺍﺭﺩ
ore	ﺍﻭﺭ
oregan	ﺍﺭگﺍﻥ
orem	ﺍﻭﺭﻡ
orfanakis	ﺍﺭﻑﺍﻥﺍکیﺱ
orfeus	ﺍﺭﻑیﻭﺱ
orford	ﺍﺭﻑﻭﺭﺩ
organ	ﺍﺭگﺍﻥ
orgar	ﺍﺭگﺍﺭ
orhan	ﺍﻭﺭﻩﺍﻥ
orhun	ﺍﻭﺭﻩﺍﻥ
orion	ﺍﻭﺭیﻭﻥ
oriordan	ﺍﻭﺭیﻭﺭﺩﺍﻥ
orkney	ﺍﻭﺭکﻥی
orlando	ﺍﻭﺭﻝﺍﻥﺩﻭ
orleans	ﺍﻭﺭﻝیﻥﺯ
ormesporden	ﺍﻭﺭﻡﺱپﻭﺭﺩﻥ
ormond	ﺍﺭﻡﺍﻥﺩ
orne	ﺍﻭﺭﻥ
orourke	ﺍﺭﺍﺭکﻩ
orpheus	ﺍﻭﺭﻑیﻭﺱ
orrell	ﺍﺭﻝ
ortiz	ﺍﺭﺕیﺯ
orue	ﺍﻭﺭﻭ
orval	ﺍﺭﻭﺍﻝ
orville	ﺍﻭﺭﻭیﻝ
osborne	ﺍﺯﺏﻭﺭﻥ
osburn	ﺍﻭﺯﺏﺭﻥ
oseas	ﺍﻭﺱیﺯ
osen	ﺍﻭﺱﻥ
oseven	ﺍﻭﺱیﻭﻥ
oshall	ﺍﻭﺵﺍﻝ
osku	ﺍﺱکﻭ
osowski	ﺍﺱﻭﺱکی
ostby	ﺍﺱﺕﺏﺍی
ostliche	ﺍﻭﺱﺕﻝیچ
ostrander	ﺍﺱﺕﺭﺍﻥﺩﺭ
ostrin	ﺍﺱﺕﺭیﻥ
oswald	ﺍﺱﻭﺍﻝﺩ
ota	ﺍﺕﺍ
otaguro	ﺍﻭﺕﺍگﻭﺭﻭ
otello	ﺍﻭﺕﻝﻭ
otha	ﺍﺕﺍ
othman	ﻉثﻡﺍﻥ
otis	ﺍﻭﺕیﺱ
oto	ﺍﺕﻭ
otoosan	ﺍﺕﻭﺱﺍﻥ
ott	ﺍﺕ
ottello	ﺍﻭﺕﻝﻭ
otto	ﺍﺕﻭ
ottolini	ﺍﻭﺕﻭﻝیﻥی
oude	ﺍیﺩ
oudekirk	ﺍﺩکﺭیک
oued	ﺍﻭﺍﺩ
ouedraogo	ﺍﻭﺩﺭگﻭ
ougouag	ﺍﻭﻕﻭﺍﻕ
ould	ﺍﻝﺩ
oursler	ﺍﻭﺭﺱﻝﺭ
outer	ﺍﺕﺭ
ouzounis	ﺍﻭﺯﻭﻥیﺱ
overdal	ﺍﻭﻭﺭﺩﺍﻝ
overpeck	ﺍﻭﻭﺭپک
owchar	ﺍﻭچﺍﺭ
owens	ﺍﻭﺱﻥﺯ
owl	ﺍﻭﻝ
oxford	ﺍکﺱﻑﻭﺭﺩ
oxley	ﺍکﺱﻝی
oxton	ﺍﻭکﺱﺕﻭﻥ
oxwell	ﺍﻭکﺱﻭﻝ
oyarce	ﺍﻭیﺍﺭﺱ
ozgur	ﺍﻭﺯگﻭﺭ
ozmen	ﺍﻭﺯﻡﻥ
ozuna	ﺍﺯﺍﻥﺍ
pablo	پﺍﺏﻝﻭ
pace	پیﺱ
pachiano	پﺍچیﺍﻥﻭ
pacholke	پﺍچﻭﻝکﻩ
pacific	پﺍﺱیﻑیک
pack	پک
packard	پﺍکﺍﺭﺩ
packer	پکﺭ
padial	پﺍﺩیﺍﻝ
padilla	پﺍﺩیﻝﺍ
padua	پﺍﺩﻭﺍ
padula	پﺍﺩﻭﻝﺍ
pagett	پگﺕ
paglia	پﺍگﻝیﺍ
pagliaro	پﺍگﻝییﺍﺭﻭ
pahle	پﺍﻝ
pai	پﺍی
paiani	پیﻥی
paige	پﺍیﺝ
paik	پیک
painter	پیﻥﺕﺭ
pais	پیﺱ
paisley	پیﺯﻝی
paizis	پیﺯﺱ
pakala	پﺍکﺍﻝﺍ
pakenas	پﺍکﻥﺍﺱ
paks	پﺍکﺱ
pal	پﺍﻝ
palagyi	پﺍﻝﺍگی
palaio	پﻝیﻭ
palermo	پﺍﻝﺭﻡﻭ
paley	پﺍﻝی
pallack	پﺍﻝﺍک
pallis	پﺍﻝیﺱ
palmert	پﺍﻝﻡﺭﺕ
palumbo	پﺍﻝﻭﻡﺏﻭ
pam	پﺍﻡ
pan	پﺍﻥ
panagos	پﺍﻥﺍگﺱ
panas	پﺍﻥﺍﺱ
pancras	پﺍﻥکﺭﺍﺱ
panda	پﺍﻥﺩﺍ
pandian	پﺍﻥﺩیﺍﻥ
pandit	پﺍﻥﺩیﺕ
pandolfino	پﺍﻥﺩﻭﻝﻑیﻥﻭ
pandya	پﻥﺩیﺍ
pane	پیﻥ
panfil	پﺍﻥﻑیﻝ
pangborn	پﺍﻥگﺏﻭﺭﻥ
panici	پﺍﻥیﺱی
panico	پﺍﻥیکﻭ
pannon	پﺍﻥﻭﻥ
panon	پﺍﻥﻥ
pant	پﺍﻥﺕ
panton	پﻥﺕﻭﻥ
panvalkar	پﺍﻥﻭﺍﻝکﺭ
papay	پﺍپﺍی
pape	پیپ
paplaskas	پﺍپﻝﺍﺱکﺍﺱ
papp	پﺍپ
pappalardo	پﺍپﺍﻝﺍﺭﺩﻭ
paquet	پﺍکﻭﺍﺕ
paradise	پﺭﺩیﺱ
parayil	پﺍﺭﺍیﻝ
pardes	پﺍﺭﺩﺯ
pardi	پﺍﺭﺩی
pardington	پﺍﺭیﻥگﺕﻭﻥ
pardon	پﺍﺭﺩﻥ
parent	پﺭﻥﺕ
parham	پﺍﺭﻩﺍﻡ
pariente	پﺭیﻥﺕ
park	پﺍﺭک
parkin	پﺍﺭکیﻥ
parks	پﺍﺭکﺯ
parmar	پﺍﺭﻡﺍﺭ
parnass	پﺍﺭﻥﺱ
parra	پﺍﺭﺍ
parratt	پﺍﺭﺍﺕ
parrish	پﺍﺭیﺵ
parrone	پﺭﻭﻥ
parry	پﺍﺭی
parson	پﺍﺭﺱﻥ
parsons	پﺍﺭﺱﺍﻥﺯ
partee	پﺍﺭﺕی
parton	پﺍﺭﺕﻭﻥ
partos	پﺍﺭﺕﻭﺱ
parvin	پﺭﻭیﻥ
pascal	پﺍﺱکﺍﻝ
pasco	پﺍﺱکﻭ
pasko	پﺍﺱکﻭ
pass	پﺍﺱ
passier	پﺍﺱیﺭ
pasternak	پﺍﺱﺕﺭﻥﺍک
pastore	پﺍﺱﺕﻭﺭ
patella	پﺕﻝﺍ
paterson	پﺍﺕﺭﺱﻭﻥ
patetta	پﺍﺕﺕﺍ
pathyil	پﺕیﻝ
pati	پﺕی
patience	پیﺵﻥﺱ
patil	پﺍﺕیﻝ
patkar	پﺕکﺭ
patocchi	پﺍﺕﻭچی
patric	پﺍﺕﺭیک
patrice	پﺍﺕﺭیﺱ
patricia	پﺍﺕﺭیﺱیﺍ
patrick	پﺍﺕﺭیک
patrik	پﺍﺕﺭیک
patrizio	پﺍﺕﺭیﺯیﻭ
patroclus	پﺍﺕﺭﻭکﻝﻭﺱ
patsy	پﺕﺱی
patten	پﺍﺕﻥ
patterson	پﺍﺕﺭﺱﻭﻥ
patti	پﺕی
patty	پﺕی
patuxent	پﺍﺕﻭکﺱﻥﺕ
pauli	پﺍﻝی
paulsen	پﺍﻝﺱﻥ
paulson	پﺍیﻭﻝﺱﻭﻥ
paultje	پﺍیﻭﺕﻩ
pavlik	پﺍﻭﻝیک
pavol	پﺍﻭﻝ
pax	پﺍکﺱ
payette	پیﺕ
payne	پیﻥ
paynter	پیﻥﺕﺭ
paynton	پیﻥﺕﻥ
paysan	پیﺱﺍﻥ
payton	پﺍیﺕﻭﻥ
peabody	پیﺏﺍﺩی
peade	پیﺩ
peak	پیک
peaks	پیکﺯ
pearce	پیﺭﺱ
pearl	پیﺭﻝ
pearlman	پیﺭﻝﻡﺍﻥ
pearman	پیﺭﻡﻥ
pearsen	پیﺭﺱﻥ
pearson	پیﺭﺱﻥ
peart	پیﺭﺕ
peasah	پیﺱﺍﻩ
pease	پیﺱ
peat	پیﺕ
pecenko	پﺱﻥکﻭ
pedersen	پﺩﺭﺱﻥ
pedram	پﺩﺭﺍﻡ
peed	پیﺩ
peet	پیﺕ
pegg	پگ
pegram	پگﺭﺍﻡ
peil	پیﻝ
peipp	پیپ
pelham	پﻝﻩﺍﻡ
pelkie	پﻝکی
pellant	پﻝﺍﻥﺕ
pellecchia	پﻝکچیﺍ
pelletier	پﻝﺕییﺭ
pelligrini	پﻝیگﺭیﻥی
peloso	پیﻝﺍﺯﻭ
pelt	پﻝﺕ
peltonen	پﻝﺕﻥﻥ
pence	پﻥﺱ
pendleton	پﻥﺩﻝﺕﻥ
peng	پﻥگ
pengadu	پﻥگﺍﺩﻭ
peninsula	پﻥیﻥﺯﻭﻝﺍ
pennebaker	پﻥﺏﺍکﺭ
pennell	پﻥﻝ
penniman	پﻥیﻡﺍﻥ
penny	پﻥی
pepe	پپﻩ
pepin	پپیﻥ
peppler	پپﻝﺭ
percival	پﺭﺱیﻭﺍﻝ
perdicaro	پﺭﺩیکﺍﺭﻭ
perdikis	پﺭﺩیکیﺱ
pereckas	پﺭکﺍﺱ
perel	پﺭﻝ
perez	پیﺭیﺯ
perillo	پﺭیﻝﻭ
pering	پﺭیﻥگ
perini	پﺭیﻥی
perkins	پﺭکیﻥﺯ
perler	پﺭﻝﺭ
perley	پﺭﻝی
perlman	پﺭﻝﻡﺍﻥ
perpk	پﺭپک
perrault	پﺭﺍﻝﺕ
perreault	پﺭیﺍﻭﻝﺕ
perricone	پﺭیکﻥ
perrin	پﺭیﻥ
perry	پﺭی
persson	پﺭﺱﻭﻥ
peskin	پﺱکیﻥ
petcher	پﺕچﺭ
peter	پیﺕﺭ
peters	پیﺕﺭ
petersson	پیﺕﺭﺱﻭﻥ
petit	پﻭﺕیﺕ
petite	پﻭﺕیﺕ
petitjean	پﺕیﺕﺝیﻥ
petren	پﺕﺭﻥ
petrich	پﺕﺭیچ
petro	پﺕﺭﻭ
petronella	پﺕﺭﻭﻥﻝﺍ
petrov	پﺕﺭﻭﻑ
petrovich	پﺕﺭﻭیچ
petrow	پیﺕﺭﻭ
petry	پﺕﺭی
pettibone	پیﺕیﺏﻭﻥ
petto	پﺕﻭ
petzold	پﺕﺯﻭﻝﺩ
pezaris	پﺯﺍﺭﺍیﺱ
phi	ﻑی
phiaxay	ﻑیﺍکﺱی
phil	ﻑیﻝ
philip	ﻑیﻝیپ
philips	ﻑیﻝیپﺱ
phill	ﻑیﻝ
phillips	ﻑیﻝپﺱ
philpot	ﻑیﻝپﺍﺕ
phils	ﻑیﻝﺯ
phipps	ﻑیپﺱ
phiroze	ﻑیﺭﻭﺯ
phlux	ﻑیﻝﺍکﺱ
phong	ﻑﻭﻥگ
phoque	ﻑﻭکﻭ
phrink	ﻑﺭیﻥک
phua	پﺍﻭ
phuong	ﻑﺍﻥگ
phylos	ﻑیﻝﻭﺱ
piatek	پیﺍﺕک
picasso	پیکﺍﺱﻭ
piccolboni	پیکﻭﻝﺏﻥی
piche	پیﺵﻩ
pickard	پیکﺍﺭﺩ
pickel	پیکﻝ
pickrell	پیکﺭﻝ
pickup	پیکﺍپ
pieck	پیک
pieper	پیپﺭ
pier	پیﺭ
pieri	پییﺭی
piero	پیﺭﻭ
piers	پیﺭﺱ
pierson	پیﺭﺱﻥ
pieter	پیﺕﺭ
pietje	پیﺍﺕﺝی
pike	پیک
pil	پیﻝ
pilato	پیﻝﺍﺕﻭ
pilewski	پیﻝﻭﺱکی
pillar	پیﻝﺍﺭ
pillars	پیﻝﺍﺭﺯ
pillay	پیﻝی
pillsbury	پیﻝیﺱﻥﺭی
pilvio	پیﻝﻭیﻭ
pina	پیﻥﺍ
pinchas	پیﻥچﺍﺯ
pinchera	پیﻥچﺭﺍ
pindar	پیﻥﺩﺍﺭ
pinedo	پیﻥﺩﻭ
pinette	پیﻥﺕﻩ
ping	پیﻥگ
pingenot	پیﻥگﻥﻭﺕ
pinkham	پیﻥخﺍﻡ
pinkowitz	پیﻥکﻭﻭیﺕﺯ
pinky	پیﻥکی
pinn	پیﻥ
pinnacle	پیﻥﺍکﻝ
pinnow	پیﻥﻭ
pino	پیﻥﻭ
pins	پیﻥﺯ
pinson	پیﻥﺱﻥ
pinter	پیﻥﺕﺭ
pinton	پیﻥﺕﻭﻥ
pinyan	پیﻥیﺍﻥ
piomelli	پیﻭﻡﻝی
pion	پیﻭﻥ
piotr	پیﻭﺕﺭ
piper	پﺍیپﺭ
pipgras	پیپگﺭﺍﺱ
piponi	پیپﻭﻥی
piran	پیﺭﺍﻥ
pirani	پیﺭﺍﻥی
pirard	پیﺭﺍﺭﺩ
pirawat	پیﺭﺍﻭﺍﺕ
pirih	پیﺭی
pirkko	پیﺭکﻭ
piroz	پیﺭﻭﺯ
pistun	پیﺱﺕﻭﻥ
pitha	پیﺕﺍ
pitkow	پیﺕکﻭ
pitman	پیﺕﺍﻥ
pitre	پﺍیﺕﺭ
pittman	پیﺕﻡﻥ
pitts	پیﺕﺱ
pivnick	پیﻭﻥیک
piziali	پیﺯیﺍﻝی
pizolato	پیﺯﻭﻝیﺕﻭ
pizza	پیﺯﺍ
pizzi	پیﺯی
pizzini	پیﺯیﻥی
plache	پﻝچ
plack	پﻝﺍک
plamen	پﻝﺍﻡﻥ
plante	پﻝﻥﺕﻩ
plastino	پﻝﺍﺱﺕیﻥﻭ
plat	پﻝﺕ
plate	پﻝیﺕ
plateau	پﻝﺍﺕیﻭ
platform	پﻝﺍﺕﻑﻭﺭﻡ
plath	پﻝﺍﺕ
platkus	پﻝﺕکﻭﺱ
plencner	پﻝﻥکﻥﺭ
pletcher	پﻝﺕچﺭ
plinskin	پﻝیﻥﺱکیﻥ
pliskin	پﻝیﺱکیﻥ
ploehn	پﻝﻭﻩﻥ
plott	پﻝﺍﺕ
plummer	پﻝﺍﻡﺭ
plunk	پﻝﺍﻥک
plyler	پﻝﺍیﺭ
poblete	پﺍﺏﻝﺕ
pogosyan	پﻭگﻭﺱیﺍﻥ
poh	پﻭﻩ
pohar	پﻭﻩﺍﺭ
pohl	پﻭﻩﻝ
point	پﻭیﻥﺕ
poirier	پیﺭیﺭ
poisl	پﻭیﺱﻝ
pokorny	پﻭکﻭﺭﻥی
poland	پﻭﻝﻥﺩ
polant	پﻭﻝﻥﺕ
polemitis	پﻭﻝﻡیﺕیﺱ
polen	پﻭﻝﻥ
polepalli	پﻭﻝیپﺍﻝی
poling	پﻭﻝیﻥگ
polis	پﻭﻝیﺱ
politte	پﻭﻝیﺕ
polk	پﻭﻝک
pollen	پﻭﻝﻥ
polo	پﻭﻝﻭ
polowin	پﻭﻝﻭﻭیﻥ
polsky	پﺍﻝﺱکی
polson	پﻭﻝﺱﻥ
ponder	پﺍﻥﺩﺭ
ponds	پﺍﻥﺩﺯ
pool	پﻭﻝ
poore	پﻭﺭ
poosala	پﻭﺱﺍﻝﺍ
poot	پﻭﺕ
popat	پﻭپﺍﺕ
pope	پﺍپ
popli	پﺍپﻝی
popovic	پﺍپﻭیک
popp	پﻭپ
poppen	پﺍپﻥ
poppleton	پﺍپﻝﺕﻭﻥ
porcino	پﺭﺱیﻥﻭ
porco	پﻭﺭکﻭ
porges	پﻭﺭﺝﺯ
porterfield	پﻭﺭﺕﺭﻑیﻝﺩ
portnoy	پﻭﺭﺕﻥﻭی
posen	پﻭﺱﻥ
posh	پﻭﺵ
posius	پﻭﺯیﻭﺱ
poso	پﻭﺱﻭ
post	پﺱﺕ
postill	پﻭﺱﺕیﻝ
postma	پﺱﺕﻡﺍ
potter	پﺍﺕﺭ
potts	پﺍﺕﺱ
poulakos	پﻭﻝﺍکﻭﺱ
poulos	پﻭﻝﺱ
poulsen	پﺍﻭﻝﺱﻥ
poulter	پﻭﻝﺕﺭ
poutre	پﻭﺕﺭی
pouw	پﺍﻭﻭ
powles	پﺍﻭﻝﺱ
poynting	پﻭیﻥﺕیﻥگ
prado	پﺭﺍﺩﻭ
prael	پﺭﺍیﻝ
prague	پﺭﺍگﻭ
prahl	پﺭﺍﻩﻝ
praktikum	پﺭﺍکﺕیکﻭﻡ
prall	پﺭﺍﻝ
pram	پﺭﺍﻡ
pramod	پﺭﺍﻡﻭﺩ
pranav	پﺭﺍﻥﺍﻭ
pranke	پﺭﺍﻥک
prasad	پﺭﺍﺱﺍﺩ
prasana	پﺭﺍﺱﺍﻥﺍ
prasen	پﺭﺍﺱﻥ
prashant	پﺭﺍﺵﺍﻥﺕ
pratap	پﺭﺍﺕپ
pratchett	پﺭﺍچﺕ
prateek	پﺭﺍﺕیک
prates	پﺭﺍﺕﺱ
pratiksh	پﺭﺍﺕیکﺵ
pratt	پﺭﺍﺕ
prattico	پﺭﺍﺕیکﻭ
pratul	پﺭﺍﺕﻭﻝ
praveen	پﺭﺍﻭیﻥ
preben	پﺭﺏﻥ
preble	پﺭیﺏﻝ
prech	پﺭچ
prechelt	پﺭﺵﻝﺕ
preedy	پﺭیﺩی
preeti	پﺭیﺕی
preisler	پﺭیﺱﻝﺭ
premal	پﺭﻡﺍﻝ
prentiss	پﺭیﻥﺱﺱ
prescott	پﺭیﺱکﺍﺕ
prestero	پﺭﺱﺕﺭﻭ
preston	پﺭیﺱﺕﻭﻥ
prestrud	پﺭﺱﺕﺭﻭﺩ
pretty	پﺭیﺕی
preuss	پﺭیﻭﺱ
prevost	پﺭیﻭﺱﺕ
pribe	پﺭﺍیﺏ
pricing	پﺭیﺱیﻥگ
prickett	پﺭیکﺕ
prickly	پﺭیکﻝی
priest	پﺭیﺱﺕ
priestley	پﺭیﺱﺕﻝی
priestly	پﺭیﺱﺕﻝی
prime	پﺭﺍیﻡ
primeau	پﺭیﻡﻭ
primero	پﺭیﻡﺭﻭ
primus	پﺭیﻡیﻭﺱ
prince	پﺭیﻥﺱ
priotti	پﺭییﻭﺕی
priscilla	پﺭیﺱیﻝﺍ
pritchard	ﺭیچﺍﺭﺩ
pritz	پﺭیﺕﺯ
private	پﺭﺍیﻭیﺕ
priven	پﺭﺍیﻭﻥ
priya	پﺭیﺍ
probst	پﺭﺍﺏﺱﺕ
progetto	پﺭﻭگﺕﻭ
projet	پﺭﻭﺝﺕ
promontory	پﺭﻭﻡﻭﻥﺕﻭﺭی
prongs	پﺭﺍﻥگﺱ
proos	پﻭﺭﻭﺱ
propes	پﺭﻭپﺱ
prothero	پﺭﻭﺕﺭﻭ
protus	پﺭﻭﺕﻭﺱ
provan	پﺭﻭﺍﻥ
provo	پﺭﻭﻭ
provost	پﺭﻭﻭﺱﺕ
prowell	پﺭﺍﻭﻝ
pruemmer	پﺭﻭﺍﻡﺭ
prupis	پﺭﺍپیﺱ
prush	پﺭﺍﺵ
pruss	پﺭﻭﺱ
pruy	پﺭﻭی
pryor	پﺭیﻭﺭ
psyko	ﺱﺍیکﻭ
puah	پﻭﺍ
puckett	پﺍکﺕ
puelma	پﻭﺍﻝﻡﺍ
puga	پﻭگﺍ
pugh	پیﻭ
pugliese	پﺍگﻝیﺱ
puhan	پﻭﻩﺍﻥ
pui	پییﻭ
pulford	پﺍﻝﻑﻭﺭﺩ
pulgar	پﻭﻝگﺍﺭ
pulido	پﺍﻝیﺩﻭ
pulley	پﺍﻝی
pulliam	پﻭﻝییﺍﻡ
pulsifer	پﺍﻝﺱیﻑﺭ
puma	پﻭﻡﺍ
pumfrey	پﺍﻡﻑﺭی
puna	پﻭﻥﺍ
punch	پﺍﻥچ
punjabi	پﺍﻥﺝﺍﺏی
punnoose	پﻭﻥﻭﺯ
purahoo	پﻭﺭﺍﻩﻭ
puranik	پﻭﺭﺍﻥیک
purcell	پﺍﺭﺱﻝ
purinton	پیﻭﺭیﻥﺕﻥ
pursell	پﺭﺱﻝ
purshottam	پﺭﺵﺍﺕﺕﺍﻡ
purvis	پﺭﻭیﺱ
puryear	پﻭﺭیﺭ
pusey	پﻭﺱی
putkonen	پﻭﺕکﻭﻥﻥ
putz	پﻭﺕﺯ
puusaari	پﻭﺱﺍﺭی
pyramid	پیﺭﺍﻡیﺩ
pyziur	پیﺯیﺭ
qadir	کﺩیﺭ
qadira	کﺩیﺭﺍ
qadisiyah	کﺩیﺱیﺍ
qamar	کﻡﺭ
qasim	کﺱیﻡ
quackenboss	کﻭکﻥﺏﺍﺱ
quainton	کﻭییﻥﺕﻭﻥ
quartzite	کﻭﺍﺭﺕﺯیﺕﻩ
quasim	کﺱیﻡ
quatrain	کﻭﺍﺕﺭیﻥ
qubilah	کﻭﺏیﻝﺍ
qudamah	کﻭﺩﺍﻡﺍ
que	کﻭیی
quel	کﻭیﻝ
querin	کﻭیﺭیﻥ
quesada	کﻭﺱﺍﺩﺍ
quezon	کیﻭﺯﻭﻥ
quickle	کﻭییکﻝ
quilici	کﻭﺍیﻝیﺱی
quillin	کﻭییﻝیﻥ
quin	کﻭیﻥ
quinby	کﻭﺍﻥﺏﺍی
quinlan	کﻭییﻥﻝﻥ
quinn	کﻭیﻥ
quint	کﻭیﻥﺕ
quintana	کﻭیﻥﺕﺍﻥﺍ
quintanar	کﻭییﻥﺕﺍﻥﺍﺭ
quist	کﻭییﺱﺕ
quitt	کﻭییﺕ
quoc	کﻭک
quock	کیﻭک
quodling	کﺍﻭﺩﻝیﻥگ
rabel	ﺭﺍﺏﻝ
raben	ﺭﺍﺏﻥ
rabenau	ﺭﺍﺏﻥﺍﻭ
rabiah	ﺭﺍﺏیﻉﻩ
rabkin	ﺭﺍﺏکیﻥ
raboel	ﺭﺍﺏﻭیﻝ
rabold	ﺭﺍﺏﻝﺩ
racecar	ﺭیﺱکﺍﺭ
rachael	ﺭﺍچﻝ
rachel	ﺭﺍﺵﻝ
racho	ﺭﺍکﻭ
racicot	ﺭﺍکیکﻭﺕ
rad	ﺭﺍﺩ
radbone	ﺭﺍﺩﺏﻭﻥ
radboud	ﺭﺍﺩﺏﻭﺩ
radcliff	ﺭﺍﺩکﻝیﻑ
radek	ﺭﺍﺩک
radenburch	ﺭیﺩﻥﺏﺭچ
radenburgerabroek	ﺭیﺩﻥﺏﺭگیﺭﺏﺭﺍک
rader	ﺭﺍﺩﺭ
radeyah	ﺭﺍﺩیﺍﻩ
radha	ﺭﺍﺩﻩﺍ
radhika	ﺭﺍﺩﻩیکﺍ
radig	ﺭﺍﺩیﻥگ
radjen	ﺭﺍﺝﻥ
radov	ﺭﺍﺩﻭﻑ
radu	ﺭﺍﺩﻭ
radwa	ﺭﺍﺩﻭﺍ
rafa	ﺭﺍﻑﺍ
rafael	ﺭﺍﻑیﻝ
rafaeli	ﺭﺍﻑﺍیﻝی
rafal	ﺭﺍﻑﺍﻝ
rafalko	ﺭﺍﻑﺍﻝکﻭ
rafalski	ﺭﺍﻑﺍﻝﺱکی
rafat	ﺭﻑﻉﺕ
rafferty	ﺭﺍﻑﺭﺕی
raffin	ﺭﺍﻑیﻥ
rafi	ﺭﺍﻑی
rafique	ﺭﺍﻑیکیﻭ
ragan	ﺭیگﺍﻥ
ragatz	ﺭﺍگﺍﺕﺯ
raghd	ﺭﻍﺩ
ragland	ﺭﺍگﻝﻥﺩ
ragle	ﺭﺍگﻝ
ragnar	ﺭﺍگﻥﺍﺭ
ragnarsson	ﺭﺍگﻥﺍﺭﺱﻭﻥ
ragnvald	ﺭﺍگﻥﻭﺍﻝﺩ
ragsdale	ﺭﺍگﺱﺩیﻝ
rahardjo	ﺭﺍﻩﺍﺭﺝﻭ
rahi	ﺭﺍﻩی
rahim	ﺭﺡیﻡ
rahimah	ﺭﺡیﻡﺍﻩ
rahul	ﺭﺍﻩﻭﻝ
rai	ﺭﺍی
raicer	ﺭیﺱﺭ
raidah	ﺭیﺩﺍ
raile	ﺭﺍیﻝی
railsback	ﺭیﻝﺱﺏک
raimond	ﺭیﻡﻭﻥﺩ
raimund	ﺭیﻡﻭﻥﺩ
rainald	ﺭیﻥﺍﻝﺩ
rainer	ﺭیﻥﺭ
raistlin	ﺭﺍیﺱﺕﻝیﻥ
raisty	ﺭیﺱﺕی
raith	ﺭیﺕ
raivo	ﺭیﻭﻭ
raizel	ﺭﺍیﺯﻝ
raj	ﺭﺍﺝ
rajas	ﺭﺝﺍﺱ
rajat	ﺭﺝﺍﺕ
rajcher	ﺭﺍﺝچﺭ
rajeev	ﺭﺍﺝیﻭ
rajender	ﺭﺍﺝﻥﺩﺭ
raju	ﺭﺍﺝﻭ
ralf	ﺭﺍﻝﻑ
ralph	ﺭﺍﻝﻑ
ram	ﺭﺍﻡ
rama	ﺭﺍﻡﺍ
rambo	ﺭﺍﻡﺏﻭ
ramer	ﺭﺍﻡﺭ
ramesh	ﺭﺍﻡﺵ
ramez	ﺭﺍﻡﺯ
rami	ﺭﺍﻡی
ramiro	ﺭﺍﻡیﺭﻭ
ramm	ﺭﺍﻡ
ramos	ﺭﺍﻡﻭﺱ
rampling	ﺭﻡپﻝیﻥگ
ramseier	ﺭﺍﻡﺱیﺭ
ramsey	ﺭﺍﻡﺱی
ramthun	ﺭﺍﻡﺕﺍﻥ
rana	ﺭﺍﻥﺍ
rander	ﺭﺍﻥﺩﺭ
randhol	ﺭﻥﺩﻩﻝ
randy	ﺭﻥﺩی
rane	ﺭیﻥ
ranu	ﺭﺍﻥیﻭ
rao	ﺭﺍیﻭ
raoult	ﺭﺍﻭﻝﺕ
raqqah	ﺭککﺍﻩ
raschke	ﺭﺍﺵکﻩ
rasha	ﺭﺍﺵﺍ
rashed	ﺭﺍﺵﺩ
rashid	ﺭﺍﺵیﺩ
rashida	ﺭﺵیﺩ
raskin	ﺭﺍﺱکیﻥ
raso	ﺭﺍﺱﻭ
rastin	ﺭﺍﺱﺕیﻥ
rasu	ﺭﺍﺱﻭ
rasul	ﺭﺱﻭﻝ
rat	ﺭﺕ
ratcheson	ﺭﺍﺕچﺱﻭﻥ
ratcliffe	ﺭﺕکﻝیﻑ
rath	ﺭﺍث
rathmann	ﺭﺍﺕﻡﻥ
rau	ﺭﺍﻭ
rauh	ﺭﺍﻭ
rautiala	ﺭﺍیﻭﺕیﺍﻝﺍ
raverdy	ﺭﺍﻭﺭﺩی
ravey	ﺭﺍﻭی
ravi	ﺭﺍﻭی
ravindran	ﺭﺍﻭیﻥﺩﺭﺍﻥ
raviraj	ﺭﺍﻭیﺭﺍﺝ
rawdah	ﺭﺍﻭﺩﺍ
rawiyah	ﺭﺍﻭیﺍﻩ
rawlings	ﺭﺍیﻭﻝیﻥگﺯ
ray	ﺭی
rayburn	ﺭیﺏﺭﻥ
rayer	ﺭییﺭ
rayle	ﺭﺍیﻝﻩ
raymond	ﺭیﻡﻥﺩ
rayner	ﺭﺍیﻥﺭ
razdan	ﺭﺍﺯﺩﺍﻥ
razorback	ﺭﺍﺯﻭﺭﺏک
rbeis	ﺭﺏیﺱ
reamy	ﺭیﻡی
reardon	ﺭیﺭﺩﺍﻥ
rears	ﺭیﺭﺯ
reaser	ﺭیﺱﺭ
reasor	ﺭیﺱﻭﺭ
reavis	ﺭیﻭیﺱ
reback	ﺭیﺏک
rebholz	ﺭﺏﻩﻭﻝﺯ
reboso	ﺭﺏﻭﺱﻭ
rechelle	ﺭﺵﻝ
reckdahl	ﺭکﺩﺍﻝ
reckeweg	ﺭکﻭگ
reddy	ﺭﺩی
redfield	ﺭﺩﻑیﻝﺩ
redlus	ﺭﺩﻝﻭﺱ
redman	ﺭﺩﻡﻥ
redmill	ﺭﺩﻡیﻝ
redondo	ﺭﺩﻭﻥﺩﻭ
reed	ﺭییﺩ
reenalda	ﺭیﻥﺍﻝﺩﺍ
reese	ﺭیﺯ
reetz	ﺭیﺕﺯ
refsnes	ﺭﻑﺱﻥﺱ
refson	ﺭﻑﺱﻭﻥ
reg	ﺭﺝ
regard	ﺭیگﺍﺭﺩ
rego	ﺭگﻭ
rehling	ﺭﻩﻝیﻥگ
reidy	ﺭیﺩی
reierson	ﺭیﺭﺱﻭﻥ
reiland	ﺭیﻝﻥﺩ
reilley	ﺭیﻝی
reinders	ﺭیﻥﺩﺭﺯ
reindert	ﺭیﻥﺩﺭﺕ
reinert	ﺭیﻥﺭﺕ
reinold	ﺭیﻥﻭﻝﺩ
reinolda	ﺭیﻥﻝﺩﺍ
reinoud	ﺭیﻥﻭﺩ
reiser	ﺭیﺯﺭ
reisner	ﺭیﺱﻥﺭ
reiss	ﺭیﺱ
reissner	ﺭیﺱﻥﺭ
reksten	ﺭکﺱﺕﻥ
remde	ﺭﻡﺩ
remlinger	ﺭﻡﻝیﻥگﺭ
remmen	ﺭﻡﻥ
rempfer	ﺭﻡﻑﺭ
remy	ﺭﻡی
renalds	ﺭﻥﺍﻝﺩﺯ
renaud	ﺭﻥﺍﻭﺩ
renault	ﺭﻥﺍﻝﺕ
rendar	ﺭﻥﺩﺭ
rennebarth	ﺭﻥﺏﺍﺭﺕ
renvoise	ﺭﻥﻭیﺱ
renze	ﺭﻥﺯ
renzland	ﺭﻥﺯﻝﻥﺩ
reodique	ﺭیﺩیگ
replogle	ﺭپﻝﺍگﻝ
reppert	ﺭپﺭﺕ
repton	ﺭپﺕﻭﻥ
research	ﺭیﺱﺭچ
resele	ﺭﺱﻝ
resnick	ﺭیﺱﻥیک
resolveert	ﺭﺯﻭﻝﻭﺭﺕ
resonate	ﺭﺱﻭﻥﺍﺕ
rest	ﺭﺱﺕ
resyntje	ﺭﺯیﻥﺕ
retzer	ﺭیﺕﺯﺭ
reuber	ﺭیﻭﺏﺭ
revelo	ﺭﻭﻝﻭ
revuluri	ﺭﻭﻭﻝﻭﺭی
rey	ﺭی
reyden	ﺭیﺩﻥ
reyes	ﺭیﺱ
reymont	ﺭیﻡﺍﻥﺕ
reynolds	ﺭیﻥﺍﻝﺩﺯ
reynoldson	ﺭیﻥﻭﻝﺩﺱﻭﻥ
rheni	ﺭﻥی
ribar	ﺭیﺏﺍﺭ
ribner	ﺭیﻥﺭ
rich	ﺭیچ
richar	ﺭیچﺍﺭ
richardson	ﺭیچﺍﺭﺩﺱﻥ
richau	ﺭیچﺍﻭ
richer	ﺭیچﺭ
richey	ﺭیچی
richmann	ﺭیچﻡﻥ
richmeyer	ﺭیچﻡیﺭ
richolson	ﺭیکﻭﻝﺱﻭﻥ
rickard	ﺭیکﺍﺭﺩ
ricker	ﺭیکﺭ
rickert	ﺭیکﺭﺕ
ricketts	ﺭیکﺕﺯ
ricky	ﺭیکی
rida	ﺭیﺩﺍ
riddle	ﺭیﺩﻝ
ridge	ﺭیگ
rieb	ﺭیﺏ
riedel	ﺭﺍیﺩﻝ
riehle	ﺭیﻩﻝ
riel	ﺭیﻝ
riemens	ﺭیﻡﻥﺯ
riemers	ﺭیﻡﺭﺱ
rienks	ﺭییﻥکﺱ
riepe	ﺭﺍیپ
ries	ﺭیﺱ
riese	ﺭیﺱ
riffle	ﺭﺍیﻑﻝ
rifkind	ﺭیﻑکﺍیﻥﺩ
riggins	ﺭیگیﻥﺯ
rights	ﺭﺍیﺕﺯ
rigler	ﺭیگﻝﺭ
rigo	ﺭیگﻭ
rihana	ﺭیﺡﺍﻥﺍ
rijkaard	ﺭیکﺍﺭﺩ
rijswijk	ﺭیﺝﺱﻭیک
rim	ﺭیﻡ
rimoni	ﺭﻡﻭﻥی
rindner	ﺭیﻥﺩﻥﺭ
ring	ﺭیﻥگ
ringuest	ﺭیﻥگﺱﺕ
ringwood	ﺭیﻥگﻭﻭﺩ
rinker	ﺭیﻥکﺭ
rinn	ﺭیﻥ
rinne	ﺭیﻥﻩ
rintoul	ﺭیﻥﺕﻭﻝ
riopka	ﺭیﻭپکﺍ
riordon	ﺭیﺭﺩﺍﻥ
rippel	ﺭیپﻝ
rischar	ﺭیﺵﺍﺭ
risel	ﺭﺍیﺱﻝ
rishah	ﺭیﺵﺍﻩ
risley	ﺭیﺱﻝی
risto	ﺭیﺱﺕﻭ
rita	ﺭیﺕﺍ
ritacco	ﺭیﺕﺍکﻭ
ritchie	ﺭیچی
ritsgert	ﺭیﺕﺯگﺭﺕ
rittweger	ﺭیﺕﻭگﺭ
rivard	ﺭیﻭﺍﺭﺩ
river	ﺭیﻭﺭ
rivers	ﺭیﻭﺭﺯ
rivoire	ﺭیﻭیﺭﻩ
rixon	ﺭیکﺱﻭﻥ
riyad	ﺭییﺍﺩ
rizvi	ﺭیﺯﻭی
rizzo	ﺭیﺯﻭ
roa	ﺭﻭ
roach	ﺭﻭچ
roar	ﺭﻭﺭ
roath	ﺭﻭﺕ
robb	ﺭﺍﺏ
robbin	ﺭﺍﺏیﻥ
robbins	ﺭﻭﺏیﻥﺯ
robby	ﺭﺍﺏی
roberge	ﺭﻭﺏﺭﺝ
robert	ﺭﺍﺏﺭﺕ
roberta	ﺭﻭﺏﺭﺕﺍ
roberto	ﺭﻭﺏﺭﺕﻭ
robertson	ﺭﺍﺏﺭﺕﺱﻥ
robey	ﺭﺍﺏی
robideaux	ﺭﺍﺏیﺩیﺍکﺱ
robijn	ﺭﺍﺏیﺝﻥ
robinson	ﺭﺍﺏیﻥﺱﻥ
roboz	ﺭﻭﺏﻭﺯ
roby	ﺭﻭﺏی
rocca	ﺭﻭکﺍ
roch	ﺭﺍک
roche	ﺭﻭچ
rockel	ﺭﺍکﻝ
rodberg	ﺭﺍﺩﺏﺭگ
roder	ﺭﺍﺩﺭ
roderick	ﺭﺩﺭیک
rodman	ﺭﺍﺩﻡﻥ
rodrigue	ﺭﻭﺩﺭیگﻭ
rodriguez	ﺭﻭﺩﺭیگﺯ
roe	ﺭﻭ
roeber	ﺭﻭﺏﺭ
roebuck	ﺭیﺏﺍک
roehrig	ﺭﺍﻩﺭیگ
roepcke	ﺭﻭیپک
roepke	ﺭﻭپکﻩ
roesner	ﺭﻭﺍﺯﻥﺭ
roff	ﺭﺍﻑ
rogalsky	ﺭﻭگﺍﻝﺱکی
rogero	ﺭﺍگﺭﻭ
rogers	ﺭﺍﺝﺭ
rognerud	ﺭﺍگﻥﺭﺩ
rogoza	ﺭﻭگﻭﺯﺍ
rohan	ﺭﻭﻩﺍﻥ
rohbeck	ﺭﺍﻩﺏک
rohde	ﺭﻭﺩ
rohm	ﺭﻭﻩﻡ
rohn	ﺭﺍﻥ
rohrer	ﺭﺍﻩﺭﺭ
roimata	ﺭﻭیﻡﺍﺕﺍ
rojas	ﺭﺍﺝﺱ
rokicki	ﺭﻭکیکی
roldan	ﺭﻭﻝﺩﺍﻥ
rolfe	ﺭﺍﻝﻑ
rolff	ﺭﻭﻝﻑ
romanchik	ﺭﻡﻥچیک
romans	ﺭﻡﻥﺱ
romero	ﺭﻭﻡیﻭ
romig	ﺭﻭﻡیگ
romulus	ﺭﺍﻡﻭﻝﻭﺱ
ron	ﺭﺍﻥ
ronald	ﺭﻭﻥﺍﻝﺩ
ronda	ﺭﻭﻥﺩﺍ
rondane	ﺭﻭﻥﺩیﻥ
ronde	ﺭﻭﻥﺩﻩ
rongel	ﺭﺍﻥگﻝ
rongo	ﺭﻭﻥگﻭ
roni	ﺭﻭﻥی
ronit	ﺭﻭﻥیﺕ
ronkin	ﺭﺍﻥکیﻥ
ronne	ﺭﺍﻥ
ronnen	ﺭﺍﻥﻥ
ronni	ﺭﺍﻥی
ronnie	ﺭﺍﻥی
rontgen	ﺭﺍﻥﺕگﻥ
rony	ﺭﺍﻥی
rood	ﺭﻭﺩ
roodenburg	ﺭﻭﺩﻥﺏﺭگ
rookery	ﺭﻭکﺭی
rooks	ﺭﻭکﺯ
rooney	ﺭﻭﻥی
roosevelt	ﺭﻭﺯﻭﻝﺕ
root	ﺭﻭﺕ
rootes	ﺭﻭﺕﺱ
rooyen	ﺭﻭیﻥ
ropebrake	ﺭﺍپﺏﺭیک
roper	ﺭﺍپﺭ
rory	ﺭﻭﺭی
rosa	ﺭﻭﺱﺍ
rosaire	ﺭﻭﺯیﺭ
rosalyn	ﺭﻭﺱﺍﻝیﻥ
rosana	ﺭﻭﺱﺍﻥﺍ
roscoe	ﺭﻭکﻭ
roseberry	ﺭﺯﺏﺭی
rosemarie	ﺭﻭﺯﻡﺍﺭی
rosemary	ﺭﻭﺯﻡﺍﺭی
rosen	ﺭﻭﺯﻥ
rosenbaum	ﺭﺯﻥﺏﺍﻭﻡ
rosenblatt	ﺭﻭﺱﻥﺏﻝﺍﺕ
rosencrans	ﺭﺯﻥکﺭﺍﻥﺱ
rosendale	ﺭﺍﺱﻥﺩیﻝ
rosenfeld	ﺭﺯﻥﻑﻝﺩ
rosenfelder	ﺭﻭﺯﻥﻑﻝﺩﺭ
rosenjack	ﺭﻭﺯﻥﺝک
rosenlof	ﺭﺯﻥﻝﻑ
rosenman	ﺭﺍﺱﻥﻡﺍﻥ
rosham	ﺭﻭﺵﺍﻡ
rosie	ﺭﻭﺯی
rosita	ﺭﻭﺯیﺕﺍ
roslyn	ﺭﻭﺱﻝیﻥ
ross	ﺭﺍﺱ
rosselin	ﺭﻭﺱﻝیﻥ
rossen	ﺭﺍﺯﻥ
rosser	ﺭﻭﺱﺭ
rossiter	ﺭﻭﺱیﺕﺭ
rossman	ﺭﺍﺱﻡﻥ
rossner	ﺭﻭﺱﻥﺭ
rosson	ﺭﻭﺱﻭﻥ
rossum	ﺭﺍﺱﻭﻡ
rostad	ﺭﻭﺱﺕﺍﺩ
rostand	ﺭﻭﺱﺕﻥﺩ
roston	ﺭﺍﺱﺕﻥ
rostrom	ﺭﺍﺱﺕﺭﺍﻡ
rosu	ﺭﻭﺱﻭ
rothe	ﺭﻭﺕ
rothera	ﺭﺍﺕﺭﺍ
rotiala	ﺭﻭﺱیﺍﻝﺍ
rotz	ﺭﻭﺕﺯ
rouch	ﺭﺍچ
rouen	ﺭﻭیﻥ
roumfort	ﺭﻭﻡﻑﻭﺭﺕ
roundel	ﺭﻭﻥﺩﻝ
rountree	ﺭﻭﻥﺕﺭی
rourke	ﺭﺍﺭک
rouse	ﺭﺍﻭﺱ
roush	ﺭﻭﺵ
rout	ﺭﺍﻭﺕ
route	ﺭﻭﺕ
rov	ﺭﺍﻭ
rovner	ﺭﺍﻭﻥﺭ
rowan	ﺭﻭﺍﻥ
rowbottom	ﺭﺍﻭﺏﺍﺕﻡ
rowett	ﺭﻭﺕ
rowland	ﺭﺍﻭﻝﻥﺩ
rowles	ﺭﻭﻝﺱ
rowley	ﺭﻭیﻝی
roworth	ﺭﺍﻭﺭﺕ
rowsome	ﺭﻭﺱﺍﻡ
roxanne	ﺭﻭکﺱﺍﻥ
roxsan	ﺭﻭکﺱﺍﻥ
roy	ﺭﻭی
royal	ﺭﻭیﺍﻝ
royappa	ﺭﻭیﺍپﺍ
royce	ﺭﺍیﺱ
royle	ﺭﻭیﻝ
royse	ﺭﻭیﺱ
roytenberg	ﺭﻭیﺕﻥﺏﺭگ
roze	ﺭﻭﺯ
rozier	ﺭﻭﺯیﺭ
rubb	ﺭﺍﺏ
ruben	ﺭﺍﺏﻥ
rubie	ﺭﻭﺏی
rubin	ﺭﺍﺏیﻥ
rubio	ﺭﺍﺏیﻭ
rubottom	ﺭﺍﺏﺕﻡ
ruckle	ﺭﺍکﻝ
ruddy	ﺭﺍﺩی
rudewig	ﺭﺍﺩﻭیگ
rudloe	ﺭﻭﺩﻝﻭ
rudnick	ﺭﺍﺩﻥیک
rudolph	ﺭﺩﻭﻝﻑ
rudolphus	ﺭﺍﺩﻭﻝﻑﺱ
rudramuni	ﺭﺍﺩﺭﺍﻡﻭﻥی
rue	ﺭﻭ
ruebel	ﺭﻭیﺏﻝ
rueden	ﺭﻭیﺩﻥ
ruehr	ﺭﻭﻩﺭ
ruemmler	ﺭیﻭﻡﻝﺭ
rueter	ﺭﻭﺍﺕﺭ
ruey	ﺭﻭﺍی
ruffner	ﺭﺍﻑﻥﺭ
ruholl	ﺭﻭﻩﻝ
ruiz	ﺭﻭﺯ
rukan	ﺭﺍکﻭﻥ
rumble	ﺭﺍﻡﺏﻝ
rumples	ﺭﺍﻡپﻝﺯ
rundle	ﺭﺍﻥﺩﻝ
runeson	ﺭیﻭﻥﺱﻭﻥ
runner	ﺭﺍﻥﺭ
rupe	ﺭﻭپ
rupert	ﺭﻭپﺭﺕ
rushforth	ﺭﺍﺱﻑﻭﺭﺩ
rusk	ﺭﺍﺱک
ruspini	ﺭﺍﺱپیﻥی
russ	ﺭﺍﺱ
russell	ﺭﺍﺱﻝ
russo	ﺭﺍﺱﻭ
rust	ﺭﺍﺱﺕ
rusty	ﺭﺍﺱﺕی
rutabaga	ﺭﻭﺕﺍﺏﺍگﺍ
rutgert	ﺭﺍﺕگﺭﺕ
ruth	ﺭﺍث
rutherford	ﺭﺍﺕﺭﻑﻭﺭﺩ
ruthstrom	ﺭﺍﺕﺱﺕﺭﻭﻡ
rutks	ﺭﺍﺕکﺱ
ruudt	ﺭیﻭﺩﺕ
rybolt	ﺭﺍیﺏﻝﺕ
ryden	ﺭﺍیﺩﻥ
ryder	ﺭیﺩﺭ
rydquist	ﺭیﺩکﻭیﺱﺕ
rymill	ﺭیﻡیﻝ
rymon	ﺭیﻡﻭﻥ
rysavy	ﺭیﺱﺍﻭی
rysling	ﺭیﺱﻝیﻥگ
ryu	ﺭیﻭ
saartje	ﺱﺭﺝﻩ
sabine	ﺱﺍﺏیﻥ
sabini	ﺱﺍﺏیﻥی
sabirah	ﺱﺏیﺭﺍﻩ
sabiston	ﺱﺏیﺱﺕﻥ
sabot	ﺱﺍﺏﺕ
sabourin	ﺱﺍﺏﻭﺭیﻥ
sabra	ﺱﺏﺭﺍ
sackett	ﺱکﺕ
sacks	ﺱﺍکﺱ
sackton	ﺱﺍکﺕﻥ
sadah	ﺱﺩﺍﻩ
saddique	ﺱﺍﺩیک
sadgrove	ﺱﺍگﺭﻭ
sadira	ﺱﺩیﺭﺍ
sadler	ﺱﺍﺩﻝﺭ
safoutin	ﺱﺍﻑﺕیﻥ
sage	ﺱیگ
sahasi	ﺱﺍﻩﺍﺱی
sahib	ﺱﻩیﺏ
sahr	ﺱﺍﺭ
said	ﺱﻉیﺩ
saida	ﺱیﺩﺍ
saidi	ﺱﻉیﺩی
saint	ﺱﻥﺕ
saito	ﺱﺍیﺕﻭ
sakamoto	ﺱﺍکﺍﻡﻭﺕﻭ
sakari	ﺱﺍکﺍﺭی
sakaue	ﺱﺍکﺍیﻭ
saklad	ﺱﺍکﻝﺍﺩ
saklani	ﺱکﻝﺍﻥی
salanne	ﺱﺍﻝیﻥ
saley	ﺱیﻝی
salfi	ﺱﻝﻑی
salgueiro	ﺱﺍﻝگﻭﺭﻭ
salian	ﺱﺍﻝیﺍﻥ
salma	ﺱﻝﻡی
salmi	ﺱﺍﻝﻡی
salmond	ﺱﺍﻝﻡﻭﻥﺩ
salsman	ﺱیﻝﺯﻡﻥ
saltzman	ﺱﺍﻝﺕﺯﻡﻥ
salwa	ﺱﻝﻭﺍ
salzberg	ﺱﺍﻝﺯﺏﺭگ
salzenberg	ﺱﺍﻝﺯﻥﺏﺭگ
sam	ﺱﻡ
samaddar	ﺱﺍﻡﺍﺩﺍﺭ
samah	ﺱﺍﻡﺍﻩ
samar	ثﻡﺭ
samblanx	ﺱﻡﺏﻝﻥکﺱ
sambolec	ﺱﺍﻡﺏﻭﻝیک
samec	ﺱﺍﻡک
sameer	ﺱﺍﻡﺭ
sameh	ﺱﺍﻡﻩ
samel	ﺱﺍﻡﻝ
samira	ثﻡیﺭﺍ
samirah	ثﻡیﺭﻩ
samiyah	ﺱﻡیﺍﻩ
samma	ثﻡﺍ
samman	ﺱﺍﻡﺍﻥ
sammer	ﺱﺍﻡﺭ
samosky	ﺱﺍﻡﻭﺱکی
sampath	ﺱﻡپﺕ
sample	ﺱﻡپﻝ
sams	ﺱﺍﻡﺯ
samsel	ﺱﻡﺱﻝ
samuel	ﺱﺍﻡﻭیﻝ
samuels	ﺱﺍﻡﻭﻝﺱ
sana	ثﻥﺍ
sancese	ﺱﺍﻥﺱﺱ
sancheti	ﺱﺍﻥچﺕی
sand	ﺱﺍﻥﺩ
sandberg	ﺱﻥﺩﺏﺭگ
sanders	ﺱﺍﻥﺩﺭﺯ
sanderson	ﺱﺍﻥﺩﺭﺱﻭﻥ
sandford	ﺱﻥﺩﻑﻭﺭﺩ
sandhu	ﺱﺍﻥﺩﻩﻭ
sandie	ﺱﻥﺩی
sandlin	ﺱﻥﺩﻝیﻥ
sandman	ﺱﺍﻥﺩﻡﺍﻥ
sands	ﺱﻥﺩﺯ
sandvik	ﺱﻥﺩﻭیک
sane	ﺱیﻥ
sang	ﺱﺍﻥگ
sangal	ﺱﻥگﺍﻝ
sangho	ﺱﺍﻥگﻭ
sangster	ﺱﺍﻥﺝﺱﺕﺭ
sanjay	ﺱﺍﻥﺝﺍی
sannella	ﺱﺍﻥﻝﺍ
sannertje	ﺱﺍﻥﺭﺕ
sanov	ﺱﺍﻥﻭ
sansburn	ﺱﺍﻥﺯﺏﻭﺭﻥ
santa	ﺱﺍﻥﺕﺍ
santanna	ﺱﺍﻥﺕﺍﻥﺍ
santee	ﺱﺍﻥﺕی
santiago	ﺱﻥﺕیﺍگﻭ
santic	ﺱﺍﻥﺕیک
santje	ﺱﺍﻥﺕ
santo	ﺱﺍﻥﺕﻭ
santos	ﺱﺍﻥﺕﻭﺱ
santucci	ﺱﺍﻥﺕﻭﺱی
sanz	ﺱﺍﻥﺯ
sarab	ﺱﺭﺍﺏ
saranen	ﺱﺍﺭﺍﻥﻥ
sarathy	ﺱﺍﺭﺍﺕی
sardar	ﺱﺭﺩﺍﺭ
sardegna	ﺱﺍﺭﺩگﻥﺍ
sardo	ﺱﺍﺭﺩﻭ
sare	ﺱیﺭ
sarma	ﺱﺍﺭﻡﺍ
sarna	ﺱﺍﺭﻥﺍ
sarrett	ﺱﺍﺭﺕ
sarwate	ﺱﺍﺭﻭﺍﺕﻩ
saslav	ﺱﺍﺱﻝﺍﻭ
sassenheim	ﺱیﺯﻥﻩیﻡ
sasze	ﺱﺍﺯﻩ
sather	ﺱﺍﺕﺭ
satur	ﺱﺍﺕﻭﺭ
sauer	ﺱﺍﻭیﺭ
saul	ﺱﺍﻭﻝ
sauls	ﺱﺍﻭﻝﺯ
saunders	ﺱﺍﻥﺩﺭﺯ
sauriol	ﺱﺍﺭیﻭﻝ
sauter	ﺱﺍﻭﺕﺭ
sauther	ﺱﺍﻭﺕﺭ
savaram	ﺱﺍﻭﺍﺭﺍﻡ
savarese	ﺱﺍﻭﺍﺭﺱ
savel	ﺱﺍﻭﻝ
savela	ﺱیﻭﻝﺍ
savetz	ﺱﺍﻭﺕﺯ
savin	ﺱﺍﻭیﻥ
savoy	ﺱﺍﻭﻭی
sawan	ﺱﺍﻭﺍﻥ
sawchuk	ﺱﺍچک
sawdey	ﺱﺍﻭﺩی
sawford	ﺱﺍﻭﻑﺭﺩ
sawsan	ﺱﺍﺱﺍﻥ
sawyer	ﺱﺍیﻭیﺭ
saxe	ﺱﺍکﺱ
saxena	ﺱﺍکﺱﻥﺍ
saxnem	ﺱکﺱﻥﻡ
saxon	ﺱﺍکﺱﻭﻥ
sayre	ﺱیﺭ
scally	ﺍﺱکﺍﻝی
scannell	ﺍﺱکﺍﻥیﻝ
scarce	ﺍﺱکﺍﺭﺱ
scarp	ﺍﺱکﺍﺭپ
scearce	ﺍﺱکیﺭﺱ
schabus	ﺵﺍﺏﻭﺱ
schafer	ﺵﺍﻑﺭ
schagen	چﺍگﻥ
scheepen	چیپﻥ
scherwich	چﺭﻭیچ
schipluiden	چیپﻝﻭیﺩﻥ
schmeer	ﺵﻡیﺭ
schmidt	ﺍﺵﻡیﺕ
schnel	ﺍﺵﻥﻝ
schofield	ﺍﺱچﺍﻑیﻝﺩ
scholtz	ﺵﻭﻝﺕﺯ
schon	ﺵﻭﻥ
schoo	ﺵﻭ
schut	ﺵﺍﺕ
schuyler	چﻭیﻝﺭ
sciandra	ﺱیﺍﻥﺩﺭﺍ
sco	ﺍﺱکﻭ
scollick	ﺍﺱکﺍﻝیک
scorer	ﺍﺱکﻭﺭﺭ
scotia	ﺍﺱکﺍﺕیﺍ
scotoni	ﺍﺱکﻭﺕﻭﻥی
scotto	ﺍﺱکﺍﺕﻭ
scotty	ﺍﺱکﺍﺕی
scowling	ﺍﺱکﻭﻝیﻥگ
scranton	ﺍﺱکﺭﺍﻥﺕﻭﻥ
screech	ﺍﺱکﺭیچ
screve	ﺍﺱکﺭیﻭ
scribbling	ﺍﺱکﺭیﺏﻝیﻥگ
scribner	ﺍﺱکﺭیﺏﻥﺭ
scris	ﺍﺱکﺭیﺱ
scrub	ﺍﺱکﺭﺍﺏ
scudds	ﺍﺱکﺍﺩﺯ
scull	ﺍﺱکﺍﻝ
scullin	ﺍﺱکﻭﻝیﻥ
scully	ﺍﺱکﻭﻝی
sea	ﺱی
seales	ﺱیﻝﺯ
seals	ﺱیﻝﺯ
seaman	ﺱیﻡﻥ
sean	ﺱیﻥ
seanagh	ﺱیﻥیگ
seanain	ﺱیﻥﺍیﻥ
seanna	ﺱیﻥﺍ
searchnet	ﺱیﺭچﻥﺕ
searle	ﺱیﺭﻝ
seaver	ﺱیﻭﺭ
seavy	ﺱیﻭی
seawood	ﺱیﻭﻭﺩ
sebastiaen	ﺱپﺍﺱﺕیﻥ
sebastian	ﺱﺏﺍﺱﺕیﻥ
sebolt	ﺱیﺏﻝﺕ
sebree	ﺱﺏﺭی
sebrianne	ﺱﺏﺭیﺍﻥی
security	ﺱکیﻭﺭیﺕی
sed	ﺱﺩ
seda	ﺱﺩﺍ
sedai	ﺱﺩﺍی
seder	ﺱیﺩﺭ
sedore	ﺱﺩﻭﺭ
seds	ﺱﺩﺱ
sedvall	ﺱﺩﻭﺍﻝ
see	ﺱی
seebacher	ﺱیﺏﺍچﺭ
seed	ﺱیﺩ
seedman	ﺱیﺩﻡﻥ
seelig	ﺱیﻝیگ
seely	ﺱیﻝی
seeney	ﺱیﻥی
seenu	ﺱیﻥﻭ
seese	ﺱیﺱ
seewald	ﺱیﻭﺍﻝﺩ
seewei	ﺱیﻭی
segal	ﺱگﺍﻝ
segura	ﺱگﻭﺭﺍ
seh	ﺱﺡ
sehr	ﺱﻩﺭ
seibel	ﺱیﺏﻝ
seibl	ﺱیﺏﻝ
seid	ﺱیﺩ
seil	ﺱیﻝ
seipel	ﺱیپﻝ
seitz	ﺱیﺕﺯ
seiyu	ﺱیﻭ
sekora	ﺱیکﺍﺭﻭ
sela	ﺱیﻝﺍ
selberg	ﺱﻝﺏﺭگ
selim	ﺱﻝیﻡ
selima	ﺱﻝیﻡﺍ
sell	ﺱﻝ
selleck	ﺱﻝک
selma	ﺱﻝﻡﺍ
selwood	ﺱیﻝﻭﺩ
seman	ﺱیﻡﻥ
semele	ﺱﻡﻝی
semir	ﺱﻡیﺭ
semiz	ﺱﻡیﺯ
semotiuk	ﺱﻡﻭﺕیﻭک
sena	ﺱﻥﺍ
sendhil	ﺱﻥﺩﻩیﻝ
senftleben	ﺱﻥﻑﺕﻝیﺏﻥ
seng	ﺱﻥگ
sengupta	ﺱﻥگﻭپﺕﺍ
senner	ﺱیﻥﺭ
sepehr	ﺱپﻩﺭ
sepinwall	ﺱپیﻥﻭﺍﻝ
seppy	ﺱپی
seputis	ﺍﺱپﻭﺕیﺱ
sequeira	ﺱکﻭیﺭﺍ
serafin	ﺱیﺭﺍﻑیﻥ
sercan	ﺱﺭکﺍﻥ
serchuk	ﺱﺭچﺍک
serhir	ﺱﺭﻩیﺭ
serling	ﺱﺭﻝیﻥگ
serpent	ﺱﺭپﻥﺕ
serratosa	ﺱﺭﺍﺕﻭﺯﺍ
serre	ﺱﺭ
serres	ﺱیﺭﺱ
serrone	ﺱیﺭﻭﻥ
servadei	ﺱﺭﻭﺍﺩی
servideo	ﺱﺭﻭیﺩیﻭ
servis	ﺱﺭﻭیﺱ
seshadri	ﺱﺵﺍﺩﺭی
seth	ﺱﺕ
sethurajan	ﺱﺕﻩﻭﺭﺍﺝﺍﻥ
sethuraman	ﺱﺕﻭﺭﺍﻡﺍﻥ
seto	ﺱیﺕﻭ
settle	ﺱﺕﻝ
seurer	ﺱﺭﺭ
sevanick	ﺱﻭﺍﻥیک
seven	ﺱﻭﻥ
severson	ﺱﻭﺭﺱﻭﻥ
sevier	ﺱﻭیﺭ
sewell	ﺱیﻭﻝ
sexton	ﺱکﺱﺕﻥ
seytie	ﺱیﺕ
shachat	ﺵﺍچﺍﺕ
shadha	ﺵﺍﺩﻩﺍ
shadiyah	ﺵﺍﺩیﺍﻩ
shadow	ﺵﺩﻭ
shaker	ﺵیکﺭ
shakespeare	ﺵکﺱپیﺭ
shakya	ﺵﺍکیﺍ
shalette	ﺵﺍﻝیﺕ
shaligram	ﺵﺍﻝیگﺭﺍﻡ
shallcross	ﺵﺍﻝکﺭﺍﺱ
shalom	ﺵﺍﻝﻭﻡ
shamaliyah	ﺵﻡیﻝﻩ
shamas	ﺵﺍﻡﺍﺱ
shamat	ﺵﻡﺍﺕ
shambat	ﺵﺍﻡﺏﺍﺕ
shambhu	ﺵﻡﺏﻩﻭ
shames	ﺵیﻡﺯ
shamim	ﺵﻡیﻡ
shamir	ﺵﺍﻡیﺭ
shamis	ﺵﻡیﺱ
shammar	ﺵﺍﻡﺍﺭ
shan	ﺵﺍﻥ
shanahan	ﺵﺍﻥﺍﻩﺍﻥ
shane	ﺵیﻥ
shank	ﺵﺍﻥک
shankar	ﺵﺍﻥکﺍﺭ
shanker	ﺵﺍﻥکﺭ
shannon	ﺵﺍﻥﻭﻥ
shanson	ﺵﺍﻥﺱﻭﻥ
shapero	ﺵﺍپﺭﻭ
shar	ﺵﺍﺭ
shardlow	ﺵﺍﺭﺩﻝﻭ
shari	ﺵﺍﺭی
sharif	ﺵﺭیط
shark	ﺵﺭک
sharknas	ﺵﺍﺭکﻥﺍﺱ
sharks	ﺵﺭکﺱ
sharlee	ﺵﺍﺭﻝی
sharock	ﺵﺍﺭﻭک
sharqiyah	ﺵﺭکیﺍﻩ
shartzer	ﺵﺍﺭﺕﺯﺭ
sharvari	ﺵﺭﻭﺍﺭی
shaul	ﺵﺍﻭﻝ
shaw	ﺵﺍﻭ
she	ﺵی
shearer	ﺵیﺭﺭ
shebert	ﺵﺏﺭﺕ
shebs	ﺵﺏﺱ
sheckman	ﺵکﻡﺍﻥ
sheehan	ﺵیﻩﺍﻥ
sheehy	ﺵیﻩی
sheep	ﺵیپ
sheer	ﺵیﺭ
sheeran	ﺵیﺭﺍﻥ
sheets	ﺵیﺕﺯ
shef	ﺵﻑ
sheffield	ﺵﻑیﻝﺩ
sheik	ﺵیک
shein	ﺵیﻥ
sheipe	ﺵپ
shekar	ﺵکﺍﺭ
shel	ﺵﻝ
sheldon	ﺵیﻝﺩﻥ
shelf	ﺵﻝﻑ
sheller	ﺵﻝﺭ
shelly	ﺵﻝی
shelmidi	ﺵﻝﻡیﺩی
shelton	ﺵﻝﺕﻭﻥ
shen	ﺵﻥ
shenan	ﺵﻥﺍﻥ
shenfeng	ﺵﻥﻑﻥگ
sheng	ﺵﻥگ
shenghun	ﺵﻥﻕﺍﻥ
shenkiat	ﺵﻥکیﺍﺕ
shenoy	ﺵیﻥﻭی
shephard	ﺵپﺭﺩ
shepherd	ﺵﻑﺭﺩ
sheppard	ﺵپﺍﺭﺩ
sher	ﺵﺭ
sherer	ﺵﺭﺭ
sheri	ﺵﺭی
sherman	ﺵﺭﻡﺍﻥ
sherriff	ﺵﺭیﻑ
sherrington	ﺵﺭیﻥگﺕﻭﻥ
sherry	ﺵﺭی
sherwood	ﺵﺭﻭﻭﺩ
shetland	ﺵﺕﻝﻥﺩ
shetler	ﺵﺕﻝﺭ
shetline	ﺵﺕﻝﺍیﻥ
sheyn	ﺵیﻥ
shi	ﺵی
shiang	ﺵیﺍﻥگ
shidler	ﺵیﺩﻝﺭ
shields	ﺵیﻝﺩﺯ
shimayah	ﺵیﻡﺍیﻩ
shimin	ﺵیﻡیﻥ
shin	ﺵیﻥ
shipman	ﺵیپﻡﻥ
shirai	ﺵیﺭﺍی
shirley	ﺵیﺭﻝی
shiyekar	ﺵیکﺍﺭ
shlaes	ﺵﻝﺍیﺯ
shockey	ﺵﺍکی
shoemaker	ﺵﻭﻡیکﺭ
shomer	ﺵﻭﻡﺭ
shortell	ﺵﻭﺭﺕﻝ
shorten	ﺵﻭﺭﺕﻥ
shortreed	ﺵﺭﺕﺭیﺩ
shoshani	ﺵﺵﺍﻥی
shostack	ﺵﺍﺱﺕک
shotton	ﺵﺍﺕﻭﻥ
shoulder	ﺵﻭﻝﺩﺭ
shoun	ﺵﻭﻥ
shoup	ﺵﻭپ
shrestha	ﺵﺭﺱﺕﺍ
shriver	ﺵﺭیﻭﺭ
shryne	ﺵﺭﺍیﻥﻩ
shtiegman	ﺍﺵﺕیگﻡﻥ
shub	ﺵﺍﺏ
shudes	ﺵﻭﺩﺯ
shue	ﺵﻭ
shuen	ﺵﻭﺍﻥ
shuff	ﺵﺍﻑ
shugrue	ﺵﺍگﺭﻭ
shuh	ﺵﺍﻩ
shuholm	ﺵﺍﻩﻭﻝﻡ
shukla	ﺵﺍکﻝﺍ
shulga	ﺵﺍﻝگﺍ
shultz	ﺵﺍﻝﺕﺯ
shum	ﺵﺍﻡ
shumaker	ﺵﺍﻡﺍکﺭ
shunnar	ﺵﺍﻥﻥﺍﺭ
shushen	ﺵﺍﺵﻥ
shutt	ﺵﺍﺕ
shuyler	ﺵﻭیﻝﺭ
siang	ﺱیﺍﻥگ
siano	ﺱیﺍﻥﻭ
sibley	ﺱیﺏﻝی
sicolo	ﺱیکﻭﻝﻭ
sidler	ﺱیﺩﻝﺭ
sidor	ﺱیﺩﻭﺭ
siebert	ﺱیﺏﺭﺕ
siegel	ﺱیگﻝ
siegl	ﺱیگﻝ
siejko	ﺱیﺝکﻭ
siembab	ﺱیﻡﺏﺍﺏ
siemon	ﺱیﻡﻥ
siemonsen	ﺱیﻡﻭﻥﺱﻥ
sierant	ﺱیﺭﺍﻥﺕ
siering	ﺱیﺭیﻥگ
sierra	ﺱیﺭﺍ
siew	ﺱیﻭ
siggs	ﺱیگﺱ
sigman	ﺱیگﻡﻥ
sigmon	ﺱیگﻡﻥ
sigmund	ﺱیگﻡﻭﻥﺩ
sihsobhon	ﺱیﻩﺱﻭﺏﻩﻭﻥ
sijmen	ﺱیگﻡﻥ
sikes	ﺱﺍیکﺱ
sikora	ﺱیکﻭﺭﺍ
silberman	ﺱیﻝﺏﺭﻡﻥ
silbermann	ﺱیﻝﺏﺭﻡﺍﻥ
silk	ﺱیﻝک
silliman	ﺱیﻝیﻡﺍﻥ
silva	ﺱیﻝﻭﺍ
silver	ﺱیﻝﻭﺭ
silverberg	ﺱیﻝﻭﺭﺏﺭگ
silverman	ﺱیﻝﻭﺭﻡﻥ
silverthorne	ﺱیﻝﻭﺭﺕﻭﺭﻥ
silverwood	ﺱیﻝﻭﺭﻭﺩ
silvey	ﺱیﻝﻭی
silvia	ﺱیﻝﻭیﺍ
silvio	ﺱیﻝﻭیﻭ
silvo	ﺱیﻝﻭ
silvonen	ﺱیﻝﻭﻥﻥ
simard	ﺱیﻡﺍﺭﺩ
simcik	ﺱیﻡﺱیک
simen	ﺱیﻡﻥ
simer	ﺱیﻡﺭ
simicich	ﺱﻡﺱچ
simin	ﺱیﻡیﻥ
siming	ﺱیﻡیﻥگ
simko	ﺱﺍیﻡکﻭ
simler	ﺱیﻡﻝﺭ
simmer	ﺱیﻡﺭ
simmonds	ﺱیﻡﻥﺩﺱ
simmons	ﺱیﻡﻥﺯ
simms	ﺱیﺱﺯ
simodynes	ﺱیﻡﻭﺩیﻥﺯ
simon	ﺱیﻡﻭﻥ
simona	ﺱیﻡﻭﻥﺍ
simonds	ﺱیﻡﻭﻥﺩﺱ
simone	ﺱیﻡﻭﻥ
simonie	ﺱیﻡﻭﻥﻩ
simons	ﺱیﻡﻭﻥﺯ
simplicity	ﺱیﻡپﻝیﺱیﺕی
sims	ﺱیﻡﺱ
sin	ﺱیﻥ
sinan	ﺱیﻥﺍﻥ
sinclair	ﺱیﻥکﻝﺍیﺭ
sindelman	ﺱیﻥﺩﻝﻡﻥ
sindre	ﺱیﻥﺩﺭﻩ
sing	ﺱیﻥگ
singleton	ﺱیگﻝﺕﻭﻥ
sinibaldi	ﺱیﻥیﺏﺍﻝﺩی
sipe	ﺱﺍیپ
sipples	ﺱیپﻝﺯ
sipriano	ﺱیپﺭیﺍﻥﻭ
siqi	ﺱیکی
sir	ﺱﺭ
sircombe	ﺱﺭکﺍﻡﺏ
sires	ﺱیﺭﺱ
sirois	ﺱیﺭﻭیﺯ
sirucka	ﺱیﺭﻭکﺍ
sisk	ﺱیﺱک
sislo	ﺱیﺱﻝﻭ
sit	ﺱیﺕ
sita	ﺱیﺕﺍ
sitaram	ﺱیﺕﺍﺭﺍﻡ
sites	ﺱیﺕﺱ
sitrah	ﺱیﺕﺭﺍ
sittler	ﺱیﺕﻝﺭ
siuuirdingelant	ﺱییﻭﺍیﺭﺩیﻥگﻝﻥﺕ
siva	ﺱیﻭﺍ
skahan	ﺍﺱکﺍﻩﺍﻥ
skari	ﺍﺱکﺍﺭی
skartsis	ﺍﺱکﺍﺭﺕﺱیﺱ
skaven	ﺍﺱکﺍﻭﻥ
skaya	ﺍﺱکﺍیﺍ
skean	ﺍﺱکیﻥ
skee	ﺍﺱکی
skeeter	ﺍﺱکیﺕﺭ
skelton	ﺍﺱکﻝﺕﻥ
skene	ﺍﺱکیﻥ
skep	ﺍﺱکپ
skerries	ﺍﺱکﺭﺍیﺯ
skerry	ﺍﺱکﺭی
skiba	ﺍﺱکیﺏﺍ
skiles	ﺍﺱکیﻝﺱ
skinner	ﺍﺱکیﻥﺭ
skip	ﺍﺱکیپ
skippy	ﺍﺱکیپی
sklower	ﺍﺱکﻝﻭیﺭ
skogen	ﺍﺱکﻭگﺍﻥ
sky	ﺍﺱکﺍی
slabotnen	ﺍﺱﻝﺏﻭﺕﻥﻥ
slan	ﺍﺱﻝﺍﻥ
slaney	ﺍﺱﻝیﻥی
slangsvold	ﺍﺱﻝﻥگﺯﻭﺍﻝﺩ
slankard	ﺍﺱﻝﺍﻥکﺍﺭﺩ
slash	ﺍﺱﻝﺵ
slashing	ﺍﺱﻝﺵیﻥگ
slate	ﺍﺱﻝیﺕی
slater	ﺍﺱﻝﺍﺕﺭ
slatkin	ﺍﺱﻝﺍﺕکیﻥ
slattery	ﺍﺱﻝﺍﺕﺭی
slave	ﺍﺱﻝیﻭ
slavenburg	ﺍﺱﻝﺍﻭﻥﺏﺭگ
slavin	ﺍﺱﻝﺍﻭیﻥ
slawek	ﺍﺱﻝﺍﻭک
slawomir	ﺍﺱﻝﺍﻭﻡیﺯ
sledd	ﺍﺱﻝﺩ
sledge	ﺱﻝﺝ
sleegers	ﺍﺱﻝیگﺭﺯ
sleep	ﺍﺱﻝیپ
sleeper	ﺍﺱﻝیپﺭ
sletten	ﺍﺱﻝﺕﻥ
slim	ﺱﻝیﻡ
slimane	ﺍﺱﻝیﻡﺍﻥ
slippery	ﺱﻝیپﺭی
sliupas	ﺍﺱﻝیﻭپﺍﺱ
sloan	ﺍﺱﻝﺍﻥ
sloane	ﺱﻝﻭﻥ
slocum	ﺍﺱﻝﻭکﺍﻡ
sloman	ﺍﺱﻝﻭﻡﻥ
slone	ﺍﺱﻝﺍﻥ
slope	ﺍﺱﻝپ
slothouber	ﺍﺱﻝﺍﺕﻭﺏﺭ
slotkin	ﺍﺱﻝﺍﺕکیﻥ
sluka	ﺍﺱﻝﻭکﺍ
slumkey	ﺱﻝﺍﻡکی
slut	ﺱﻝﺍﺕ
sly	ﺱﻝﺍی
slyke	ﺍﺱﻝﺍیک
smadja	ﺍﺱﻡﺍﺩﺝ
smakovane	ﺱﻡکﻭﻭﻥ
small	ﺍﺱﻡﺍﻝ
smalley	ﺍﺱﻡﺍﻝی
smart	ﺍﺱﻡﺍﺭﺕ
smead	ﺍﺱﻡیﺩ
smeall	ﺍﺱﻡیﻝ
smedley	ﺍﺱﻡﺩﻝی
smeds	ﺍﺱﺩﺱ
smikla	ﺍﺱﻡیکﻝﺍ
smirnov	ﺍﺱﻡیﺭﻥﻭ
smiths	ﺍﺱﻡیﺕﺯ
smithson	ﺍﺱﻡیﺕﺱﻭﻥ
smithwick	ﺍﺱﻡیﺕﻭیک
smitley	ﺱﻡیﺕﻝی
smits	ﺍﺱﻡیﺕﺯ
smoky	ﺍﺱﻡﻭکی
smolen	ﺍﺱﻡﻝﻥ
smolik	ﺍﺱﻡﻭﻝیک
smolin	ﺍﺱﻡﻭﻝیﻥ
smoot	ﺍﺱﻡﻭﺕ
smyley	ﺍﺱﻡیﻝی
smythe	ﺍﺱﻡﺍیﺕ
snail	ﺍﺱﻥیﻝ
sneed	ﺍﺱﻥیﺩ
snehal	ﺱﻥﻩﺍﻝ
sneissel	ﺍﺱﻥیﺱﻝ
snel	ﺍﺱﻥﻝ
snelling	ﺍﺱﻥﻝیﻥگ
snodgrass	ﺍﺱﻥﻭگﺭﺱ
snorri	ﺱﻥﻭﺭی
snotoa	ﺱﻥﻭﺕﻭ
snow	ﺍﺱﻥﻭ
snowden	ﺍﺱﻥﻭﺩﻥ
snowfield	ﺍﺱﻥﻭﻑیﻝﺩ
snug	ﺍﺱﻥﺍگ
snyder	ﺍﺱﻥﺍیﺩﺭ
sobhan	ﺱﺏﺡﺍﻥ
sobotka	ﺱﻭﺏﻭﺕکﺍ
social	ﺱﻭﺵﺍﻝ
soderblom	ﺱﺍﺩﺭﺏﻝﺍﻡ
soft	ﺱﺍﻑﺕ
software	ﺱﺍﻑﺕﻭﺭ
sogen	ﺱﻭگﻥ
soha	ﺱﻭﻩﺍ
sohm	ﺱﻭﻩﻡ
sohrab	ﺱﻩﺭﺍﺏ
sokol	ﺱﻭکﻭﻝ
sol	ﺱﻭﻝ
solak	ﺱﺍﻝک
solar	ﺱﻭﻝﺍﺭ
solberg	ﺱﻝﺏﺭگ
sold	ﺱﻭﻝﺩ
solek	ﺱﻭﻝک
soli	ﺱﻭﻝی
solis	ﺱﻭﻝیﺱ
solo	ﺱﻭﻝﻭ
solodov	ﺱﻝﻭﺩﻭﻑ
solomon	ﺱﺍﻝﻭﻡﻥ
solovay	ﺱﻭﻝﻭﻭی
solovier	ﺱﻭﻝﻭیﺭ
solvay	ﺱﻭﻝﻭی
soma	ﺱﻭﻡﺍ
somashekar	ﺱﻭﻡﺍﺵیکﺍﺭ
someren	ﺱﻡﺭﻥ
somerville	ﺱﻭﻡﺭﻭیﻝ
somesh	ﺱﺍﻡﺵ
something	ﺱﺍﻡﺕیﻥگ
somjee	ﺱﻭﻡﺝی
somvay	ﺱﻭﻡﻭی
son	ﺱﺍﻥ
songer	ﺱﻭﻥگﺭ
songerwala	ﺱﻭﻥگﺭﻭﺍﻝﺍ
songkran	ﺱﻭﻥگکﺭﻥ
sonja	ﺱﻭﻥﺝﺍ
sonny	ﺱﻭﻥی
sony	ﺱﻭﻥی
soo	ﺱﻭ
sopan	ﺱﻭپﻥ
sophie	ﺱﻭﻑی
sor	ﺱﻭﺭ
sorab	ﺱﻭﺭﺍﺏ
sorabh	ﺱﻭﺭﺍﺏ
sorc	ﺱﻭﺭک
sore	ﺱﻭﺭ
soren	ﺱﻭﺭﻥ
sorensen	ﺱﻭﺭﻥﺱﻥ
sorin	ﺱﻭﺭیﻥ
sorrel	ﺱﻭﺭﻝ
sorvali	ﺱﻭﺭﻭﺍﻝی
sotilas	ﺱﻭﻝیﺕﺍﺱ
soto	ﺱﻭﺕﻭ
sou	ﺱﻭ
soucek	ﺱﻭکک
soudan	ﺱﻭﺩﺍﻥ
soumen	ﺱﻭﻡﻥ
soun	ﺱﻭﻥ
source	ﺱﻭﺭﺱ
sousa	ﺱﻭﺱﻩ
souza	ﺱﻭﺯﺍ
sowder	ﺱﻭﺩﺭ
soyack	ﺱﻭیﺍک
sozo	ﺱﻭﺯﻭ
spaarndam	ﺍﺱپﺍﺭﺩﺍﻡ
spacek	ﺍﺱپیﺱیک
spangler	ﺍﺱپﺍﻥگﻝﺭ
sparks	ﺍﺱپﺍﺭکﺱ
sparrow	ﺍﺱپﺍﺭﻭ
spatafora	ﺍﺱپﺍﺕﺍﻑﻭﺭﺍ
spath	ﺍﺱپﺍﺕ
spatz	ﺍﺱپﺍﺕﺯ
spaulding	ﺍﺱپﺍﻭﻝﺩیﻥگ
spear	ﺍﺱپیﺭ
spearing	ﺍﺱپیﺭیﻥگ
spears	ﺍﺱپیﺭﺯ
speden	ﺍﺱپیﺩﻥ
speer	ﺍﺱپیﺭ
spelman	ﺍﺱپﻝﻡﻥ
spence	ﺍﺱپﻥﺱ
spencer	ﺍﺱپﻥﺱﺭ
spero	ﺍﺱپیﺭﻭ
sperry	ﺍﺱپﺭی
sphar	ﺍﺱﻑﺍﺭ
spider	ﺍﺱپﺍیﺩﺭ
spiders	ﺍﺱپﺍیﺩﺭﺯ
spiers	ﺍﺱپیﺭﺯ
spies	ﺍﺱپﺍیﺯ
spike	ﺍﺱپﺍیک
spikes	ﺍﺱپﺍیکﺱ
spillman	ﺍﺱپیﻝﻡﻥ
spinak	ﺍﺱپیﻥﺍک
spindrift	ﺍﺱپیﻥﺩﺭیﻑﺕ
spine	ﺍﺱپیﻥ
spinning	ﺍﺱپﺍیﻥیﻥگ
spires	ﺍﺱپﺍیﺭﺯ
spiro	ﺍﺱپیﺭﻭ
spiros	ﺍﺱپیﺭﺍﺱ
spisak	ﺍﺱپیﺱﺍک
spit	ﺍﺱپیﺕ
spitzer	ﺍﺱپیﺕﺯﺭ
spivak	ﺍﺱپیﻭﺍک
spleid	ﺍﺱپﻝیﺩ
splinter	ﺍﺱپﻝیﻥﺕﺭ
spolarich	ﺍﺱپﻭﻝﺍﺭیخ
sporay	ﺍﺱپﻭﺭی
spotswood	ﺍﺱپﺍﺕﺱﻭﻭﺩ
spousta	ﺍﺱپﻭﺱﺕﺍ
sprag	ﺍﺱپﺭﺍگ
sprayberry	ﺍﺱپﺭیﺏﺭی
springer	ﺱپﺭیﻥگﺭ
sproat	ﺍﺱپﺭﻭﺕ
spur	ﺍﺱپﺍﺭ
squire	ﺍﺱکﻭﺍیﺭ
squirrel	ﺍﺱکﻭﺍیﺭﻝ
stabell	ﺍﺱﺕیﺏﻝ
stacey	ﺍﺱﺕیﺱی
stachnik	ﺍﺱﺕچﻥیک
stacy	ﺍﺱﺕیﺱی
stadler	ﺍﺱﺕﺩﻝﺭ
staffan	ﺍﺱﺕﻑﺍﻥ
stafford	ﺍﺱﺕﺍﻑﻭﺭﺩ
stagg	ﺍﺱﺕﺍگ
staggers	ﺍﺱﺕیگﺭﺱ
stailey	ﺍﺱﺕیﻝی
staines	ﺍﺱﺕیﻥﺯ
stainless	ﺍﺱﺕﺍیﻥﻝﺱ
stajano	ﺍﺱﺕﺍﺝﺍﻥﻭ
stam	ﺍﺱﺕﺍﻡ
stamper	ﺍﺱﺕﺍﻡپﺭ
stampf	ﺱﺕﻡﻑ
stan	ﺍﺱﺕﻥ
stancomb	ﺍﺱﺕﻥکﺍﻡﺏ
stanford	ﺍﺱﺕﻥﻑﺭﺩ
stangier	ﺍﺱﺕﺍﻥگیﺭ
stansell	ﺍﺱﺕﻥﺱﻝ
staples	ﺍﺱﺕیپﻝﺯ
star	ﺍﺱﺕﺍﺭ
starbuck	ﺍﺱﺕﺍﺭﺏﺍک
starcap	ﺍﺱﺕﺍﺭکیپ
staringer	ﺍﺱﺕﺍﺭیﻥگﺭ
stark	ﺍﺱﺕﺍﺭک
starkey	ﺍﺱﺕﺍﺭکی
starr	ﺍﺱﺕﺍﺭ
stars	ﺍﺱﺕﺍﺭﺯ
start	ﺍﺱﺕﺍﺭﺕ
startled	ﺍﺱﺕﺍﺭﺕﻝﺩ
startz	ﺍﺱﺕﺍﺭﺕﺯ
stas	ﺍﺱﺕﺍﺱ
statham	ﺍﺱﺕﺍﺕﻡ
stead	ﺍﺱﺕیﺩ
stealer	ﺍﺱﺕیﻝﺭ
stearn	ﺍﺱﺕیﺭﻥ
stearns	ﺍﺱﺕیﺭﻥﺯ
stec	ﺍﺱﺕک
stedina	ﺍﺱﺕﺩیﻥﺍ
stedman	ﺍﺱﺕﺩﻡﻥ
steel	ﺍﺱﺕیﻝ
steele	ﺍﺱﺕیﻝ
steen	ﺍﺱﺕیﻥ
steentje	ﺍﺱﺕیﺝﻩ
steep	ﺍﺱﺕیپ
stefano	ﺍﺱﺕﻑﺍﻥﻭ
stegen	ﺍﺱﺕگﻥ
stelly	ﺍﺱﺕﻝی
stenberg	ﺍﺱﺕیﻥﺏﺭگ
stenfort	ﺍﺱﺕﻥﻑﻭﺭﺕ
stensrud	ﺍﺱﺕﻥﺱﺭﺍﺩ
stephane	ﺍﺱﺕﻑﺍﻥ
stephanus	ﺍﺱﺕﻑﺍﻥﺯ
stephen	ﺍﺱﺕﻑﻥ
stephenson	ﺍﺱﺕﻑﻥﺱﻭﻥ
stepke	ﺍﺱﺕپک
stepken	ﺍﺱﺕپکﻥ
steriti	ﺍﺱﺕﺭیﺕی
sterne	ﺍﺱﺕﺭﻥ
steven	ﺍﺱﺕیﻭﻥ
stevenson	ﺍﺱﺕیﻭﻥﺱﻭﻥ
steves	ﺍﺱﺕیﻭﺯ
stew	ﺍﺱﺕﻭ
steward	ﺍﺱﺕﻭﺍﺭﺩ
stewart	ﺍﺱﺕﻭﺍﺭﺕ
stian	ﺍﺱﺕیﻥ
stiansen	ﺍﺱﺕیﺍﻥﺱﻥ
stickelman	ﺍﺱﺕیکﻝﻡﻥ
stieber	ﺍﺱﺕیﺏﺭ
stig	ﺍﺱﺕیگ
stigberg	ﺍﺱﺕیگﺏﺭگ
stiles	ﺍﺱﺕیﻝﺯ
still	ﺍﺱﺕیﻝ
stine	ﺍﺱﺕﺍیﻥ
stineman	ﺍﺱﺕﺍیﻥﻡﻥ
stinson	ﺍﺱﺕیﻥﺱﻥ
stirling	ﺍﺱﺕﺭﻝیﻥگ
stith	ﺍﺱﺕیﺕ
stobert	ﺍﺱﺕﺍﺏﺭﺕ
stock	ﺍﺱﺕﻭک
stockman	ﺍﺱﺕﺍکﻡﻥ
stocks	ﺍﺱﺕﺍکﺱ
stockslager	ﺍﺱﺕﺍکﺱﻝﺍﺝﺭ
stockwell	ﺍﺱﺕﻭکﻭﻝ
stodola	ﺍﺱﺕﻭﺩﻭﻝﺍ
stoffel	ﺍیﻑﻭﻑﻝ
stok	ﺍﺱﺕﻭک
stoker	ﺍﺱﺕﺍکﺭ
stoklas	ﺍﺱﺕﻭکﻝﺍﺱ
stolcke	ﺍﺱﺕﺍﻝکﻩ
stoler	ﺍﺱﺕﻝﺭ
stoller	ﺍﺱﺕﻭﻝﺭ
stolte	ﺍﺱﻭﻝﺕ
stonebridge	ﺍﺱﺕﻭﻥﺏﺭﺍیﺝ
stookey	ﺍﺱﺕﻭکی
storer	ﺍﺱﺕﻭﺭﺭ
storey	ﺍﺱﺕﻭﺭی
storga	ﺍﺱﺕﻭﺭگﺍ
storleer	ﺍﺱﺕﻭﺭﻝیﺭ
storms	ﺍﺱﺕﻭﺭﻡﺯ
story	ﺍﺱﺕﻭﺭی
stothers	ﺍﺱﺕﺍﺕﺭﺯ
stoun	ﺍﺱﺕﻭﻥ
stovall	ﺍﺱﺕﻭﻭﺍﻝ
stowbridge	ﺍﺱﺕﻭﺏﺭیﺝ
stowell	ﺍﺱﺕﻭﻝ
stoy	ﺍﺱﺕﻭی
strader	ﺍﺱﺕﺭﺍﺩﺭ
strand	ﺍﺱﺕﺭﻥﺩ
strasheim	ﺍﺱﺕﺭﺍﺵیﻡ
straton	ﺱﺕﺭﺍﺕﻭﻥ
straub	ﺍﺱﺕﺭﺍﻭﺏ
strawbridge	ﺍﺱﺕﺭﺍﺏﺭیﺝ
stray	ﺍﺱﺕﺭی
strayer	ﺍﺱﺕﺭیﺭ
stream	ﺍﺱﺕﺭیﻡ
streater	ﺱﺕﺭیﺕﺭ
stremler	ﺍﺱﺕﺭﻡﻝﺭ
strider	ﺍﺱﺕﺭیﺩﺭ
striebel	ﺍﺱﺕﺭیﺏﻝ
stringer	ﺍﺱﺕﺭیﻥگﺭ
strini	ﺍﺱﺕﺭیﻥی
strock	ﺍﺱﺕﺭﺍک
strope	ﺍﺱﺕﺭﺍپ
strouss	ﺍﺱﺕﺭﻭﺱ
stroustrup	ﺍﺱﺕﺭﻭﺱﺕﺭﺍپ
stroyan	ﺍﺱﺕﺭیﺍﻥ
struckman	ﺍﺱﺕﺭﺍکﻡﻥ
strum	ﺍﺱﺕﺭﻭﻡ
strydom	ﺍﺱﺕﺭیﺩﻡ
stubbs	ﺍﺱﺕﺍﺏﺯ
stuckey	ﺍﺱﺕﺍکی
stucki	ﺍﺱﺕﺍکی
stud	ﺍﺱﺕﺍﺩ
stude	ﺍﺱﺕﺍﺩ
student	ﺍﺱﺕیﻭﺩﻥﺕ
stuplich	ﺍﺱﺕﺍپﻝیچ
sturges	ﺍﺱﺕﺍﺭگﺱ
sturgill	ﺍﺱﺕﺍﺭگیﻝ
sturim	ﺍﺱﺕﻭﺭیﻡ
sturluson	ﺱﺕﺍﺭﻝﻭﺯﻥ
stutzman	ﺍﺱﺕﺍﺕﺯﻡﻥ
styles	ﺍﺱﺕﺍیﻝﺯ
subglacial	ﺱﺍﺏگﻝﺍﺵیﺍﻝ
subhani	ﺱﺍﺏﻩﺍﻥی
subhendu	ﺱﻭﺏﻩﺍﻥﺩﻭ
sublette	ﺱﺍﺏﻝﺕ
subramaniam	ﺱﺍﺏﺭﺍﻡﺍﻥیﺍﻡ
subramanian	ﺱﺍﺏﺭﺍﻡﺍﻥیﺍﻥ
subtense	ﺱﺍﺏﺕﻥﺱ
suchan	ﺱﻭچﺍﻥ
sucia	ﺱﻭﺵیﺍ
sudan	ﺱﻭﺩﺍﻥ
sudare	ﺱﻭﺩیﺭ
sudarmo	ﺱﻭﺩﺍﺭﻡﻭ
sudarshan	ﺱﻭﺩﺍﺭﺵﺍﻥ
sudip	ﺱﻭﺩیپ
sudipto	ﺱﻭﺩیپﺕﻭ
sudupe	ﺱﺍﺩیﻭپ
sue	ﺱﻭ
suffer	ﺱﻭﻑﺭ
suga	ﺱﺍگﺍ
sugai	ﺱﺍگﺍیی
sugarloaf	ﺵﻭگﺭﻝﻑ
sugars	ﺱﺍگﺍﺭﺱ
suha	ﺱﻭﻩﺍ
suhas	ﺱﻭﻩﺍﺱ
sukumar	ﺱﻭکﻭﻡﺍﺭ
sulaymaniyah	ﺱﻝیﻡﺍﻥیﻩ
sullivan	ﺱﺍﻝیﻭﺍﻥ
sully	ﺱﺍﻝی
sulphur	ﺱﻭﻝﻑﻭﺭ
sultan	ﺱﻭﻝﺕﺍﻥ
sumanta	ﺱﺍﻡﺍﻥﺕﺍ
sumanth	ﺱﺍﻡﺍﻥﺕﺍ
sumgin	ﺱﺍﻡگیﻥ
sumit	ﺱﺍﻡیﺕ
summers	ﺱﺍﻡﺭﺯ
summit	ﺱﺍﻡیﺕ
sumon	ﺱﺍﻡﻭﻥ
sumrall	ﺱﺍﻡﺭﺍﻝ
suna	ﺱﻭﻥﺍ
sunando	ﺱﺍﻥﺍﻥﺩﻭ
sundar	ﺱﺍﻥﺩﺍﺭ
sundaram	ﺱﺍﻥﺩﺭﺍﻡ
sunday	ﺱﺍﻥﺩی
sundeep	ﺱﺍﻥﺩیپ
sundelin	ﺱﺍﻥﺩﻝیﻥ
sune	ﺱیﻭﻥ
suneet	ﺱﺍﻥیﺕ
sung	ﺱیﻭﻥگ
sungold	ﺱﺍﻥگﻝﺩ
sunil	ﺱییﻭﻥیﻝ
sunk	ﺱﺍﻥک
sunken	ﺱﺍﻥکﻥ
sunker	ﺱﺍﻥکﺭ
sunley	ﺱﺍﻥﻝی
sunni	ﺱﺍﻥی
sunny	ﺱﺍﻥی
sunondo	ﺱﺍﻥﻭﻥﺩﻭ
sunrise	ﺱﺍﻥﺭﺍیﺯ
sunrong	ﺱﺍﻥﺭﺍﻥگ
sunset	ﺱﺍﻥﺱﺕ
sunshine	ﺱﺍﻥﺵﺍیﻥ
sup	ﺱﺍپ
supratic	ﺱﻭپﺭﺍﺕیک
supriyo	ﺱﻭپﺭیﻭ
suraj	ﺱﻭﺭﺍﺝ
surana	ﺱﻭﺭﺍﻥﺍ
surinder	ﺱﻭﺭیﻥﺩﺭ
survey	ﺱﺭﻭی
susa	ﺱﻭﺱﺍ
susalis	ﺱﻭﺯﺍﻝیﺱ
susanna	ﺱﻭﺯﺍﻥﺍ
susanne	ﺱﻭﺯﺍﻥﻩ
sushil	ﺱﻭﺵیﻝ
suska	ﺱﺍﺱکﺍ
sussman	ﺱﺍﺱﻡﻥ
sustik	ﺱﺍﺱﺕیک
suter	ﺱﺍﺕﺭ
sutkus	ﺱﺍﺕکﺍﺱ
sutphen	ﺱﺍﺕﻑیﻥ
sutter	ﺱﻭﺕﺭ
sutton	ﺱﺍﺕﻥ
suture	ﺱﺍچﺭ
suwayda	ﺱﻭیﺩﺍ
suwito	ﺱﻭیﺕﻭ
suze	ﺱﻭﺯ
suzy	ﺱﻭﺯی
swa	ﺱﻭﺍ
swafford	ﺱﻭﺍﻑﻭﺭﺩ
swag	ﺱﻭگ
swagato	ﺱﻭﺍگﺍﺕﻭ
swallow	ﺱیﻭﺍﻝﻭ
swami	ﺱﻭﺍﻡی
swamy	ﺱﻭﺍﻡی
swan	ﺱﻭﺍﻥ
swank	ﺱﻭﺍﻥک
swany	ﺍﺱﻭﺍﻥﺍی
swart	ﺱﻭﺍﺭﺕ
swash	ﺱﻭﺍﺵ
swearingin	ﺱﻭﺍﺭیﻥگیﻥ
swearman	ﺱﻭﺍﺭﻡﻥ
sweeny	ﺱﻭﺍﻥی
swensen	ﺱﻭﻥﺱﻥ
swift	ﺱﻭیﻑﺕ
swine	ﺱﻭیﻥ
swingler	ﺱﻭیﻥگﻝﺭ
swink	ﺱﻭییﻥک
swinnerton	ﺱﻭیﻥﺭﺕﻭﻥ
swisher	ﺍﺱﻭیﺵﺭ
switenky	ﺱﻭیﺕﻥکی
sydney	ﺱیﺩﻥی
sylvan	ﺱیﻝﻭﺍﻥ
sylvia	ﺱیﻝﻭیﺍ
syme	ﺱﺍیﻡ
symington	ﺱیﻡیﻥگﺕﻭﻥ
sync	ﺱیﻥک
systems	ﺱیﺱﺕﻡﺯ
sytje	ﺱیﺕﺝ
taatje	ﺕﺍﺕ
table	ﺕیﺏﻝ
tabuk	ﺕﺍﺏﻭک
taco	ﺕﺍکﻭ
tad	ﺕﺍﺩ
taffone	ﺕﺍﻑﻭﻥ
tafilah	ﺕﻉﻑیﻝﻩ
tagle	ﺕگﻝ
tahara	ﺕﺍﻩﺍﺭﺍ
tahirah	طﺍﻩﺭیﻩﺍ
tahoun	ﺕﺍﻩﻭﻥ
tahsin	ﺕﺡﺱیﻥ
tai	ﺕﺍی
tak	ﺕک
taka	ﺕﺍکﺍ
taki	ﺕﺍکی
takiyah	ﺕکیﺍﻩ
talbert	ﺕﻝﺏﺭﺕ
talboys	ﺕﺍﻝﺏﻭیﺯ
talcott	ﺕﺍﻝکﻭﺕ
talib	طﻝیﺏ
talibah	طﻝیﺏﺍ
tallan	ﺕﺍﻝﺍﻥ
tallen	ﺕﺍﻝﻥ
tallent	ﺕﻝﻥﺕ
talman	ﺕﺍﻝﻡﻥ
talmy	ﺕﺍﻝﻡی
tam	ﺕﺍﻡ
tamai	ﺕﺍﻡﺍی
tamas	ﺕﺍﻡﺍﺱ
tamburri	ﺕﻡﺏﺭی
tame	ﺕیﻡ
tamir	ﺕﻡیﺭ
tammana	ﺕﺍﻡﺍﻥﺍ
tampas	ﺕﺍﻡپﺍﺱ
tanak	ﺕﺍﻥﺍک
tandiary	ﺕﻥﺩیﺭی
tanis	ﺕﺍﻥیﺱ
tanton	ﺕﺍﻥﺕﻭﻥ
tants	ﺕﻥﺕﺱ
tanwar	ﺕﻥﻭﺭ
tapio	ﺕﺍپیﻭ
taplin	ﺕﺍپﻝیﻥ
tappin	ﺕﺍپیﻥ
taraz	ﺕﺭﺍﺯ
tardell	ﺕﺍﺭﺩﻝ
tariq	طﺭیﻕ
tarr	ﺕﺍﺭ
tarub	طﺭﻭﺏ
tasdeler	ﺕﺍﺱﺩیﻝﺭ
tasker	ﺕﺍﺱکﺭ
tat	ﺕﺍﺕ
tatari	ﺕﺍﺕﺍﺭی
tatby	ﺕﺍﺕﺏﺍی
tate	ﺕیﺕ
taterway	ﺕﺍﺕﺭﻭی
tatsuro	ﺕﺍﺕﺱﻭﺭﻭ
tattam	ﺕﺍﺕﺍﻡ
tavares	ﺕﺍﻭﺍﺭﺱ
tavernini	ﺕﺍﻭﺭﻥیﻥی
tay	ﺕی
teague	ﺕیگﻭ
tean	ﺕیﻥ
teche	ﺕک
teck	ﺕک
teed	ﺕیﺩ
teeling	ﺕیﻝیﻥگ
teeth	ﺕیﺕ
tegelberg	ﺕگﻝﺏﺭگ
teh	ﺕﻩ
tehan	ﺕیﻩﺍﻥ
telecom	ﺕﻝکﻭﻡ
telfer	ﺕﻝﻑﺭ
tell	ﺕﻝ
teller	ﺕﻝﺭ
tello	ﺕﻝﻝﻭ
tempelman	ﺕﻡپﻝﻡﻥ
tempest	ﺕﻡپﺱﺕ
templar	ﺕﻡپﻝﺭ
templeton	ﺕﻡپﻝﺕﻭﻥ
tenaya	ﺕﻥﺍیﺍ
tenbrook	ﺕﻥﺏﺭﻭک
tennant	ﺕیﻥﺍﻥﺕ
tennebo	ﺕﻥﺏﻭ
tennyson	ﺕﻥیﺱﺍﻥ
tenorio	ﺕﻥﻭﺭیﻭ
tenpo	ﺕﻥپﻭ
tent	ﺕﻥﺕ
teppo	ﺕپﻭ
teresa	ﺕﺭﺱﺍ
teri	ﺕﺭی
terminal	ﺕﺭﻡیﻥﺍﻝ
tern	ﺕﺭﻥ
ternes	ﺕﺭﻥﺱ
ternyck	ﺕﺭﻥیک
terrace	ﺕﺭﺍﺱﻩ
terrada	ﺕﺭﺍﺩﺍ
terran	ﺕﺭﺍﻥ
terrapin	ﺕﺭﺍپیﻥ
terrell	ﺕﺭﻝ
terrence	ﺕﺭﻥﺱﻩ
terri	ﺕﺭی
terrible	ﺕﺭیﺏﻝ
terris	ﺕﺭیﺱ
territory	ﺕﺭیﺕﻭﺭی
terror	ﺕﺭﻭﺭ
terry	ﺕﺭی
tertene	ﺕﺭﺕﻥﻩ
teruel	ﺕﺭﻭﻝ
teruhiko	ﺕﺭﻭﻩیکﻭ
terwilliger	ﺕﺭﻭیﻝیگﺭ
teshima	ﺕﺵیﻡﺍ
tesink	ﺕﺱیﻥک
tesla	ﺕﺱﻝﺍ
tesler	ﺕﺱﻝﺭ
tess	ﺕﺱ
tessner	ﺕﺱﻥﺭ
testa	ﺕﺱﺕﺍ
tester	ﺕﺱﺕﺭ
tetervin	ﺕﺕﺭﻭیﻥ
tether	ﺕﺕﺭ
tetrad	ﺕﺕﺭﺍﺩ
tetro	ﺕﺕﺭﻭ
teunis	ﺕیﻭﻥیﺱ
teusink	ﺕﻭﺱیﻥک
tewari	ﺕﻭﺍﺭی
tewie	ﺕﻭیﻩ
tex	ﺕکﺱ
thabit	طﺏیﺏ
thalberg	ﺕﺍﻝﺏﺭگ
thallmayer	ﺕﺍﻝﻡﺍیﺭ
thana	ﺕﺍﻥﺍ
thao	ﺕﺍیﻭ
thapa	ﺕﺍپﺍ
thara	ﺕﺍﺭﺍ
thayer	ﺕﺍیﺭ
thedell	ﺕﺩﻝ
theis	ﺕیﺯ
thelander	ﺕﻝﺍﻥﺩﺭ
thelen	ﺕیﻝﻥ
therese	ﺕﺭﺯﻩ
theroux	ﺕیﺭﻭکﺱ
theunis	ﺕیﻭﻥیﺱ
thief	ﺕیﻑ
thilo	ﺕیﻝﻭ
tho	ﺕﻭ
thom	ﺕﺍﻡ
thomas	ﺕﻭﻡﺍﺱ
thommesen	ﺕﺍﻡﺱﻥ
thomsen	ﺕﺍﻡﺱﻭﻥ
thong	ﺕﻭﻥگ
thoresen	ﺕﻭﺭیﺱﻥ
thorn	ﺕﻭﺭﻥ
thornley	ﺕﻭﺭﻥﻝی
thornton	ﺕﺭﻥﺕﻥ
thorpe	ﺕﻭﺭپ
thorson	ﺕﺍﺭﺱﻭﻥ
thorud	ﺕﻭﺭﺍﺩ
thorup	ﺕﻭﺭﻭپ
threston	ﺕﺭﺱﺕﻭﻥ
throop	ﺕﺭﻭپ
thulen	ﺕییﻭﻝﻥ
thulin	ﺕﻭﻝیﻥ
thumb	ﺕﺍﻡﺏ
thurayya	ﺕﻭﺭیﺍ
thurber	ﺕﻭﺭﺏﺭ
thurlede	ﺕﺭﺩ
thurlo	ﺕﺭﻝﻭ
thurman	ﺕﻭﺭﻡﻥ
thurn	ﺕﺍﺭﻥ
tichauer	ﺕیچﺍﻭﺭ
tiebout	ﺕیﺏﺍﺕ
tielemans	ﺕیﻝﻡﺍﻥﺱ
tien	ﺕیﻥ
tierie	ﺕﺭی
tierney	ﺕیﺭﻥی
tifford	ﺕیﻑﻭﺭﺩ
tiits	ﺕیﺕﺱ
tijmen	ﺕیﺝﻡﻥ
tilbury	ﺕیﻝﺏﺭی
tilden	ﺕیﻝﺩﻥ
tilgner	ﺕیﻝگﻥﺭ
tiller	ﺕیﻝﺭ
tillotson	ﺕیﻝﻭﺕﺱﺍﻥ
timbol	ﺕیﻡﺏﻭﻝ
timian	ﺕیﻡیﺍﻥ
timko	ﺕیﻡکﻭ
timmins	ﺕیﻡیﻥﺯ
timonin	ﺕیﻡﻭﻥیﻥ
timur	ﺕیﻡﻭﺭ
tin	ﺕیﻥ
tina	ﺕیﻥﺍ
tindall	ﺕیﻥﺩﺍﻝ
ting	ﺕیﻥگ
tingley	ﺕیﻥگﻝی
tinney	ﺕﻥی
tinsel	ﺕیﻥﺱﻝ
tinsley	ﺕیﻥﺱﻝی
tiny	ﺕیﻥی
tio	ﺕیﻭ
tioga	ﺕیﻭگﺍ
tippu	ﺕیپﻭ
tipul	ﺕیپﺍﻝ
tirza	ﺕیﺭﺯﺍ
tisza	ﺕیﺱﺯﺍ
title	ﺕﺍﺕﻝ
titmus	ﺕیﺕﻡﺍﺱ
tjaatje	ﺕیﺝﺍﺕﻩ
toal	ﺕﻭﻝ
tobe	ﺕﻭﺏ
tobias	ﺕﻭﺏیﺍﺱ
tobin	ﺕﻭﺏیﻥ
todd	ﺕﻭﺩ
tofferi	ﺕﻭﻑﺭی
toft	ﺕﺍﻑﺕ
toida	ﺕﻭیﺩﺍ
toit	ﺕﻭیﺕ
tokman	ﺕﺍکﻡﻥ
tokyo	ﺕﻭکیﻭ
tolani	ﺕﻭﻝﺍﻥی
toledo	ﺕﻭﻝﺩﻭ
toleno	ﺕﺍﻝﻥﻭ
tolliver	ﺕﻭﻝیﻭﺭ
tolman	ﺕﻭﻝﻡﻥ
tolvanen	ﺕﺍﻝﻭﺍﻥﻥ
tom	ﺕﺍﻡ
tomany	ﺕﻭﻡﺍﻥی
tomatius	ﺕﺍﻡﺍﺕیﻭﺱ
tombros	ﺕﺍﻡﺏﺭﻭﺱ
tomes	ﺕﻭﻡﺯ
tomi	ﺕﺍﻡی
tomines	ﺕﺍﻡیﻥﺯ
tommi	ﺕﻭﻡی
tompkins	ﺕﺍﻡپکیﻥﺯ
toms	ﺕﺍﻡﺯ
tomura	ﺕﺍﻡﺍﺭﺍ
tonar	ﺕﻭﻥﺍﺭ
toner	ﺕﻭﻥﺭ
tong	ﺕﺍﻥگ
tongue	ﺕﺍﻥگ
tonjes	ﺕﺍﻥﺝﺱ
tony	ﺕﻭﻥی
tooke	ﺕﻭک
tooley	ﺕﻭﻝی
toon	ﺕﻭﻥ
tooth	ﺕﻭﺱ
topic	ﺕﺍپیک
toptani	ﺕﺍپﺕﺍﻥی
torda	ﺕﻭﺭﺩﺍ
toren	ﺕﻭﺭﻥ
torigoe	ﺕﺭیﺝﻭ
tormala	ﺕﻭﺭﻡﺍﻝﺍ
tornberg	ﺕﻭﺭﻥﺏﺭگ
torres	ﺕﺍﺭﺱ
torrez	ﺕﻭﺭﺯ
torrie	ﺕﻭﺭی
toscano	ﺕﻭﺱکﺍﻥﻭ
totty	ﺕﻭﺕی
touch	ﺕﺍچ
tow	ﺕﺍﻭ
tower	ﺕﺍﻭﺭ
tra	ﺕﺭﺍ
tracey	ﺕﺭیﺱی
tracy	ﺕﺭیﺱی
trafford	ﺕﺭﺍﻑﻭﺭﺩ
trafton	ﺕﺭﺍﻑﺕﻭﻥ
traiectensis	ﺕﺭیکﺕﻥﺱیﺱ
trainham	ﺕﺭیﻥﻩﺍﻡ
trainor	ﺕﺭیﻥﻭﺭ
trapp	ﺕﺭﺍپ
trash	ﺕﺭﺵ
traster	ﺕﺭﺍﺱﺕﺭ
trauzzi	ﺕﺭﺍﻭﺯی
travaglia	ﺕﺭﺍﻭﺍﺝﻝیﺍ
traynor	ﺕﺭﺍیﻥﻭﺭ
treadway	ﺕﺭیﺩﻭی
treindl	ﺕﺭیﻥﺩ
treitel	ﺕﺭیﺕﻝ
trent	ﺕﺭﻥﺕ
trethowan	ﺕﺭﺕﻭﺍﻥ
treuerice	ﺭﻭﺭیﺱ
trevor	ﺕﺭیﻭﺭ
tribble	ﺕﺭیﺏﻝ
trickett	ﺕﺭیکﺕ
triemstra	ﺕﺭیﻡﺱﺕﺍﺭ
triggs	ﺕﺭیگﺱ
trim	ﺕﺭیﻡ
trindade	ﺕﺭیﻥﺩﺍﺩ
trinkle	ﺕﺭیﻥکﻝ
triolo	ﺕﺭیﻭﻝﻭ
tripps	ﺕﺭیپﺱ
tristram	ﺕﺭیﺱﺕﺭﻡ
tritle	ﺕﺭیﺕﻝ
troedson	ﺕﺭﻭﺩﺱﻭﻥ
trollinger	ﺕﺭﻭﻝیﻥگﺭ
trometer	ﺕﺭﻭﻡیﺕﺭ
tron	ﺕﺭﻭﻥ
trotter	ﺕﺭﻭﺕﺭ
trough	ﺕﺭﻭ
troughton	ﺕﺭﻭگﺕﻭﻥ
trout	ﺕﺭﻭﺕ
trown	ﺕﺭﺍﻭﻥ
trubey	ﺕﺭﻭﺏی
trucco	ﺕﺭﺍکﻭ
trudel	ﺕﺭﻭﺩﻝ
true	ﺕﺭﻭ
truesdale	ﺕﺭﻭیﺱﺩیﻝ
truex	ﺕﺭﻭکﺱ
truitje	ﺕﺭیﻭیﺕژ
trull	ﺕﺭﻭﻝ
trumbo	ﺕﺭﻭﻡﺏﻭ
tryntje	ﺕﺭیﻥﺕ
tuama	ﺕﻭﺍﻡﺍ
tubutis	ﺕﻭﺏﻭﺕیﺱ
tucker	ﺕﺍکﺭ
tudor	ﺕﺍﺩﺭ
tufte	ﺕﻭﻑﺕﻩ
tufts	ﺕﺍﻑﺕﺯ
tuglu	ﺕﺍگﻝﻭ
tula	ﺕﻭﻝﺍ
tuli	ﺕﻭﻝی
tulio	ﺕﻭﻝیﻭ
tullis	ﺕﺍﻝیﺱ
tully	ﺕﻭﻝی
tulse	ﺕﺍﻝﺱ
tuna	ﺕیﻭﻥﺍ
tunen	ﺕﺍﻥﻥ
tung	ﺕﻭﻥگ
tunga	ﺕﻭﻥگﺍ
tuohela	ﺕﻭﻩﻝﺍ
tuomas	ﺕﻭﻡﺍﺱ
tuomi	ﺕﻭﻡی
tuominen	ﺕیﻭﻡیﻥﻥ
tuong	ﺕﻭﻥگ
tupper	ﺕﺍپﺭ
tupshin	ﺕﺍپﺵیﻥ
turambar	ﺕﻭﺭﺍﻡﺏﺭ
turco	ﺕﻭﺭکﻭ
turcotte	ﺕﻭﺭکﺍﺕ
turin	ﺕﻭﺭیﻥ
turkel	ﺕﺍﺭکﻝ
turmelle	ﺕﺍﺭﻡﻝ
turmoil	ﺕﺭﻡﻭیﻝ
turner	ﺕﺭﻥﺭ
turnitsa	ﺕﺭﺍﻥیﺕﺱﺍ
turoff	ﺕﻭﺭﻭﻑ
turtle	ﺕﻭﺭﺕﻝ
turton	ﺕﺭﺕﻭﻥ
tushar	ﺕﻭﺵﺍﺭ
tusing	ﺕﻭﺱیﻥگ
tuso	ﺕﻭﺱﻭ
tuthill	ﺕﺍﺕیﻝ
tuttle	ﺕﺍﺕﻝ
tuxbury	ﺕﺍکﺱﺏﺭی
tuyet	ﺕﻭیﺕ
tweedale	ﺕﻭییﺩیﻝ
tweedie	ﺕﻭیﺩی
twigg	ﺕﻭییگ
twin	ﺕﻭییﻥ
twiss	ﺕﻭﻭیﺱ
twitchell	ﺕﻭﺍیچﻝ
two	ﺕﻭ
twombly	ﺕﻭﻡﺏﻝی
tye	ﺕﺍی
tyler	ﺕیﻝﺭ
tymen	ﺕیﻡﻥ
tymes	ﺕیﻡﺯ
tyndall	ﺕیﻥﺩﺍﻝ
tyng	ﺕیﻥگ
tynor	ﺕﺍیﻥﻭﺭ
tyrone	ﺕﺍیﺭﻭﻥ
tysinger	ﺕیﺱیﻥﺝﺭ
tysmans	ﺕیﺱﻡﻥﺯ
tyson	ﺕﺍیﺱﻥ
tytie	ﺕیﺕی
ubaid	ﺍﺏیﺩ
ubiera	یﻭﺏیﺭﺍ
udo	ﺍﻭﺩﻭ
udolph	ﺍﺩﻭﻝﻑ
uemura	یﻭﻡﻭﺭﺍ
uenal	یﻭﻥﺍﻝ
uffington	یﻭﻑیﻥگﺕﻭﻥ
uffner	ﺍﻭﻑﻥﺭ
ugur	ﺍﻭگﺍﺭ
ukelo	یﻭکیﻝﻭ
ukraine	ﺍﻭکﺭﺍیﻥ
ulima	ﺍﻝیﻡﺍ
ullman	ﺍﻭﻝﻡﻥ
ulvestad	ﺍﻭﻝﻭﺱﺕﺍﺩ
umar	ﻉﻡﺭ
umberger	ﺍﻭﻡﺏﺭگﺭ
umlas	ﺍﻭﻡﻝﺍﺱ
umstead	ﺍﻡﺱﺕﺩ
unaiza	یﻭﻥیﺯﺍ
unpingco	ﺍﻥپیﻥگکﻭ
unruh	ﺍﻥﺭﺍﻩ
unsicker	ﺍﻥﺱیکﺭ
upchurch	ﺍپچﺭچ
uplands	ﺍپﻝﻥﺩﺱ
upright	ﺍپﺭﺍیﺕ
upston	ﺍپﺱﺕﻥ
uranium	یﻭﺭﺍﻥیﻡ
urbanik	یﻭﺭﺏﺍﻥیک
urena	یﻭﺭیﻥﺍ
uri	ﺍﻭﺭی
urma	ﺍﻭﺭﻡﺍ
user	یﻭﺯﺭ
vaccaro	ﻭکﺭﻭ
vadaparty	ﻭﺍﺩﺍپﺍﺭﺕی
vadlamudi	ﻭﺩﻝﻡﻭﺩی
vaggen	ﻭﺍگﻥ
vagner	ﻭﺍگﻥﺭ
vail	ﻭیﻝ
vaitkus	ﻭیﺕکﻭﺱ
vajdic	ﻭﺍﺝﺩیک
valance	ﻭﺍﻝﺍﻥﺱ
valdez	ﻭﺍﻝﺩﺯ
vale	ﻭﺍﻝ
valentijn	ﻭﺍﻝﻥﺕیﺝﻥ
valerian	ﻭﺍﻝﺭیﻥ
valihora	ﻭﺍﻝیﻩﻭﺭ
valkenaar	ﻭﺍﻝکﻥﺍﺭ
vall	ﻭﺍﻝ
valley	ﻭﺍﻝی
valur	ﻭﺍﻝﻭﺭ
van	ﻑﻭﻥ
vanantwerp	ﻭﺍﻥﺍﺕﻭﺭپ
vanburen	ﻭﺍﻥﺏﺭﻥ
vance	ﻭﺍﻥﺱی
vancko	ﻭﻥکﻭ
vancuren	ﻭﺍﻥکﻭﺭﻥ
vandeman	ﻭﻥﺩﻡﻥ
vanden	ﻭﺍﻥﺩﻥ
vandenburgh	ﻭﺍﻥﺩﻥﺏﺭﻕ
vanderford	ﻭﻥﺩﺭﻑﻭﺭﺩ
vanderveer	ﻭﺍﻥﺩﺭﻭیﺭ
vandousen	ﻭﺍﻥﺩﻭﺱﻥ
vandry	ﻭﻥﺩﺭی
vanduzen	ﻭﺍﻥﺩﺯﻥ
vandyck	ﻭﺍﻥﺩیک
vanecek	ﻭﺍﻥﺱک
vang	ﻭﺍﻥگ
vanhoff	ﻭﻥﻩﻑ
vanick	ﻭﻥیک
vankeuren	ﻭﺍکﻭﺭﻥ
vanriper	ﻭﻥﺭیپﺭ
vanschoonhoven	ﻭﺍﻥﺱچﻭﻥﻩﻭﻥ
vanvleck	ﻭﺍﻥﻭﻝک
vanvranken	ﻭﺍﻥﻭﺭﺍﻥکﻥ
vanzandt	ﻭﺍﻥﺯﺍﻥﺕ
vardan	ﻭﺭﺩﺍﻥ
vardi	ﻭﺍﺭﺩی
vargas	ﻭﺍﺭگﺍﺱ
vargo	ﻭﺍﺭگﻭ
variants	ﺍﻭﺭیﻥﺕﺱ
varieur	ﻭﺍﺭیﻭﺭ
varlow	ﻭﺭﻝﻭ
varma	ﻭﺍﺭﻡﺍ
varnes	ﻭﺍﺭﻥﺱ
varney	ﻭﺍﺭﻥی
varty	ﻭﺍﺭﺕی
varvel	ﻭﺍﺭﻭﻝ
vasallo	ﻭﺍﺱﺍﻝﻭ
vato	ﻭﺍﺕﻭ
vawdry	ﻭیﺩﺭی
vaya	ﻭﺍیﺍ
veasey	ﻭیﺱی
vecoven	ﻭیکﺍﻭﻥ
ved	ﻭﺩ
vee	ﻭی
vela	ﻭﻝﺍ
velasco	ﻭیﻝﺍﺱکﻭ
veld	ﻭﻝﺩ
velden	ﻭﻝﺩﻥ
veldman	ﻭﻝﺩﻡﻥ
vella	ﻭﻝﺍ
velletri	ﻭﻝﺕﺭی
veloso	ﻭﻝﻭﺱﻭ
ven	ﻭﻥ
venable	ﻭیﻥیﺏﻝ
venables	ﻭﻥﺍﺏﻝﺱ
venkat	ﻭﻥکﺍﺕ
venkata	ﻭﻥکﺍﺕﺍ
venner	ﻭﻥﺭ
ventureli	ﻭﻥﺕﺭﻝی
verbeck	ﻭﺭﺏک
verhulst	ﻭﺭﻩﻭﺱﺕ
verity	ﻭﺭیﺕی
verlinde	ﻭﺭﻝیﻥﺩ
verma	ﻭﺭﻡﺍ
vermaas	ﻭﺭﻡﺍﺱ
vermaseren	ﻭﺭﻡﺍﺱﺭﻥ
vermes	ﻭﺭﻡﺯ
vermeulen	ﻭﺭﻡیﻭﻝﻥ
vermillion	ﻭﺭﻡیﻝییﻭﻥ
vernon	ﻭﺭﻥﻥ
verweij	ﻭﺭﻭیﺝ
vessels	ﻭﺱﻝﺯ
vessey	ﻭﺱی
vest	ﻭﺱﺕ
vestal	ﻭﺱﺕﺍﻝ
vestli	ﻭﺱﺕﻝی
vetter	ﻭﺕﺭ
vezina	ﻭﺯیﻥﺍ
vianen	ﻭیﺍﻥﻥ
vic	ﻭیک
vicious	ﻭیﺱیﻭﺱ
vickers	ﻭیکﺭﺯ
victim	ﻭیکﺕیﻡ
victor	ﻭیکﺕﻭﺭ
vidal	ﻭیﺩﺍﻝ
video	ﻭیﺩیﻭ
vidi	ﻭیﺩی
vieux	ﻭیﻭکﺱ
vigen	ﻭیگﻥ
vik	ﻭیک
vikas	ﻭیکﺍﺱ
vikram	ﻭیکﺭﺍﻡ
viktor	ﻭیکﺕﻭﺭ
vila	ﻭیﻝﺍ
viladot	ﻭیﻝﺍﺩﻭﺕ
vilas	ﻭیﻝﺍﺱ
vilcans	ﻭیﻝکﺍﻥﺱ
viles	ﻭیﻝﺯ
viljo	ﻭیﻝﺝﻭ
villa	ﻭیﻝﺍ
villani	ﻭیﻝیﺍﻥی
villard	ﻭیﻝﺍﺭﺩ
vimal	ﻭیﻡﺍﻝ
vin	ﻭیﻥ
vinata	ﻭیﻥﺍﺕﺍ
vincent	ﻭیﻥﺱﻥﺕ
vine	ﻭﺍیﻥ
vineis	ﻭیﻥیﺯ
vinko	ﻭیﻥکﻭ
vinson	ﻭیﻥﺱﻭﻥ
viola	ﻭیﻭﻝﺍ
vipin	ﻭیپیﻥ
viraf	ﻭیﺭﺍﻑ
viren	ﻭیﺭﻥ
virendra	ﻭیﺭﻥﺩﺭﺍ
virgil	ﻭیﺭﺝیﻝ
virginia	ﻭیﺭﺝیﻥیﺍ
virtanen	ﻭیﺭﺕﺍﻥﻥ
virtual	ﻭیﺭچﻭﺍﻝ
visca	ﻭیﺱکﺍ
vish	ﻭیﺵ
vision	ﻭیژﻭﻥ
visionary	ﻭیژﻥﺭی
vispi	ﻭیﺱپی
visser	ﻭیﺱﺭ
vitaca	ﻭیﺕﺍکﺍ
vitale	ﻭیﺕﺍﻝ
vito	ﻭیﺕﻭ
vitor	ﻭیﺕﻭﺭ
vitt	ﻭیﺕ
vittoria	ﻭیﺕﻭﺭیﺍ
viva	ﻭیﻭﺍ
vivek	ﻭیﻭک
vivian	ﻭیﻭیﺍﻥ
viviane	ﻭیﻭیﺍﻥﻩ
vizen	ﻭیﺯﻥ
vladack	ﻭﻝﺍﺩﺍک
vladan	ﻭﻝﺍﺩﺍﻥ
vlado	ﻭﻝﺍﺩﻭ
voccia	ﻭککیﺍ
vogel	ﻭگﻝ
vogl	ﻭگﻝ
vogler	ﻭﻭگﻝﺭ
vohra	ﻭﻩﺭﺍ
vojak	ﻭﻭﺝﺍک
voldman	ﻭﻝﺩﻡﻥ
volk	ﻭﻝک
volkman	ﻭﻝکﻡﺍﻥ
vollum	ﻭﺍﻝﻭﻡ
volodin	ﻭﻝﻭﺩیﻥ
voltmer	ﻭﻝﺕﻡﺭ
volz	ﻭﻝﺯ
von	ﻭﻥ
vonk	ﻭﺍﻥک
vos	ﻭﺱ
voss	ﻭﺍﺱ
vost	ﻭﺍﺱﺕ
vowles	ﻭﻭﻝﺯ
vrouwtje	ﺭﻭﺕﺝ
vulis	ﻭﻝیﺱ
wack	ﻭک
wackerfuss	ﻭکﺭﻑﺍﺱ
wade	ﻭیﺩ
wafa	ﻭﺍﻑﺍ
wafiyyah	ﻭﺍﻑیﺍ
wagle	ﻭﺍگﻝ
wagner	ﻭگﻥﺭ
wah	ﻭﺍﻩ
wai	ﻭی
wail	ﻭیﻝ
waingrow	ﻭﺍیﻥگﺭﻭ
wainstead	ﻭیﻥﺱﺕﺩ
waite	ﻭیﺕ
waites	ﻭیﺕﺯ
wajihah	ﻭﺝیﺡﻩ
wake	ﻭیک
wakefield	ﻭیکﻑیﻝﺩ
wal	ﻭﺍﻝ
waldmanneuenna	ﻭﺍﻝﺩﻡﺍﻥیﻭﻥﺍ
waldo	ﻭﺍﻝﺩﻭ
waldram	ﻭﺍﻝﺩﺭﺍﻡ
walenta	ﻭﻝﻥﺕﺍ
wales	ﻭﺍﻝﺯ
walidah	ﻭﻝیﺩﻩ
walka	ﻭﺍﻝکﺍ
walkerdine	ﻭﺍکﺭﺩﺍیﻥ
wallace	ﻭﺍﻝیﺱ
walle	ﻭﺍﻝﻩ
wallewein	ﻭﺍﻝﻭیﻥ
wallin	ﻭﺍﻝیﻥ
wallington	ﻭﺍﻝیﻥگﺕﻥ
wallis	ﻭﺍﻝیﺱ
wallman	ﻭﺍﻝﻡﻥ
wally	ﻭﺍﻝی
walter	ﻭﺍﻝﺕﺭ
walters	ﻭﺍﻝﺕﺭﺯ
walth	ﻭﺍﻝﺕ
waltman	ﻭﺍﻝﺕﻡﻥ
walton	ﻭﺍﻝﺕﻥ
walworth	ﻭﺍﻝﻭﺭﺕ
wan	ﻭﺍﻥ
wand	ﻭﻥﺩ
warborough	ﻭﺭﺏﻭﺭﻭﻑ
warburton	ﻭﺍﺭﺏﺭﺕﻭﻥ
ware	ﻭیﺭ
warn	ﻭﺍﺭﻥ
warne	ﻭﺍﺭﻥ
warner	ﻭﺍﺭﻥﺭ
wasay	ﻭﺱی
waseem	ﻭﺍﺱیﻡ
washington	ﻭﺍﺵیﻥگﺕﻭﻥ
wasik	ﻭﺍﺱیک
wasit	ﻭﺍﺱیط
waskey	ﻭﺍﺱکی
waslo	ﻭﺍﺱﻝﻭ
wass	ﻭﺍﺱ
wasson	ﻭیﺱﻭﻥ
watanabe	ﻭﺍﺕﺍﻥیﺏ
waterhouse	ﻭﺍﺕﺭﻩﺍﻭﺱ
waterman	ﻭﺍﺕﺭﻡﻥ
waters	ﻭﺍﺕﺭﺯ
watkins	ﻭﺍﺕکیﻥﺯ
watt	ﻭﺍﺕ
watterson	ﻭﺍﺕﺭﺱﻭﻥ
watts	ﻭﺍﺕﺱ
wavle	ﻭﺍﻝﻭ
way	ﻭی
weage	ﻭیگ
weare	ﻭیﺭ
weast	ﻭیﺱﺕ
weaston	ﻭیﺱﺕﻭﻥ
weaver	ﻭیﻭﺭ
webb	ﻭﺏ
weber	ﻭﺏﺭ
webster	ﻭﺏﺱﺕﺭ
wechner	ﻭچﻥﺭ
wedberg	ﻭﺩﺏﺭگ
wedelin	ﻭﺩﻝیﻥ
wedemeier	ﻭﺩﻡیﺭ
wee	ﻭی
weedon	ﻭیﺩﻭﻥ
weeks	ﻭیکﺱ
weers	ﻭیﺭﺯ
wegert	ﻭیگﺭﺕ
wegner	ﻭگﻥﺭ
weidman	ﻭیﺩﻡﺍﻥ
weigand	ﻭیگﺍﻥﺩ
weigend	ﻭیﺝﻥﺩ
weikamp	ﻭیکﺍﻡپ
weiland	ﻭیﻝﻥﺩ
weiler	ﻭیﻝﺭ
weimann	ﻭیﻡﺍﻥ
weimar	ﻭیﻡﺭ
wein	ﻭیﻥ
weinberg	ﻭیﻥﺏﺭگ
weinelt	ﻭیﻥﻝﺕ
weiner	ﻭیﻥﺭ
weinert	ﻭیﻥﺭﺕ
weinstock	ﻭیﻥﺱﺕﻭک
weintz	ﻭﻥﺕﺯ
welam	ﻭﻝﺍﻡ
wellemtje	ﻭیﻝﻡﺕﺝی
wellingk	ﻭﻝیﻥک
wellington	ﻭﻝیﻥگﺕﻭﻥ
wellman	ﻭﻝﻡﻥ
wells	ﻭﻝﺯ
welsh	ﻭﻝﺵ
welter	ﻭﻝﺕﺭ
welty	ﻭﻝﺕی
welzel	ﻭﻝﺯﻝ
wen	ﻭﻥ
wench	ﻭﻥچ
wendel	ﻭﻥﺩﻝ
wendell	ﻭﻥﺩﻝ
wendland	ﻭﻥﺩﻝﻥﺩ
wendzel	ﻭﻥﺩﺯﻝ
weninger	ﻭﻥیﻥگﺭ
wensel	ﻭﻥﺱﻝ
wermont	ﻭﺭﻡﻭﻥﺕ
wernegreen	ﻭﺭﻥگﺭیﻥ
werner	ﻭﺍﺭﻥﺭ
werry	ﻭﺭی
wershoven	ﻭﺭﺵﻭﻭﻥ
wesley	ﻭﺱﻝی
wesleyan	ﻭﺱﻝیﺍﻥ
wesson	ﻭیﺱﻭﻥ
west	ﻭﺱﺕ
weste	ﻭﺱﺕ
wester	ﻭﺱﺕﺭ
westerholm	ﻭﺱﺕﺭﻩﻝﻡ
western	ﻭﺱﺕﺭﻥ
westerveldt	ﻭﺱﺕﺭﻭﻝﺕ
westfall	ﻭﺱﺕﻑﺍﻝ
westley	ﻭﺱﺕﻝی
westmoreland	ﻭﺱﺕﻡﻭﺭﻝﻥﺩ
weston	ﻭﺱﺕﻥ
westover	ﻭﺱﺕﻭﺭ
westphal	ﻭیﺱﺕﻑﺍﻝ
wet	ﻭﺕ
wetmore	ﻭﺕﻡﻭﺭ
whadzen	ﻭﺍﺩﺯﻥ
whalen	ﻭﺍﻝﻥ
whaley	ﻭﺍﻝی
whalley	ﻭﺍﻝی
wharton	ﻭﺍﺭﺕﻭﻥ
wheat	ﻭیﺕ
wheaton	ﻭیﺕﻥ
wheeler	ﻭیﻝیﺭ
whelan	ﻭﻝﺍﻥ
whinen	ﻭیﻥﻥ
whitaker	ﻭیﺕیکﺭ
whitcomb	ﻭیﺕکﺍﻡﺏ
whiteaker	ﻭﺍیﺕیکﺭ
whitehorn	ﻭﺍیﺕﻩﺭﻥ
whitehouse	ﻭﺍیﺕﻩﺍﻭﺱ
whitfield	ﻭیﺕﻑیﻝﺩ
whitmore	ﻭیﺕﻡﺭ
whitson	ﻭیﺕﺱﻭﻥ
whittaker	ﻭیﺕﺍکﺭ
whittemore	ﻭیﺕﻡﻭﺭ
whittenburg	ﻭیﺕﻥﺏﺭگ
whittington	ﻭیﺕیﻥگﺕﻭﻥ
whitwell	ﻭیﺕﻭﻝ
whitworth	ﻭﺍیﺕﻭﺭﺱ
whorwood	ﻭﺭﻭﻭﺩ
wibowo	ﻭیﺏﻭﻭﻭ
wichura	ﻭیچﻭﺭﺍ
wick	ﻭیک
wickham	ﻭیکﻩﺍﻡ
wicks	ﻭیکﺱ
widad	ﻭیﺩﺍ
widdul	ﻭیﺩﺍﻝ
wide	ﻭﺍیﺩ
widere	ﻭیﺩیﺭ
widmer	ﻭیﺩﻡﺭ
wiebe	ﻭیﺏ
wiegand	ﻭیگﺍﻥﺩ
wieland	ﻭیﻝﻥﺩ
wiepkje	ﻭیپک
wier	ﻭیﺭ
wierse	ﻭییﺭﺱ
wiersma	ﻭیﺭﺱﻡﺍ
wietse	ﻭیﺕﺱﻩ
wiewer	ﻭیﻭﻭﺭ
wifall	ﻭیﻑﺍﻝ
wiggin	ﻭیگﺝیﻥ
wiggins	ﻭیگیﻥﺯ
wigle	ﻭﺍیگﻝ
wigley	ﻭیگﻝی
wigmore	ﻭیگﻡﻭﺭ
wigston	ﻭیگﺱﺕﻭﻥ
wigton	ﻭیگﺕﻭﻥ
wijbrand	ﻭیژﺏﺭﺍﻥﺩ
wijdan	ﻭیﺝﺩﺍﻥ
wijnand	ﻭیژﻥﺍﻥﺩ
wiklund	ﻭیکﻝﻭﻥﺩ
wilber	ﻭیﻝﺏﺭ
wilcox	ﻭیﻝکﺍکﺱ
wildcat	ﻭیﻝﺩکﺍﺕ
wilder	ﻭﺍیﻝﺩﺭ
wilderman	ﻭیﻝﺩﺭﻡﻥ
wildfong	ﻭیﺩﻑﺍﻥگ
wilding	ﻭیﻝﺩیﻥگ
wiles	ﻭیﻝﺱ
wiley	ﻭیﻝی
wilford	ﻭیﻝﻑﺭﺩ
wilfred	ﻭیﻝﻑﺭﺩ
wilhelm	ﻭیﻝﻩﻝﻡ
wilhelmus	ﻭیﻝﻝﻡﻭﺱ
wilhite	ﻭیﻝﻩﺍیﺕ
wilken	ﻭیﻝکﻥ
wilkens	ﻭیکﻥﺯ
wilkerson	ﻭیﻝکﺭﺱﻭﻥ
wilkin	ﻭیﻝکیﻥ
wilkins	ﻭیﻝکیﻥﺯ
wilkinson	ﻭیﻝکیﻥﺱﻥ
will	ﻭیﻝ
willard	ﻭیﻝﺍﺭﺩ
willats	ﻭیﻝﺍﺕﺯ
willemintje	ﻭیﻝﻡیﻥیﺕﻩ
willey	ﻭیﻝی
william	ﻭیﻝیﺍﻡ
williamina	ﻭیﻝیﺍﻡیﻥﺍ
willing	ﻭیﻝیﻥگﺯ
willingham	ﻭیﻝیﻥگﻩﺍﻡ
willmore	ﻭیﻝﻡﻭﺭ
willmot	ﻭیﻝﻡﺕ
willner	ﻭیﻝﻥﺭ
willour	ﻭﻝﺭ
wills	ﻭیﻝﺯ
willson	ﻭیﻝﺱﻭﻥ
willy	ﻭیﻝی
wilmer	ﻭیﻝﻡﺭ
wilmot	ﻭیﻝﻡﻭﺕ
wimberley	ﻭیﻡﺏﺭﻝی
wimpje	ﻭیﻡپ
winchester	ﻭیﻥچﺱﺕﺭ
wincn	ﻭیﻥﺱﻥ
wind	ﻭیﻥﺩ
winders	ﻭیﻥﺩﺭﺯ
windom	ﻭیﻥﺩﻭﻡ
winiecki	ﻭیﻥیکی
wininger	ﻭیﻥیﻥگﺭ
winkelmann	ﻭیﻥکﻝﻡﺍﻥ
winkels	ﻭیﻥکﻝﺯ
winkle	ﻭیﻥکﻝ
winningstad	ﻭیﻥیﻥگﺱﺕﺩ
winokur	ﻭیﻥﻭکﺭ
winsor	ﻭیﻥﺱﺭ
winston	ﻭیﻥﺱﺕﻭﻥ
winstrom	ﻭیﻥﺱﺕﺭﻭﻡ
winter	ﻭیﻥﺕﺭ
winterer	ﻭیﻥﺕﺭﺭ
winterfeld	ﻭیﻥﺕﺭﻑیﻝﺩ
wintermute	ﻭیﻥﺕﺭﻡیﻭﺕ
winters	ﻭیﻥﺕﺭﺯ
winton	ﻭیﻥﺕﻭﻥ
winz	ﻭیﻥﺯ
wirt	ﻭیﺭﺕ
wiryana	ﻭیﺭیﺍﻥﺍ
wisal	ﻭیﺱﺍﻝ
wise	ﻭﺍیﺯ
wiseman	ﻭﺍیﺱﻡﻥ
wiser	ﻭیﺱﺭ
wiserner	ﻭیﺯﺭﻥﺭ
witchard	ﻭیچﺍﺭﺩ
witten	ﻭیﺕﻥ
wittick	ﻭیﺕیک
wolfson	ﻭﻝﻑﺱﻭﻥ
wolke	ﻭﻝک
wolman	ﻭﻭﻝﻡﻥ
wolski	ﻭﻝﺱکی
woltering	ﻭﻝﺕﺭیﻥگ
wombwell	ﻭﺍﻡﺏﻭﻝ
won	ﻭﻥ
wood	ﻭﻭﺩ
woodard	ﻭﻭﺩﺍﺭﺩ
woodburn	ﻭﻭﺩﺏﺭﻥ
wooded	ﻭﻭﺩﺩ
wooden	ﻭﻭﺩﻥ
woodgate	ﻭﻭﺩگیﺕ
woodhouse	ﻭﻭﺩﻩﺍﻭﺱ
woodrow	ﻭﻭﺩﺭﻭ
woodward	ﻭﻭﺩﻭﺍﺭﺩ
woog	ﻭﻭگ
wook	ﻭﻭک
woolard	ﻭﻭﻝﺍﺭﺩ
woollard	ﻭﻭﻝﺍﺭﺩ
woolley	ﻭﻭﻝی
woon	ﻭﻭﻥ
worchick	ﻭﺭچیک
worden	ﻭﻭﺭﺩﻥ
workman	ﻭﺭکﻡﻥ
worling	ﻭﺭﻝیﻥگ
worrilow	ﻭﺭیﻝﺍﻭ
wouter	ﻭﺕﺭ
wren	ﺭﻥ
wright	ﺭﺍیﺕ
wrobel	ﻭﺭﻭﺏﻝ
wun	ﻭﻭﻥ
wust	ﻭﺍﺱﺕ
wyman	ﻭیﻡﺍﻥ
wyntje	ﻭیﻥﺕ
xaros	ﺯﺍﺭﻭﺱ
yacob	یﺍکﻭﺏ
yager	یﺍگﺭ
yagla	یﺍگﻝﺍ
yahsi	یﺍﺱی
yake	ییک
yakootah	یکﻭﺕﺍﻩ
yamaha	یﺍﻡﺍﻩﺍ
yamha	یﺍﻡﺍﻩﺍ
yaminah	یﺍﻡیﻥﺍ
yan	یﺍﻥ
yang	یﺍﻥگ
yangi	یﺍﻥگی
yaniv	یﺍﻥیﻭ
yanowitz	یﺍﻥﻭﻭیﺕﺯ
yanson	یﺍﻥﺱﻭﻥ
yanzek	یﺍﻥﺯک
yap	یﺍپ
yarman	یﺍﺭﻡﺍﻥ
yaron	یﺍﺭﻭﻥ
yaros	یﺍﺭﻭﺱ
yaryan	یﺍﺭیﺍﻥ
yasar	یﺍﺱﺭ
yasin	یﺍﺱیﻥ
yasirah	یﺍﺱیﺭﺍﻩ
yates	ییﺕﺯ
yaw	یﺍﻭ
yazid	یﺯیﺩ
yearwood	ﺍیﺭﻭﻭﺩ
yeats	ییﺕﺯ
yeka	ییکﺍ
yelich	یﻝیچ
yelland	یﻝﻥﺩ
yerbury	یﺭﺏﺭی
yerger	یﺍﺭگﺭ
yermish	یﺭﻡیﺵ
yermo	یﻭﺭﻡﻭ
yetter	یﺕﺭ
yok	یﻭک
yonas	یﻭﻥﺍﺱ
yongsup	یﻭﻥگﺱﺍپ
york	یﻭﺭک
yosef	یﻭﺯﻑ
yoseph	یﻭﺱﻑ
yoshio	یﻭﺵیﻭ
yossi	یﻭﺱی
yossy	یﻭﺱی
youlin	یﻭﻝیﻥ
youmans	یﻭﻡﺍﻥﺱ
younger	یﺍﻥگﺭ
youse	یﻭﺱ
yousten	یﻭﺱﺕﻥ
yumn	یﺍﻡﻥ
yzaak	ﺯﺍک
zabel	ﺯﺍﺏﻝ
zachary	ﺯﺍچﺍﺭی
zafina	ﺯﺍﻑیﻥﺍ
zagar	ﺯﺍگﺍﺭ
zahid	ﺯﺍﻩیﺩ
zahirah	ﺯﻩﺭﺍ
zainab	ﺯیﻥﺏ
zaira	ﺯیﺭﺍ
zaki	ذکی
zakiyyah	ذکیﺍﻩ
zalan	ﺯﺍﻝﺍﻥ
zammit	ﺯﺍﻡیﺕ
zamore	ﺯﺍﻡﻭﺭ
zang	ﺯﻥگ
zangerl	ﺯﺍﻥگﺭﻝ
zanneke	ﺯﺍﻥک
zapara	ﺯﺍپﺍﺭﺍ
zara	ﺯﺭﺍ
zaria	ﺯﺭی
zarifa	ﺯﺭیﻑﺍ
zaynah	ﺭیﻥﺍﻩ
zaza	ﺯﺯ
zec	ﺯک
zeke	ذک
zella	ﺯﻝﺍ
zeller	ﺯﻝﺭ
zeman	ﺯﻡﺍﻥ
zemanek	ﺯﻡﺍﻥک
zen	ﺯﻥ
zentner	ﺯﻥﺕﻥﺭ
zepka	ﺯپکﺍ
zeyer	ﺯیﺭ
zimraan	ﺯیﻡﺭﺍﻥ
zinser	ﺯیﻥﺱﺭ
zirilli	ﺯیﺭیﻝی
zito	ﺯیﺕﻭ
zjarritjen	ﺯﺍﺭیﺕﻥ
zocca	ﺯﻭکﺍ
zoeterwoude	ﺯیﻭﺕﺭﻭﺩ
zold	ﺯﻭﻝﺩ
zolmer	ﺯﻭﻝﻡﺭ
zontek	ﺯﻭﻥﺕک
zuleika	ذﻭﻝکیﺍ
zurink	ﺯﺭیﻥک
zuvieta	ﺯﻭیﺕﺍ
zygmunt	ﺯیگﻡﻭﻥﺕ
zyl	ﺯیﻝ
