خﺍی	khai
ریﺝﺱﻭیک	rijswijk
ریﺩی	reedy
ریﺵﺕر	richter
ریﻝی	riley
ریﻥگﻥﺍﻝﺩﺍ	ringenalda
ریﻥیﻥگر	reininger
ریﻥﺝﻥﺍﻝﺩﺍ	ringenalda
ریﻥﻑﻭرﺩ	rainford
رﻝﻑ	rolfe
رﻡﺯی	ramsay
رﻭزﻭﻝﺕ	roosevelt
رﻭییز	ruiz
رﻭﺱﻥﺍﻝ	rosendale
زرکﺍ	zarqa
زرگﺍ	zarqa
زکﻩ	zeke
زیﺍﻡ	zaim
زیﻥﺍﻩ	zaynah
زﺍزﺍ	zaza
زﺍکی	zaki
زﺍﻭر	zawr
زﺝﺍریﺕﺝﻥ	zjarritjen
زﻑیر	zafir
زﻩیﺩ	zahid
طﻩیرﻩ	tahirah
پرﺍﺕیک	pratik
پرﺍﻥگ	prang
پیرﺱ	pearse
پیرﺱﻭﻥ	pearson
پیﺍﺕک	piatek
پیﺕﻩ	pietje
پیﺭﺍﻥی	pirani
پیﺭﺱﻭﻥ	pearson
پیﺭﻭ	piero
پیﺯیﺍﻝی	piziali
پیﺯﺱ	paizis
پیﺱﺍﻩ	peasah
پیﻝ	peil
پیﻝیﻥﺕی	paylyntie
پیﻝﻩﺍﻑﺭ	pilhofer
پیﻡﺏری	pemberry
پیﻥچﺭﺍ	pinchera
پیﻥکی	pinky
پیﻥکﺭﺕﻥ	pinkerton
پیﻥگﻝﺕﻥ	pingleton
پیﻥﺍ	pena
پیﻥﺕﺭ	painter
پﺍر	parr
پﺍرﺱﻝﻭ	parsloe
پﺍیرﺱ	pierce
پﺍیﻭﻝﻭ	paulo
پﺍﺕرﺱﻭﻥ	paterson
پﺍﺕﻭچی	patocchi
پﺍﺱکﻭ	pasco
پﺍﺱﺕﻭﺭ	pastore
پﺍﻝی	paley
پﺍﻝﺭﻡﻭ	palermo
پﺍﻝﻑﻭﺭﺩ	pulford
پﺍﻥﺩﻭﻝﻑیﻥﻭ	pandolfino
پﺍﻥﻭﺍﻝکﺭ	panvalkar
پﺕرﺱﻥ	petersen
پﺕی	petty
پﺕیﻝ	pathyil
پﺕﺭیﻥﻭ	petrino
پﺕﺭﺱﻥ	paterson
پﺕﻝﺍ	patella
پﺩﺭﺍﻡ	pedram
پﺭیچﺍﺭﺩ	pritchard
پﺭیﻡیﻭﺱ	primus
پﺭیﻥگ	pering
پﺭﺍچﺕ	pratchett
پﺭﺍﻩﻝ	prahl
پﺭﻥﺕ	parent
پﺭﻥﻝ	purnell
پﺭﻭکﺕﻭﺭ	proctor
پﻝکچیﺍ	pellecchia
پﻝیﺯﻥﺕﺯ	pleasants
پﻝﺍک	plack
پﻝﺍکﺍ	puolakka
پﻝﺍﻡﻥ	plamen
پﻥیﻥﺯﻭﻝﺍ	peninsula
پﻭیﺱﻝ	poisl
پﻭﺕ	poot
پﻭﺭﺕﻥﻭی	portnoy
پﻭﺭﻭﺱ	proos
پﻭﺱی	pusey
پﻭﻝﺱ	poulos
پﻭﻝﻡیﺕیﺱ	polemitis
پﻭﻝﻭ	polo
پﻭﻝﻭﺱ	paulus
چیﺍ	cheal
چیﺵﺕی	chishtie
چیﻝﺕ	cheiltje
چﺍیﻭﻭﺕ	chauvet
چﺍﺵ	chas
چﺍﻥگ	chong
چﺍﻭﻥ	chaun
چﺱﻥی	chesney
ژﻑﺭی	jeffrey
کریﺱﺕیﻥﺍ	christyntie
کرﺍکﺱﻑرﺩ	croxford
کرﺍﺯی	krazy
کزﻡﻥز	coesmans
کپیﺱﺕﺭﺍﻥ	capistran
کییﻭﺏﺍﺱ	kubose
کیﺍﻥی	kayani
کیﺕیﻥگ	keating
کیﺭﺕﺍ	keerthi
کیﺱیﻥﺝﺭ	kissinger
کیﻝ	kale
کیﻝی	kiely
کیﻝﺭ	keeler
کیﻝﺯ	kills
کیﻡﻭ	kimo
کیﻥ	keene
کیﻥگﺱﻝی	kingsley
کیﻥیﻥی	keanini
کیﻭچی	kiuchi
کﺍرک	karak
کﺍرﺕﻡﻝ	cartmell
کﺍرﺩﻥ	kardon
کﺍپﺭﺍﻝ	kapral
کﺍپﻝﺍﻥ	kaplan
کﺍپﻝﻥ	kaplan
کﺍچﻭﻥ	cauchon
کﺍکیﻭﺭ	kakure
کﺍیﺭﺍﺱ	kyrus
کﺍیﺭﻭﻑ	kairoff
کﺍﺏﻝ	cabell
کﺍﺕریﺝﻥ	catrijn
کﺍﺕریﻥﺕﺝ	katryntje
کﺍﺕریﻥﺕﺝﻩ	katryntje
کﺍﺭﺍﺱ	karras
کﺍﺭﺍﻥ	karan
کﺍﺭﺕیک	kartik
کﺍﺭﺕﺭ	carter
کﺍﺭﻝﺱ	carlos
کﺍﺭﻡﻭﻥﺍ	carmona
کﺍﺭﻥی	carney
کﺍﺭﻩﺍﺭﺕ	carhart
کﺍﺱﺕریکﻭﻡ	castricum
کﺍﺱﺕرﻝ	gastrell
کﺍﺱﻡیچی	kosmicki
کﺍﺱﻡﺍﻝکﺍﺭ	kasmalkar
کﺍﺵیﻥگ	cushing
کﺍﻑﺭی	caffrey
کﺍﻝیﻥﺯ	collins
کﺍﻝﺍﻩﺍﻥ	callahan
کﺍﻝﻡیﺱ	kalemis
کﺍﻡپﺕﻭﻥ	compton
کﺍﻡیﻭ	comeau
کﺍﻡﻝ	kamil
کﺍﻡﻥﻭ	kamenev
کﺍﻥﺕﺭﺍکﺕﻭﺭ	contractor
کﺍﻥﺕﺭﻝ	cantrell
کﺍﻥﺩﻭ	kundu
کﺍﻥﺭﻝی	conerly
کﺍﻥﻑیﻝﺩ	canfield
کﺍﻭﺍیی	kawai
کﺍﻭﺭﺕ	covert
کﺕﺏ	kateb
کﺭیک	craick
کﺭیﺱﺕ	crest
کﺭیﺱﺕیﺍﻥﺱﻥ	christiansen
کﺭیﻥگﻝ	cringle
کﺭﺍچﻝی	crouchley
کﺭﺍﻥﺯ	kronz
کﺭﺏیﺕ	corbit
کﺭﺏﻝی	corbelli
کﺭﺱﺕﻥ	kresten
کﺭﺵ	kresh
کﺭﻥﺍی	kernie
کﺭﻥﻑﺭﺩ	cranford
کﺭﻭیﺱ	charrois
کﺭﻭﺱ	crouse
کﺭﻭﺱﺏی	crosby
کﺭﻭﻡیﺕﺱ	keromitis
کﺭﻭﻥی	cerveny
کﺭﻭﻥﺯ	chrons
کﺱﺕﻝﻭﺕ	castellot
کﺱﻭﻥ	kesson
کﻝکﺍﺭ	kelkar
کﻝیﻥﺯ	collins
کﻝﺍژﻭﺭﺍ	klazura
کﻝﺍﺭک	clark
کﻝﺍﻥﺕﻭﻥ	clanton
کﻝﺕﺯ	keltz
کﻝﻭﺭ	clever
کﻡﻑیﻝﺩ	camsfield
کﻥﺩﺍﻝ	kendal
کﻥﺯ	kenz
کﻥﺱیﻥگﺕﻭ	kensingto
کﻥﻭﻑیﻥکﻩ	knufinke
کﻩﻭ	kehoe
کﻭرک	cork
کﻭپﻥﺯ	coppeans
کﻭکﺕﺍﻭﺍی	koktavy
کﻭگﻝ	kugel
کﻭی	cowie
کﻭیﻥﺕﺍﻥﺍ	quintana
کﻭﺏﺱﺍ	kobsa
کﻭﺏﻝ	kobel
کﻭﺏﻝﺍ	kubla
کﻭﺏﻥ	kobben
کﻭﺕرﻭﺯﻭ	kotrozo
کﻭﺩﺍﻡﺍ	qudamah
کﻭﺭﻥ	korn
کﻭﺭﻥﻝیﻭﺱﻥ	corneliusen
کﻭﺱﺕ	coast
کﻭﺱﺕیﺱ	kostis
کﻭﺱﺕیﻝﻭ	costello
کﻭﺱﻡﺍﺱ	cosmas
کﻭﻝﻥ	kullen
کﻭﻡﺭ	comer
کﻭﻡﻭﺭیﺕﺍ	komorita
کﻭﻥگ	keong
کﻭﻥﺍیﺕیرﺍﻩ	qunaytirah
کﻭﻥﻭپکﺍ	konopka
گریﺕﺏﻥکز	greatbanks
گرﺕﺯ	gertz
گرﻭﻝﺍیﺕ	geervliet
گیﺕیﺕیﺱ	gitaitis
گیﺕﺍرﺍ	qitarah
گیﺱﺏرﺕﻭﺱ	gijsbertus
گیﻝﻥﺭ	gilner
گیﻡﺯ	gamez
گیﻡﻥﺯ	gimenez
گیﻡﻥﻭ	gimeno
گﺍیﻭ	gaw
گﺍﺏریﻥ	gabrin
گﺍﺏﺭیﻝ	gabriella
گﺍﺕکﻭﻡﺏ	gatcombe
گﺍﺕﺯ	gatz
گﺍﺩگﻝ	gudgel
گﺍﺭﻥ	garon
گﺍﺭﻭﺩ	garrod
گﺍﺱکﻭیﻥ	gascoyne
گﺍﺱیک	gasic
گﺍﻝکﻭ	galko
گﺍﻝﺏرﺍیث	galbraith
گﺍﻝﺏﺍﻭﺍی	galbavy
گﺍﻡﻝ	gamal
گﺍﻥﺕﺭ	ganter
گﺍﻥﺩﺭﺯیک	gonderzik
گﺍﻥﺯﺍﻝﺯ	gonzalez
گﺍﻭرﻥﻭرﻥ	gouvernoren
گﺍﻭﺕیﺭ	gauthier
گﺭییﻥ	green
گﺭیﻥﺝﺭ	grainger
گﺭﺍﺏﻥﺍﺭ	grabnar
گﺭﺍﻑ	graf
گﺭﺱ	gerth
گﺭﺱﺕیﻥﻥ	grasteinen
گﺭﻥﺱیﻥگ	grensing
گﺭﻭیﻥﻝﻥﺩ	groenland
گﺱﺕ	guest
گﻝیﻥ	glynn
گﻝﺱ	glass
گﻝﻭﺏ	golub
گﻡیﻝ	gamil
گﻡﺏﻝ	gamble
گﻥکﺱ	genks
گﻥﺍگی	gnagy
گﻥﺯﺍﻝﺯ	gonzales
گﻭرﺩ	gord
گﻭپﺍﻝﺍﻥ	gopalan
گﻭپﺕﺍ	gupta
گﻭپﻭﻝ	gupwell
گﻭیﻥ	gwin
گﻭﺍﻥﺕﺭ	guenter
گﻭﺩک	goedecke
گﻭﺭگﻭﺕیﺱ	gourgoutis
گﻭﺭﺍﻝ	gural
گﻭﺭﻡ	gorm
گﻭﺵ	goch
گﻭﻥیﺍ	goniea
گﻭﻩﺩ	gohde
ییکﺍ	yeka
یﺍﺕﻡﻥ	yeatman
یﺍﻑیﻩ	yafiah
یﻑیﻩ	yafiah
یﻭرزﻝﺕ	urseltje
یﻭییکﻩ	uilkje
یﻭیﻥز	youens
یﻭﺕریچ	utrecht
یﻭﻡﺍﻥﺱ	youmans
یﻭﻥﺱﻭﻥ	jonsson
ﺍرکﻝ	arkell
ﺍریﺍﻥﺕ	ariaantje
ﺍریﺝ	alridge
ﺍرﺕرﺱ	arthers
ﺍرﻡیﺕ	armitt
ﺍرﻡﺱﺕرﺍﻥگ	armstrong
ﺍزﺍﻝیﺍ	azalea
ﺍچﺩﻝ	archdale
ﺍکرﺱﻝیﺕﻭ	ekerslato
ﺍکﺍپﺍﺩی	accapadi
ﺍکﺍﺭ	akar
ﺍکﺱﺕیﻥ	eckstein
ﺍکﻭﻥﺍ	acuna
ﺍگیﺱﺍ	agesa
ﺍگﺍﺕی	agate
ﺍگﻝ	eagle
ﺍیرﺏیﺩ	irbid
ﺍیرﻥﻭﺕ	aernoudt
ﺍیرﻭﻥﺍﺕ	aeronaut
ﺍیگﻝی	egli
ﺍیﺕﻩ	aetje
ﺍیﺩﻥﺏﻭرگ	edenborough
ﺍیﺭﺍﺭﺩی	ierardi
ﺍیﺭﺩ	aird
ﺍیﺯﻭ	izzo
ﺍیﺱﺍ	aissa
ﺍیﺱﺍﺱک	isacq
ﺍیﺱﺕﻡﺍﺱ	isthmus
ﺍیﺱﻝﺕ	iselt
ﺍیﻑﺝﻩ	ifje
ﺍیﻝﺍﻥ	ilan
ﺍیﻝﺍﻥﺍ	ilana
ﺍیﻝﺕﺝی	eeltje
ﺍیﻝﺯ	eales
ﺍیﻡرﺱﻭﻥ	emerson
ﺍیﻡپﺭﺍﻥﺕیﺭی	empranthiri
ﺍیﻥچ	inch
ﺍیﻥکﻩ	einke
ﺍیﻥگریﺱﻭﻝ	ingresole
ﺍیﻥگﻝیﺵ	english
ﺍیﻥﺍچ	ienatch
ﺍیﻥﺩیگﻭ	indigo
ﺍیﻥﺱیﻥ	insane
ﺍیﻥﻩﻭ	inho
ﺍیﻭیﻥ	eoin
ﺍیﻭﺍﺭ	ivar
ﺍﺏیﺍ	abia
ﺍﺏیﺍﻥ	abyan
ﺍﺏﺱﻝﻭﻡ	absalom
ﺍﺏﻭﺕ	abbot
ﺍﺕ	utt
ﺍﺕیگ	attig
ﺍﺕیﺯ	etesse
ﺍﺕﺭ	otter
ﺍﺕﺭی	atri
ﺍﺕﺭیﺩﺯ	atreides
ﺍﺕﻭ	athow
ﺍﺕﻭﺱی	atusi
ﺍﺕﻭﻥ	atoon
ﺍﺩکک	adcock
ﺍﺩیکﺱ	addicks
ﺍﺩیﺱﺍک	adisak
ﺍﺩﺍﺕ	udut
ﺍﺩﺭیﺍ	adria
ﺍﺩﻝﻡﻥ	edelman
ﺍﺩﻡیﺭﺍﻝﻥ	admiralen
ﺍﺩﻡﺏر	adamberr
ﺍﺩﻡﻭﻥز	edmonds
ﺍﺩﻭﺍﺭﺩ	edvard
ﺍﺭ	ear
ﺍﺭﺍﻥﺩ	aurand
ﺍﺭﺏی	ereby
ﺍﺭﻑیﻭﺱ	orfeus
ﺍﺭﻑﺍﻥﺍکیﺱ	orfanakis
ﺍﺭﻥﻭﻝﺩ	arnold
ﺍﺱپیﺱﺍک	spisak
ﺍﺱپیﻝیﺕ	spilite
ﺍﺱپﺍیکﺱ	spikes
ﺍﺱپﺭﺍگ	sprag
ﺍﺱکیﻥ	skean
ﺍﺱکﺍیﺍ	skaya
ﺍﺱکﺍیﻝر	schuyler
ﺍﺱکﺍﺕی	scotty
ﺍﺱکﺍﺝﻥ	schagen
ﺍﺱکﺭﺍیﺯ	skerries
ﺍﺱکﻭﺭﺭ	scorer
ﺍﺱکﻭﻝیﻥگﻝک	sculingleke
ﺍﺱیﻑ	asif
ﺍﺱﺕیکﻝﻡﻥ	stickelman
ﺍﺱﺕیﺝﻩ	steentje
ﺍﺱﺕیﺱی	stacey
ﺍﺱﺕیﻭﻝی	stavely
ﺍﺱﺕﺍکی	stuckey
ﺍﺱﺕﺍﺕﻡ	statham
ﺍﺱﺕﺍﺝﺍﻥﻭ	stajano
ﺍﺱﺕﺍﻡپﺭ	stamper
ﺍﺱﺕﺍﻥگیﺭ	stangier
ﺍﺱﺕﺭیﺩ	astrid
ﺍﺱﺕﻑﻥﺱﻭﻥ	stephenson
ﺍﺱﺕﻝی	astley
ﺍﺱﺕﻥﻑﻭﺭﺕ	stenfort
ﺍﺱﺕﻭﺍﺭﺕ	stewart
ﺍﺱﺕﻭﺭﻝیﺭ	storleer
ﺍﺱﺕﻭﺭﻡﺯ	storms
ﺍﺱﺕﻭﻭﺍﻝ	stovall
ﺍﺱﻝﻭکﺍ	sluka
ﺍﺱﻡیﺕﺯ	smiths
ﺍﺱﻡﺍﺩﺝ	smadja
ﺍﺱﻡﻭکی	smoky
ﺍﺱﻥﻭ	snow
ﺍﺱﻥﻭﻑیﻝﺩ	snowfield
ﺍﺱﻭﺍﻥﺍی	swany
ﺍﺵﺕیگﻡﻥ	shtiegman
ﺍﻉﻝیﺍﻩ	aaliyah
ﺍﻑی	aefje
ﺍﻝرﺍیﺕ	allwright
ﺍﻝزﻭرث	allsworth
ﺍﻝکیﻥ	elkin
ﺍﻝگﺭﻭ	allegro
ﺍﻝیکﺱ	alyx
ﺍﻝیﺍ	aaliyah
ﺍﻝیﺏی	alibey
ﺍﻝیﺯﺍﺏﺕ	elizabeth
ﺍﻝیﺱیﺍ	alicia
ﺍﻝیﻥگﺕﻭﻥ	alington
ﺍﻝیﻭﺍ	oliva
ﺍﻝﺍﻥﺍ	alana
ﺍﻝﺏریﺝ	albright
ﺍﻝﺕﻩ	aaltje
ﺍﻝﺝ	aaltje
ﺍﻝﺩیﻥ	aldine
ﺍﻝﺩﻩﻑرﺍ	aldhafra
ﺍﻝﺱﻥﺭ	elsner
ﺍﻝﻝﺍﺩﺡکیﺍﻩ	alladhiqiyah
ﺍﻝﻥﺩﺭ	allender
ﺍﻝﻭک	alok
ﺍﻝﻭی	eloy
ﺍﻝﻭیﺕﺯ	allowitz
ﺍﻡپﺱﻭﻥ	empson
ﺍﻡیﻩﺍی	amihai
ﺍﻡﺍﺭﺩیﻭ	amardeo
ﺍﻡﺍﻥﻭﺍﻝ	emmanuel
ﺍﻡﺏرﻭﺱیﻭﺱ	ambrosius
ﺍﻡﺩیﻭ	amedeo
ﺍﻡﻝﻥ	emlen
ﺍﻥکﻭیﺕﺯ	ancowitz
ﺍﻥگﻝیﻥﺍ	engelina
ﺍﻥگﻝﻩﻝﻡ	engelholm
ﺍﻥﺍﻥﺕ	anant
ﺍﻥﺕﺍﻥﺍیﺕیﺱ	antanaitis
ﺍﻥﺕﺱ	annetts
ﺍﻥﺕﺱﺕﻝ	anthistle
ﺍﻥﺕﻭﻥیﻭ	antonio
ﺍﻥﺕﻭﻥﻭﻭیچ	antonowich
ﺍﻥﺝﻝﺕﺝﺍ	engeltje
ﺍﻥﺩﺭ	ander
ﺍﻥﺩﺭﻭﺯ	andrews
ﺍﻥﺩﻭﻥیﺱ	anthonis
ﺍﻥﺱر	anwer
ﺍﻥﺱیکﺭ	unsicker
ﺍﻥﺱﻝیﻥ	ansselin
ﺍﻥﻩﻝﺩ	anhold
ﺍﻥﻭچیﻥ	anuchin
ﺍﻭریک	averice
ﺍﻭرﺱﻝﺕ	urseltje
ﺍﻭرﺱﻝﺕﺝﻩ	urseltje
ﺍﻭک	ouk
ﺍﻭکی	aoki
ﺍﻭکیﻥﺯ	oakins
ﺍﻭگﺏﻭﺍﻑی	ogbuefi
ﺍﻭیکﻩ	oeycke
ﺍﻭیﺍﻥ	avian
ﺍﻭیﺕگیﺱﺕ	uitgeest
ﺍﻭﺍچﺍ	ewacha
ﺍﻭﺍﺩی	ouadi
ﺍﻭﺏﺍﺩﺍﻩ	ubadah
ﺍﻭﺕیﺱ	otis
ﺍﻭﺭیﺩﻩ	ourida
ﺍﻭﺭیﻥ	orin
ﺍﻭﺱیﺯ	oseas
ﺍﻭﺱﺏﻭﺭﻥ	osborne
ﺍﻭﺱﺕﻭﻝیﻥ	austvollen
ﺍﻭﺱﻝیﻥﺍ	aucellina
ﺍﻭﻑﻥﺭ	uffner
ﺍﻭﻝکﻥ	olken
ﺍﻭﻝﺱﻭﻥ	olson
ﺍﻭﻡﺍﺱﻭﺕﺍﻥ	umasuthan
ﺍﻭﻡﻝﺍﺱ	umlas
ﺏرکﻭﻝ	boerkoel
ﺏرﺍزیر	brazier
ﺏرﺩﻝی	bradlee
ﺏچﻝر	bachelor
ﺏکرﺯ	beckers
ﺏکﺕ	beckett
ﺏکﺭ	backer
ﺏکﻭیﺕ	beckwith
ﺏگﻝی	bagley
ﺏگﻭیﻝ	bagwill
ﺏیرﺕﺍی	beartie
ﺏیکﻥﺱﺕ	bakeneset
ﺏیﺍﻭیﺱ	beavis
ﺏیﺏﻝ	bible
ﺏیﺕﺱ	bates
ﺏیﺩی	bidee
ﺏیﻝﺯیﺏﺍﺏ	beelzibub
ﺏیﻥﺯ	baines
ﺏیﻩﺍﻥ	beyhan
ﺏیﻭ	beau
ﺏیﻭﺍﻥ	bevan
ﺏیﻭﻡﻥﺕ	beaumont
ﺏﺍرﺍﺕ	barratt
ﺏﺍرﺱ	barrese
ﺏﺍرﻥﺯ	barnes
ﺏﺍچﺍﺭﺍچ	bacharach
ﺏﺍچﺍﻥﺩ	bachand
ﺏﺍکیر	baqir
ﺏﺍیر	bair
ﺏﺍﺏ	bob
ﺏﺍﺏیﺕﺯ	babitz
ﺏﺍﺏﻝ	babel
ﺏﺍﺕﻥﺍﺕ	buttnut
ﺏﺍﺭﺏ	barb
ﺏﺍﺭﺕک	bartok
ﺏﺍﺭﺕﺯ	bartz
ﺏﺍﺭﺕﻭک	bartok
ﺏﺍﺱکیﻥ	baskin
ﺏﺍﻑی	baefje
ﺏﺍﻝکﻭﺱکی	bulkowski
ﺏﺍﻝﺩﺭﺩ	baldred
ﺏﺍﻝﻭگ	balog
ﺏﺍﻭﻡگﺍﺭﺕﻥﺭ	baumgartner
ﺏﺍﻭﻡﻥ	baumann
ﺏﺕریﺱ	beatrice
ﺏﺕﻡﻥ	bateman
ﺏﺭخﺍﺭﺩ	burkhard
ﺏﺭکﺍﺕ	barakat
ﺏﺭگﻝﺍﻥﺩ	berglund
ﺏﺭیﺍﻥ	brian
ﺏﺭیﺩﺝﺱ	bridges
ﺏﺭیﺱﺏیﻥ	brisbane
ﺏﺭیﻥﺩﺍﻥ	breanndan
ﺏﺭیﻭیﻥ	brewin
ﺏﺭیﻭﻥ	bryon
ﺏﺭﺍﻡﺭ	brummer
ﺏﺭﺝ	burj
ﺏﺭﻝ	burl
ﺏﺭﻝﻥﺩ	borland
ﺏﺭﻥﺩﺍﻥ	brendan
ﺏﺭﻥﺩﺱ	berends
ﺏﺭﻥﻩﺍﺭﺩ	bernhard
ﺏﺭﻭﺯ	broz
ﺏﺭﻭﻡﻝی	bromley
ﺏﺱﻭﻝ	boswell
ﺏﻝﺍﻡی	bellamy
ﺏﻝﺱ	blas
ﺏﻝﻥﺩﻥ	ballenden
ﺏﻝﻭ	blue
ﺏﻝﻭﺱکﻭﻡ	bloxom
ﺏﻝﻭﻡﻥ	blumen
ﺏﻩیﺝﺍ	bahija
ﺏﻭرﺯ	borrs
ﺏﻭکﺍﺕ	bowcott
ﺏﻭکﻝ	bokel
ﺏﻭکﻭﻥ	bockoven
ﺏﻭیک	bewick
ﺏﻭﺍیﻭیﻥ	boivin
ﺏﻭﺭگ	borg
ﺏﻭﺭی	bury
ﺏﻭﺭﺝیﺍ	bourgea
ﺏﻭﺭﺱیﺭ	bourcier
ﺏﻭﺱکﺍ	bosscha
ﺏﻭﺱی	bocci
ﺏﻭﻥﺍﺭ	bonar
ﺏﻭﻥﺍﻭگﻝیﺍ	bonavoglia
ﺕرﺍپﻡﻥ	traupman
ﺕرﺍیﺱﺕﻥیﺱ	traiectensis
ﺕرﺍﻭﺏ	traub
ﺕرﺱک	trask
ﺕی	tay
ﺕیپی	tippi
ﺕیﺕکﻭﻡﺏ	titcomb
ﺕیﻝﺕﺝ	tiletje
ﺕیﻝﺩﻥ	tilden
ﺕیﻥﺍﻥﺕ	tennant
ﺕیﻭﺩﻭر	theodore
ﺕیﻭﻡیﻥﻥ	tuominen
ﺕیﻭﻥ	teun
ﺕیﻭﻭیﺱ	teeuwis
ﺕﺍکﺍ	taka
ﺕﺍیﺏﻭﺕ	tiebout
ﺕﺍیﺭﻭﻥ	tyrone
ﺕﺍﺭﻥ	thurn
ﺕﺍﻝﺏﺭگ	thalberg
ﺕﺍﻝﺏﻭیز	talboys
ﺕﺍﻡیﻥﺯ	tomines
ﺕﺍﻡﺍﺕیﻭﺱ	tomatius
ﺕﺍﻥگ	tang
ﺕﺭﺍﻭﺯی	trauzzi
ﺕﺭﺕﻭﺍﻥ	trethowan
ﺕﺭﻭ	trough
ﺕﺭﻭپ	throop
ﺕﺱیﻥک	tesink
ﺕﻥپﻭ	tenpo
ﺕﻭرﻥﺕﻭﻥ	thornton
ﺕﻭکیﻭ	tokyo
ﺕﻭﺍﻡﺍ	tuama
ﺕﻭﺭﺍﻡﺏﺭ	turambar
ﺕﻭﻥگ	thong
ﺙﻥﺍ	sana
ﺝرﺝ	george
ﺝپی	gepje
ﺝکﺏﺱﻥ	jacobsen
ﺝکﻡﻥ	jackman
ﺝیری	geary
ﺝیکﺱ	jakes
ﺝیﺱﻭﺯ	jesus
ﺝیﻥﺕﻭﻥ	ginton
ﺝیﻥﺱ	jeynes
ﺝیﻭیﻝ	jewell
ﺝﺍکﻭﺏ	jacob
ﺝﺍکﻭﺏﺯ	jacobs
ﺝﺍﺕﻭ	jatou
ﺝﺍﺱﺕﺝی	justje
ﺝﻑﺭی	jeffrey
ﺝﻝیﻡﺍﻥ	jelleyman
ﺝﻝﺕﻩ	jeltje
ﺝﻝﺝ	jeltje
ﺝﻥکیﻥﺱﻭﻥ	jenkinson
ﺝﻭیﺱ	joyce
ﺝﻭﺍﻥﺩﺭ	juvander
ﺝﻭﻝی	jolee
ﺝﻭﻝﺍی	joly
ﺝﻭﻥگﺍﻥ	joungane
ﺝﻭﻥگﺍﻥﺯ	junghans
ﺝﻭﻥﺍﺱ	jonas
ﺝﻭﻩﺍﻥی	juhani
ﺝﻭﻩﺍﻥﺯ	johanes
ﺡریﺙ	harith
ﺡﺩیﻝ	hadil
ﺩکﻝﻭ	declue
ﺩیپﻝﺩ	dippold
ﺩیکﻭ	dickow
ﺩیگﻩ	dighe
ﺩیﺭکﺱ	dirks
ﺩیﻝﺍیﺭ	delaere
ﺩیﻡﺍ	dema
ﺩیﻡﺍﺭیپ	dimaryp
ﺩیﻥگﻝﻭ	deangelo
ﺩیﻥﺕﻩ	dientje
ﺩیﻥﻝﺭ	dinler
ﺩیﻭ	deo
ﺩیﻭی	davie
ﺩیﻭیﺩﺱﻭﻥ	davidson
ﺩﺍیﺏﻝ	dibble
ﺩﺍﺕﻩ	daatje
ﺩﺍﺯﺱی	dazsi
ﺩﺍﻑ	duff
ﺩﺍﻥکﺍﻥ	duncan
ﺩﺍﻥیﺩیﻥ	dunedin
ﺩﺍﻥﺍ	dana
ﺩﺍﻥﺩﺍﺱ	dundas
ﺩﺍﻥﻩ	dunne
ﺩﺍﻩﻭر	duhur
ﺩﺍﻭکیﻥز	dawkins
ﺩﺭیﺱکﻭﻝ	driscoll
ﺩﺭﺍﺝ	drodge
ﺩﺱﺍﻝﻭﻭ	desalvo
ﺩﻝی	dalie
ﺩﻝﺱیﻡپﻭ	delciampo
ﺩﻡﺍر	demar
ﺩﻭرک	dork
ﺩﻭریز	devries
ﺩﻭرﺍﺕﻩ	dorathee
ﺩﻭپیﻭیﺱ	dupuis
ﺩﻭﺏیﻥﺱﻭﻥ	dobinson
ﺩﻭﺯﺍﺕ	duzat
ﺩﻭﻡیﻥیکﺍﺱ	dominicus
ﺩﻭﻥگ	dong
ﺩﻭﻩﻭﺭ	douhour
ﺩﻭﻭﻩ	douwe
ﺭپﻥیﻥگ	repenning
ﺭیگ	ridge
ﺭیﺏ	rieb
ﺭیﺭﺩﻥ	reardon
ﺭیﺱﻝی	risley
ﺭیﻥی	rainey
ﺭیﻭﺭ	river
ﺭﺍکﺱ	roux
ﺭﺍکﻭ	racho
ﺭﺍگﻥﺭﺩ	rognerud
ﺭﺍیﺯﻝ	raizel
ﺭﺍﺩﻩﺍ	radha
ﺭﺍﻝیﻥ	rollin
ﺭﺍﻥﺭ	runner
ﺭﺍﻭیﺭﺍﺝ	raviraj
ﺭﺍﻭﺏﺍﺕﻡ	rowbottom
ﺭﺍﻭﺕ	rout
ﺭﺍﻭﺱ	rouse
ﺭﺏﻭک	roebuck
ﺭﻭﺍﺯﻥﺭ	roesner
ﺭﻭﺏﺭﺕﻭ	roberto
ﺭﻭﺕﻡﻥ	rutman
ﺭﻭﺯﻥﻩیﻡ	rosenheim
ﺭﻭﺱکﻭﻝیﻥ	roscolyn
ﺭﻭﻝﻑﻩ	rolfe
ﺭﻭﻡﻝ	rommel
ﺯﺍﻥک	zanneke
ﺱزﺍر	caesar
ﺱیﺕیﻩ	seytie
ﺱیﺭ	sayer
ﺱیﻝﻭﺭﻡﻥ	silverman
ﺱیﻝﻭﺱﺕﺭ	silvester
ﺱﺍچک	sawchuk
ﺱﺍکﺭ	sakr
ﺱﺍکﻝﺍﺩ	saklad
ﺱﺍﺏﻭﺭیﻥ	sabourin
ﺱﺍﺩگرﻭ	sadgrove
ﺱﺍﺭﺕ	sarrett
ﺱﺍﺭﺕﺍکﺱﻭ	cartaxo
ﺱﺍﺱکﺍ	suska
ﺱﺍﻑیﻝﺩ	suffield
ﺱﺍﻝیﺕﻭریﻭ	solitario
ﺱﺍﻝﺭﻡﺍ	salerma
ﺱﺍﻝﻭﻡﻥ	solomon
ﺱﺍﻡرﺍ	sumehra
ﺱﺍﻡﺭﺍﻝ	summerall
ﺱﺍﻡﻭیﻝ	samuel
ﺱﺍﻥیﻝ	sunil
ﺱﺍﻥﺭ	sanner
ﺱﺍﻥﻭﻥﺩﻭ	sunondo
ﺱﺍﻭیﺯ	saviz
ﺱﺍﻭیﻥ	savin
ﺱﺍﻭﺍﺩ	sawad
ﺱﺍﻭﺍﺱﺕﺍ	savasta
ﺱﺍﻭﺕﺭ	sauter
ﺱﺩیرﺍ	sadira
ﺱﺵﺍﺩﺭی	seshadri
ﺱﻝک	selleck
ﺱﻝکﻭک	selcuk
ﺱﻝﻡﺍﻥ	salman
ﺱﻝﻭی	selway
ﺱﻥﺍ	sana
ﺱﻥﺩﺭﺯ	sanders
ﺱﻥﻭﺕﻭ	snotoa
ﺱﻭیﺝ	savage
ﺱﻭیﻥﺭﺕﻭﻥ	swinnerton
ﺱﻭﺏک	sobek
ﺱﻭﺭﻥﺱﻥ	sorensen
ﺱﻭﺯی	susie
ﺱﻭﻝک	solek
ﺱﻭﻥﺝی	songie
ﺱﻭﻩ	suh
ﺱﻭﻩﺍﺱ	suhas
ﺱﻭﻩﻡ	sohm
ﺵر	sherr
ﺵرﻝﻭک	sherlock
ﺵرﻡرﻩﻭرﻥ	schermerhorn
ﺵکﺱپیﺭ	shakespeare
ﺵیﻡﻝ	shimeall
ﺵﺍﺩﻩﺍ	shadha
ﺵﺍﺱﺕک	shostak
ﺵﺍﻑ	shuff
ﺵﺍﻥﻭﻥ	shannon
ﺵﺍﻭﻥ	shawn
ﺵﺩﺍﻩ	shadha
ﺵﻑﺍرﺩ	shephard
ﺵﻝﺕﻭﻥ	shelton
ﺵﻡیﺱ	shamis
ﺵﻭﻝﺯ	scholz
ﺵﻭﻥکﻭی	shunkui
ﻉﺏﺩﺍﻝﻝﻩ	abdullah
ﻉﺏﺩﺍﻝﻡﻝک	abdalmalik
ﻉﺏﺩﺍﻝﻩ	abdullah
ﻉﻝییﺍﻩ	aliyyah
ﻉﻡر	umar
ﻍﺩیرﻩ	qadira
ﻑریﺵﻥ	frisian
ﻑرﺕﺯ	fretz
ﻑرﻥکﻭیز	francoys
ﻑرﻭییﻥ	fruin
ﻑیﺍﺱکﻭﻥﺍﺭﻭ	fiasconaro
ﻑیﺕﺯﻭیﻝیﺍﻡ	fitzwilliam
ﻑیﺩﻭﺭ	fedor
ﻑیﻥک	fink
ﻑﺍیﺭﺏﺍﻥک	fairbank
ﻑﺍﺏﺭیﺱ	fabris
ﻑﺍﺏﻝﺭ	fubler
ﻑﺍﺩ	fahd
ﻑﺍﺩیﻝﺍ	fadila
ﻑﺍﺩﻥﺏﺭگ	fudenberg
ﻑﺍﺯیﻭ	fazio
ﻑﺍﻝﺯ	fales
ﻑﺭیﺍﻥﺩ	freund
ﻑﺭﺍﺱﺕی	frosti
ﻑﺭﺍﺱﺭ	fraser
ﻑﺭﺍﻥکﻭ	franco
ﻑﺭﺍﻥﺕﺯﻥ	frantzen
ﻑﺭﺩﺭکیﻥگ	frederking
ﻑﺭﻥکﺱﻭﻥ	frankson
ﻑﻝیﻥی	fellini
ﻑﻡﻡﺕﻩ	femmetje
ﻑﻥچﺍﺭچ	fenchurch
ﻑﻥﻭیک	fenwick
ﻑﻭر	four
ﻑﻭریﻭ	furio
ﻑﻭیﺱ	fuess
ﻑﻭﺭﻥیﺭ	fournier
ﻑﻭﺯﺍﺭﺩ	fozzard
ﻑﻭﻝﺩﺯ	foulds
ﻑﻭﻥﺩﻭ	fondo
ﻕﺩیﺱیﻩﺍ	qadisiyah
ﻕﻝیﺏﺍ	ghaliya
ﻝچﻡر	lechmere
ﻝیﺏﻝیﺕ	liblit
ﻝیﺕﺝﻩ	letje
ﻝیﺩیﺍ	lydea
ﻝیﺩﺯ	leeds
ﻝیﺩﻥ	leyden
ﻝیﺯ	liz
ﻝیﻝیﻥﺕﺍﻝ	lilienthal
ﻝیﻥﺍﻥ	lennon
ﻝیﻥﺩﺏﺭگ	lindberg
ﻝیﻥﺩﺭﻭﺕﺱ	lindroth
ﻝیﻥﻩ	lynne
ﻝیﻭﺏﻭﻥی	lyubovny
ﻝﺍرکیﻥگ	larking
ﻝﺍکﺵیﻥ	lockshin
ﻝﺍگﻭﺱی	lugosi
ﻝﺍیﻭﻝی	lively
ﻝﺍﺩﻭﻭیکﺍ	ludovica
ﻝﺍﺭﺝ	large
ﻝﺍﺭﻥ	larren
ﻝﺍﺱکﺍﺭی	lascari
ﻝﺍﺱﻭﻥ	larson
ﻝﺍﻡرﻥ	lammeren
ﻝﺍﻡﺏرچ	lambrecht
ﻝﺍﻥکﺍ	lanka
ﻝﺍﻥﺩیﻥ	landin
ﻝﺍﻥﺩﺍﺱﺕﺭﻭﻡ	lundstrom
ﻝﺍﻭی	lavey
ﻝﺍﻭیکﺕﻭیر	lavictoire
ﻝﺍﻭیﺕ	lovitt
ﻝﺍﻭﻥیﻭﺱ	lavonius
ﻝﺏﺩیﻭ	lebedev
ﻝﺕﺏری	lathbury
ﻝﻩﻥﺭﺭ	lehnerer
ﻝﻭکﺍﺱ	lucas
ﻝﻭگﺯ	loges
ﻝﻭﺍیﻥ	levine
ﻝﻭﻡﺯ	loomes
ﻝﻭﻡﻥ	lowman
ﻝﻭﻥﺩﻭﻥ	lewendon
ﻝﻭﻥﺯ	lones
ﻝﻭﻥﻡﻭ	lonnemo
ﻡکیﻝ	makil
ﻡکﻝﺍﻭﻝیﻥ	maclaughlin
ﻡیپﻝ	maple
ﻡیچﺍﻝیﺱ	michaelis
ﻡیکﻝﺍ	makela
ﻡیگﻝیﺍﺭﺩی	migliardi
ﻡیگﻥﺭﺍﻥ	migneron
ﻡیﺕﻭﻥﻥ	miettunen
ﻡیﺩﺍﻭﺯ	meadows
ﻡیﻝیکﻥ	millican
ﻡیﻥﺭﻭﺍ	minerva
ﻡﺍرگﺍریﺕﺝ	margarietje
ﻡﺍرگﺍﻝﺕﺍ	margretha
ﻡﺍریﺝﻩ	marytje
ﻡﺍرﺕیﻥﺕﺝ	martyntje
ﻡﺍرﺕﻝ	martel
ﻡﺍیﺍﻝ	mayall
ﻡﺍیﺭﻥ	myreen
ﻡﺍیﻭﻩﺍی	maohai
ﻡﺍﺏﺍﻥﺍگ	mabanag
ﻡﺍﺕﺍﺭ	matar
ﻡﺍﺕﺱﻭﻥ	mattson
ﻡﺍﺕﻭﻝﺍ	matula
ﻡﺍﺭﺕی	marti
ﻡﺍﺭﺕیﻥ	martyn
ﻡﺍﻝﺩ	malde
ﻡﺍﻥﺍﻡﺍ	manama
ﻡﺍﻥﻝی	manley
ﻡﺍﻭﻑ	maufe
ﻡﺝیﺩ	magid
ﻡﺭک	merk
ﻡﻑرک	mafraq
ﻡﻝﻩﺍﺭﺕ	melhart
ﻡﻩ	mah
ﻡﻭگﺍﻥﺕی	moganti
ﻡﻭﺭچ	morch
ﻡﻭﺭیﺱﻥ	morrison
ﻡﻭﺭﺍﻥﻭ	morano
ﻡﻭﺭﻥیﻥگ	morning
ﻡﻭﺯﺯ	moses
ﻡﻭﻑﺍﺩ	moffat
ﻡﻭﻝﺩﻥ	moulden
ﻡﻭﻥیﺯ	muniz
ﻡﻭﻥﺍک	monack
ﻡﻭﻥﺕﺍ	monta
ﻡﻭﻥﺕﺭﺍﻝ	montreal
ﻡﻭﻥﺕﺭﻭ	montero
ﻥپی	nappi
ﻥیچﻭﻝﺍﺱ	nicholas
ﻥیکﺱ	nikos
ﻥیکﻭ	niko
ﻥییﻭکﺍﻡﺏ	newcomb
ﻥیﺭ	near
ﻥیﻡﺍ	naimah
ﻥیﻡﺕﺯ	nimtz
ﻥیﻥﺩک	ninedek
ﻥیﻭﺍﻥ	neuen
ﻥیﻭﺕﻥ	newton
ﻥیﻭﻭیﻥگﺕﻭﻥ	newington
ﻥﺍپﻭﻝیﺕﺍﻥﻭ	napolitano
ﻥﺍکﺍﻡﻭﺭﺍ	nakamura
ﻥﺍیگﻝ	nigel
ﻥﺍﺕﺭ	nutter
ﻥﺍﺱ	nas
ﻥﺍﻑزﺍ	nafeeza
ﻥﺍﻡﺏیﻡیﺩﻭﻡ	nambimadom
ﻥﺍﻥﻝی	nunley
ﻥﺍﻭﺍرﺍ	navarra
ﻥﺝیﺍﻩ	najiyah
ﻥﻩﺕﺍ	nahta
ﻥﻭﺍیﻝ	nevile
ﻥﻭﺱﻝ	kneusel
ﻥﻭﻥیﺱ	nunis
ﻩریﺱ	harith
ﻩرﺏﺍیﺝ	harbidge
ﻩکﻝ	heckel
ﻩیرﻭﻥیﻡﻭﺱ	hieronimus
ﻩیک	haik
ﻩیکﻭﺭی	hickory
ﻩیﺕﻝی	heatlie
ﻩیﺭﻥ	hearn
ﻩیﺯﻡﺍﻥ	heezemans
ﻩیﻝی	healy
ﻩیﻝﺩﺏرﺍﻥﺩیﺱﻝﺍﻥﺕ	hildebrandislant
ﻩیﻡﻥ	hayman
ﻩیﻥچی	hinchey
ﻩﺍرﺩ	hurd
ﻩﺍرﻡﺍﻥﻭﺱ	harmanus
ﻩﺍپکیﻥﺯ	hopkins
ﻩﺍپﺯ	hopps
ﻩﺍپﺱﻭﻥ	hopson
ﻩﺍکﺱ	hawks
ﻩﺍیﻝﺕ	hilletje
ﻩﺍﺏﺭ	haber
ﻩﺍﺕﻭﺭی	hattori
ﻩﺍﺭیﻥگﺕﻭﻥ	harrington
ﻩﺍﺭﺕﻝپ	hartlep
ﻩﺍﺭﻭ	harrow
ﻩﺍﺭﻭﻝ	harvell
ﻩﺍﺭﻭﻭﺩ	harwood
ﻩﺍﻝﺕﻭﻥ	holton
ﻩﺍﻝﺱی	hulsey
ﻩﺍﻝﻑﻭرﺩ	halford
ﻩﺍﻡپﺵیر	hampshire
ﻩﺍﻥگﻩ	haange
ﻩﺍﻥﺵﺭ	hansher
ﻩﺍﻭﺱ	house
ﻩﺍﻭﻝ	havel
ﻩﺍﻭﻥ	haven
ﻩﺭیﺱ	harris
ﻩﺭﻝﻭی	herlevi
ﻩﺭﻡﻥ	herman
ﻩﺭﻥ	hearn
ﻩﺭﻥﺍکی	hernacki
ﻩﺱ	hess
ﻩﻑﺭﻭﻥ	heffron
ﻩﻥک	henke
ﻩﻥی	hanney
ﻩﻥﻝ	henle
ﻩﻭیگﻥ	huigen
ﻩﻭیﺱﺭ	huyser
ﻩﻭﺍ	hua
ﻩﻭﻑﻡﺍﻥ	hofmann
ﻩﻭﻝﺱﺕﻥ	holsten
ﻩﻭﻭﺍﺭﺕ	howarth
ﻭیکﺱ	weeks
ﻭیﺏ	wiebe
ﻭیﺕﺍگﻥ	withagen
ﻭیﺝﻥ	wijdan
ﻭیﺩﺍک	weadock
ﻭیﺭﺝیﻥیﺍ	virginia
ﻭیﻝکیﻥﺯ	wilkins
ﻭیﻝﺍﺱکﻭ	velasco
ﻭیﻝﺩکﺍﺕ	wildcat
ﻭیﻥیکی	winiecki
ﻭیﻥیﺏﻝ	venable
ﻭیﻥﺏﺭگ	weinberg
ﻭیﻥﻥ	whinen
ﻭﺍﺕ	watt
ﻭﺍﺩری	vawdry
ﻭﺍﺩﺯﻥ	whadzen
ﻭﺍﺭﻥﺱ	varnes
ﻭﺍﺭﻭﻝ	varvel
ﻭﺍﻝﺍﺱ	wallace
ﻭﺕﻡﻭﺭ	wetmore
ﻭﺩﻡیﺭ	wedemeier
ﻭﺭﻭﻭﺩ	whorwood
ﻭﺱﺕﻝی	vestli
ﻭﻑیکﺍ	wafiqah
ﻭﻑیکﺍﻩ	wafiqah
ﻭﻝکﻡﺍﻥ	volkman
ﻭﻥچ	wench
ﻭﻥﺩﺭی	vandry
ﻭﻥﺩﺭﻑﻭﺭﺩ	vanderford
ﻭﻥﺩﻝﻥﺩ	wendland
ﻭﻥﺩﻥﻩﻭﻑ	vandenhoff
ﻭﻥﻝک	vanvleck
ﻭﻭﻝﻡﻥ	wolman
