ABASHIRI	網走
ABE	安倍
ABENO	阿倍野
ABIKO	安孫子
ABIRU	安蒜
ABO	安保
ABOSHI	網干
ABU	阿武
ABUKAWA	虻川
ABURAI	油井
ABURAYA	油谷
ACHIWA	阿知波
ADACHI	安立
ADEGAWA	阿出川
ADEKAWA	阿出川
ADUO	阿多
AEBA	饗場
AERI	愛絵理
AGATA	安形
AGATSUMA	吾妻
AGAWA	阿川
AGEISHI	上石
AGEMATSU	上松
AGEO	上尾
AGURI	亜久里
AHIRU	阿比留
AI	亜唯
AIBA	相場
AICHI	愛知
AIDA	会田
AIGA	相賀
AIHARA	相原
AIISO	相磯
AIJIMA	相島
AIJIRO	愛次郎
AIKAWA	会川
AIKI	相木
AIKO	亜依子
AIMOTO	相本
AINO	愛野
AINOSUKE	愛之助
AINOYA	相野谷
AIOI	相生
AISAKU	愛作
AISAWA	逢沢
AISO	相磯
AIUCHI	相内
AIURA	相浦
AIYAMA	相山
AIZAWA	会沢
AIZO	愛三
AIZUBANGE	会津坂下
AIZUHONGO	会津本郷
AIZUTAKADA	会津高田
AIZUWAKAMATSU	会津若松
AJIKI	安食
AJIMA	安島
AJIMU	安心院
AJINOSUKE	味之助
AJIOKA	味岡
AJIRO	網代
AJISAKA	鯵坂
AKABA	赤羽
AKABANE	赤羽
AKABIRA	赤平
AKABORI	赤堀
AKABOSHI	赤星
AKADA	赤田
AKAGAWA	赤川
AKAGI	赤城
AKAGIRI	赤桐
AKAHA	赤羽
AKAHANE	赤羽根
AKAHIRA	赤平
AKAHO	赤穂
AKAHOSHI	赤星
AKAI	赤井
AKAIKE	赤池
AKAISHI	赤石
AKAIWA	赤岩
AKAKABE	赤壁
AKAMA	赤間
AKAMAGASEKI	赤間関
AKAMATSU	赤松
AKAMINE	赤峯
AKANE	茜
AKANUMA	赤沼
AKAO	赤尾
AKAOGI	赤荻
AKARI	明香里
AKARU	耀
AKASAKA	赤坂
AKASE	赤瀬
AKASHI	明石
AKASHINA	明科
AKASO	赤楚
AKASU	赤須
AKATA	赤田
AKATSU	赤津
AKATSUKA	赤塚
AKAYAMA	赤山
AKAZAKI	赤崎
AKAZAWA	赤沢
AKEKO	明子
AKEMI	明実
AKENO	明野
AKESHI	明史
AKETA	明田
AKI	亜季
AKIBA	秋場
AKIE	彰恵
AKIFUMI	彰史
AKIGAWA	秋川
AKIHARU	昭春
AKIHEI	秋平
AKIHIDE	彰英
AKIHIKO	亜紀彦
AKIHIRO	彰博
AKIHISA	彰久
AKIHITO	彰人
AKIHO	明穂
AKIIKE	秋池
AKIKAZU	彰一
AKIKIMI	彰公
AKIKO	亜季子
AKIKUSA	秋草
AKIMA	秋間
AKIMASA	彰将
AKIMI	亜紀実
AKIMICHI	彰道
AKIMITSU	彰光
AKIMOTO	秋元
AKINA	明菜
AKINAGA	秋永
AKINAO	昭尚
AKINARI	明成
AKINO	秋野
AKINOBU	彰伸
AKINORI	彰典
AKIO	亜喜夫
AKIOKA	秋岡
AKIRA	丹
AKIRO	秋郎
AKISADA	秋定
AKISAWA	秋沢
AKISHIMA	昭島
AKITA	明田
AKITAKA	昭隆
AKITANI	秋谷
AKITAYA	秋田谷
AKITO	彰人
AKITOSHI	彰俊
AKITSUGU	明次
AKIWA	秋和
AKIYAMA	秋山
AKIYASU	彰保
AKIYO	亜希世
AKIYOSHI	彰好
AKIYUKI	彰之
AKIZAWA	秋沢
AKIZO	秋蔵
AKIZUKI	秋月
AKO	亜古
AKUI	阿久井
AKUNE	阿久根
AKUSAWA	阿久沢
AKUTAGAWA	芥川
AKUTSU	阿久津
AMAAKE	天明
AMADA	天田
AMAGAI	天海
AMAGASA	天笠
AMAGASAKI	尼崎
AMAGASE	天瀬
AMAGI	甘木
AMAHA	天羽
AMAI	天井
AMAIKE	天池
AMAKASU	甘粕
AMAKAWA	天川
AMAKI	天木
AMAKO	尼子
AMAKUSA	天草
AMAMIYA	天宮
AMAMORI	雨森
AMAMOTO	天本
AMANO	天野
AMANUMA	天沼
AMARI	亜真理
AMARUME	余目
AMATANI	天谷
AMATSU	天津
AMATSUKOMINATO	天津小湊
AMAUMI	天海
AMAYA	天谷
AMEMIYA	雨宮
AMEMORI	雨森
AMI	亜実
AMIKO	亜美子
AMIKURA	網倉
AMIMOTO	網本
AMINAKA	網中
AMINO	網野
AMISHIRO	網代
AMITANI	網谷
AMIYA	網谷
AMO	天羽
ANABUKI	穴吹
ANADA	穴田
ANAHARA	穴原
ANAI	穴井
ANAMI	阿南
ANAMIZU	穴水
ANAN	阿南
ANASAWA	穴沢
ANAYAMA	穴山
ANAZAWA	穴沢
ANBIRU	安蒜
ANDO	安東
ANEKAWA	姉川
ANESAKI	姉崎
ANG	昂
ANI	阿仁
ANJO	安城
ANJU	杏樹
ANNA	安奈
ANNAKA	安中
ANNEN	安念
ANO	安納
ANPO	安保
ANPUKU	安福
ANRAKU	安楽
ANRI	安里
ANTAKU	安宅
ANZAI	安斉
ANZU	杏
AOBA	青葉
AOBATA	青畑
AOCHI	青地
AODA	青田
AOE	青江
AOI	葵
AOIKE	青池
AOKI	青木
AOKO	青子
AOMINE	青峰
AOMORI	青森
AONO	青野
AONUMA	青沼
AOSHIKA	青鹿
AOSHIMA	青島
AOTA	青田
AOTO	青戸
AOTSUKA	青塚
AOYAGI	青柳
AOYAMA	青山
ARA	荒
ARADA	荒田
ARAE	新江
ARAGAKI	新垣
ARAGANE	荒金
ARAHATA	荒幡
ARAHORI	荒堀
ARAI	新井
ARAJIMA	荒島
ARAKAWA	荒川
ARAKI	新木
ARAKIDA	荒木田
ARAMAKI	荒巻
ARAMI	新美
ARANO	新野
ARAO	荒尾
ARAOKA	荒岡
ARASAWA	荒沢
ARASE	荒瀬
ARASEKI	荒関
ARASHI	嵐
ARATA	新
ARATANI	新谷
ARAYA	荒谷
ARAYAMA	荒山
ARIAKE	有明
ARIDA	有田
ARIGA	有我
ARIHARA	在原
ARIHITO	有人
ARII	有井
ARIICHI	有一
ARIIZUMI	有泉
ARIJI	有路
ARIKA	亜利佳
ARIKAWA	有川
ARIKI	有木
ARIMA	有馬
ARIMATSU	有松
ARIMI	有美
ARIMITSU	有光
ARIMOTO	有本
ARIMURA	有村
ARINO	有野
ARINORI	有乗
ARIOKA	有岡
ARISA	亜利沙
ARISAKA	有坂
ARISAWA	有沢
ARITA	有田
ARITAKA	有孝
ARITOMI	有冨
ARIWARA	在原
ARIYAMA	有山
ARIYOSHI	有吉
ARIZONO	有園
ARIZUMI	有住
ARU	亜留
ASABA	浅場
ASADA	朝田
ASAE	亜佐恵
ASAGA	朝賀
ASAGI	浅木
ASAGORO	朝五郎
ASAHA	浅羽
ASAHARA	浅原
ASAHI	旭
ASAHIKAWA	旭川
ASAHINA	朝比奈
ASAI	朝井
ASAJI	朝地
ASAJIRO	浅次郎
ASAKA	亜沙加
ASAKAI	浅海
ASAKAWA	朝川
ASAKICHI	浅吉
ASAKITA	安佐北
ASAKO	亜佐子
ASAKURA	朝倉
ASAMA	浅間
ASAMI	亜佐美
ASAMINAMI	安佐南
ASAMITSU	朝光
ASAMOTO	朝本
ASANO	朝野
ASANUMA	浅沼
ASAO	朝夫
ASAOKA	朝岡
ASARI	浅利
ASATANI	浅谷
ASATARO	朝太郎
ASATSUMA	朝妻
ASAUMI	浅海
ASAWA	浅輪
ASAYA	浅谷
ASAYAMA	朝山
ASAYO	朝代
ASAYUKI	朝之
ASHIBETSU	芦別
ASHIDA	芦田
ASHIHARA	芦原
ASHIHEI	葦平
ASHIKAGA	足利
ASHIKAWA	芦川
ASHIKITA	芦北
ASHINA	芦名
ASHINO	芦野
ASHIO	足尾
ASHITANI	芦谷
ASHIYA	芦屋
ASHIZAWA	芦沢
ASO	阿曽
ASUKA	明日香
ASUKE	足助
ASUMI	明日美
ATA	阿多
ATAKA	安宅
ATAKE	安宅
ATAMI	熱海
ATARASHI	新子
ATARIYAMA	当山
ATARU	中
ATO	阿藤
ATOBE	跡部
ATOMU	歩夢
ATSUBETSU	厚別
ATSUE	敦恵
ATSUFUMI	厚文
ATSUGI	厚木
ATSUHARU	淳治
ATSUHIKO	厚彦
ATSUHIRO	厚博
ATSUHISA	敦久
ATSUHITO	厚人
ATSUJI	敦二
ATSUKAWA	厚川
ATSUKO	亜津子
ATSUMI	厚美
ATSUMU	伍
ATSUNARI	厚成
ATSUNORI	敦規
ATSUO	厚夫
ATSUSHI	充史
ATSUSUKE	篤輔
ATSUTA	熱田
ATSUYA	厚哉
ATSUYO	修代
ATSUYOSHI	淳好
ATSUZAWA	厚沢
AWAIHARA	粟飯原
AWAJI	淡路
AWAKURA	粟倉
AWAMURA	粟村
AWANO	粟野
AWATA	粟田
AWATAKE	粟竹
AWAYA	粟屋
AWAZU	粟津
AYA	亜也
AYABE	綾部
AYAKA	彩佳
AYAKO	亜也子
AYAME	菖
AYAMI	彩水
AYANA	彩名
AYANE	文音
AYANO	彩乃
AYARU	斐
AYASE	綾瀬
AYATA	綾田
AYATO	綾人
AYU	亜由
AYUHA	阿由葉
AYUKAWA	鮎川
AYUKO	亜裕子
AYUMI	亜弓
AYUMU	歩
AYUSAWA	鮎沢
AZATO	安里
AZAWA	安沢
AZE	安瀬
AZEGAMI	畔上
AZEHIRU	畔蒜
AZEKAMI	畔上
AZUMA	吾妻
AZUMI	安住
AZUSA	亜津佐
BABA	馬場
BAN	伴
BANBA	番場
BANDAI	磐梯
BANDO	坂東
BANNAI	坂内
BANNO	万野
BANTO	阪東
BARATA	茨田
BATO	馬頭
BEN	本
BENIKO	紅子
BENIYA	紅谷
BEPPU	別府
BESSHO	別所
BIBAI	美唄
BISAI	尾西
BITO	尾藤
BIZEN	備前
BOKU	朴
BONO	坊農
BUN'ICHI	文一
BUN'ICHIRO	文一郎
BUN'YA	文屋
BUN'YU	文雄
BUNCHIN	文珍
BUNGO	文吾
BUNGOTAKADA	豊後高田
BUNJI	文二
BUNJIRO	文次郎
BUNKICHI	文吉
BUNNO	文野
BUNPEI	文平
BUNSEI	文正
BUNSHICHI	文七
BUNSHIRO	文四郎
BUNSUI	分水
BUNTARO	文太郎
BUNZO	文三
BUSUJIMA	毒島
BUSUKE	武助
BUZEN	豊前
CHAMI	茶美
CHANGJI	昌吉
CHANGPING	昌平
CHE	徹
CHENG	丞
CHENGYI	成一
CHIAKI	千亜季
CHIBA	千葉
CHICHIBU	秩父
CHIDA	千田
CHIE	千恵
CHIEI	千栄
CHIEKI	智恵紀
CHIEKO	千恵子
CHIEMI	千恵巳
CHIEO	智栄夫
CHIERI	千恵理
CHIFUMI	千文
CHIGA	千賀
CHIGIRA	千明
CHIGIRI	契
CHIGUSA	千種
CHIHARA	千原
CHIHARU	千春
CHIHAYA	千早
CHIHIRO	千博
CHIHO	千帆
CHIHOKO	千峰子
CHIKA	千佳
CHIKADA	近田
CHIKAGE	千影
CHIKAHIRO	親弘
CHIKAI	誓
CHIKAKO	千佳子
CHIKAMATSU	近松
CHIKAMORI	近森
CHIKANORI	親徳
CHIKAO	千嘉夫
CHIKAOKA	近岡
CHIKARA	力
CHIKARAISHI	力石
CHIKASHI	睦
CHIKATAKE	親武
CHIKAYAMA	近山
CHIKAYO	千佳代
CHIKAYOSHI	親義
CHIKAYUKI	親之
CHIKAZAWA	近沢
CHIKU	千久
CHIKUGO	筑後
CHIKUHO	筑穂
CHIKUI	筑井
CHIKURA	千倉
CHIKUSA	千種
CHIKUSHI	筑紫
CHIKUSHINO	筑紫野
CHIMAKI	千真季
CHIMAKO	智満子
CHIMIKO	千美子
CHIMURA	千村
CHINAMI	千奈美
CHINATSU	千夏
CHINE	茅根
CHINEN	知念
CHINO	千野
CHINONE	茅根
CHIORI	千織
CHIRYU	知立
CHISA	千沙
CHISAKA	千坂
CHISAKO	千佐子
CHISAKU	千咲
CHISATO	千聖
CHISEKO	千勢子
CHISEN	千仙
CHISHIMA	千島
CHISHIO	千潮
CHITA	知多
CHITAE	智太恵
CHITOSE	千年
CHITOSHI	智稔
CHIWAKI	千脇
CHIYA	千也
CHIYAKO	千夜子
CHIYO	千世
CHIYODA	千代田
CHIYOE	千与江
CHIYOJI	千代治
CHIYOKA	千代芳
CHIYOKICHI	千代吉
CHIYOKO	千与子
CHIYOMATSU	千代松
CHIYOMI	千代三
CHIYONO	千代乃
CHIYOSHI	千佳
CHIYUI	千結
CHIYUKI	千幸
CHIZU	千寿
CHIZUE	千津絵
CHIZUKA	千鶴香
CHIZUKO	千壽子
CHIZURU	千尋
CHIZUYO	千寿代
CHOFU	調布
CHOGORO	潮五郎
CHOHEI	長平
CHOICHI	長一
CHOICHIRO	長一郎
CHOJI	兆治
CHOJIRO	長二郎
CHOKAI	鳥海
CHOKICHI	長吉
CHONAN	長南
CHONOSUKE	長之助
CHOSHI	銚子
CHOSHIRO	長四郎
CHOSUKE	長助
CHOTARO	長太郎
CHOZABURO	長三郎
CHOZO	長三
CHUANG	創
CHUGORI	中郡
CHUHEI	忠平
CHUICHI	忠一
CHUJI	忠司
CHUJIRO	忠次郎
CHUKICHI	忠吉
CHUN	淳
CHUNYI	淳一
CHUO	中央
CHUSAKU	忠作
CHUSHICHI	忠七
CHUTA	忠太
CHUTARO	忠太郎
CHUZO	忠三
CONG	聡
DA	大
DADE	大徳
DADONG	大東
DAGUI	大貴
DAHUI	大輝
DAI	台
DAIDOJI	大道寺
DAIGO	大吾
DAIGUJI	大宮司
DAIHACHI	大八
DAIHACHIRO	大八郎
DAIJI	大路
DAIJIRO	大二郎
DAIKI	大樹
DAIKICHI	大吉
DAIKOKU	大黒
DAIKUHARA	大工原
DAIMARU	大丸
DAIMON	大門
DAIRAKU	大楽
DAISABURO	大三郎
DAISAKU	大作
DAISUKE	大介
DAITARO	大太郎
DAITO	大東
DAITOKU	大徳
DAIWA	大和
DAIZO	大三
DAN	丹
DANKADOMATSU	旦門松
DANNO	団野
DATE	伊達
DAZAIFU	太宰府
DAZHI	達志
DE	徳
DEBUCHI	出渕
DEGAWA	出川
DEGUCHI	出口
DEI	出井
DEJIMA	出島
DEMIZU	出水
DEMURA	出村
DEN'ICHI	伝一
DENDA	伝田
DENHACHI	伝八
DENJI	伝二
DENJIRO	伝次郎
DENKICHI	伝吉
DENO	出野
DENSHIRO	伝四郎
DENSUKE	伝助
DENTARO	伝太郎
DENZABURO	伝三郎
DESAKI	出崎
DESHOU	徳寿
DEURA	出浦
DEUSHI	出牛
DEWA	出羽
DEYI	徳一
DEZHI	得志
DOBASHI	土橋
DOHI	土肥
DOI	土井
DOKE	道家
DOKI	土岐
DOMAE	堂前
DOMEKI	百目鬼
DOMON	土門
DOMOTO	堂本
DONGFANG	東方
DONGYU	東予
DONO	堂埜
DOPPO	独歩
DOSHIDA	土支田
DOZONO	堂園
EBANA	江花
EBARA	江原
EBASHI	江橋
EBATA	江幡
EBATO	江波戸
EBE	江部
EBETSU	江別
EBI	海老
EBIHARA	海老原
EBIKO	蛯子
EBINA	海老名
EBINE	海老根
EBINUMA	海老沼
EBISAWA	海老沢
EBISU	胡
EBISUYA	戎谷
EBUCHI	江淵
ECHIGO	越後
ECHIGOYA	越後谷
ECHIKO	江知子
ECHIZEN	越前
ECHIZEN'YA	越前谷
EDA	枝
EDAGAWA	枝川
EDAMATSU	枝松
EDAMURA	枝村
EDO	江渡
EDOGAWA	江戸川
EDOSAKI	江戸崎
EEICHI	詠一
EGAMI	江上
EGASHIRA	江頭
EGAWA	江川
EGI	江木
EGUCHI	江口
EGURO	江黒
EGUSA	江草
EHANA	江花
EHARA	榎原
EHASHI	江橋
EHATA	江畑
EHIME	愛媛
EHIRA	江平
EI	映
EIGO	瑛伍
EIHACHI	栄八
EIHACHIRO	英八郎
EIHIKO	栄彦
EIICHI	映一
EIICHIRO	栄一郎
EIJI	映二
EIJIRO	栄二郎
EIJU	永寿
EIKAWA	穎川
EIKI	栄喜
EIKICHI	栄吉
EIKO	映子
EIMI	詠美
EINOSUKE	栄之介
EISABURO	栄三郎
EISAKU	栄作
EISHI	英志
EISHIRO	英四郎
EISUKE	栄介
EITARO	栄太郎
EIZABURO	栄三郎
EIZO	栄三
EJIMA	江島
EJIRI	江尻
EKIE	益栄
EMA	恵麻
EMI	恵実
EMIKO	恵三子
EMIO	笑夫
EMORI	江守
EMOTO	柄本
EMU	絵夢
EMURA	江村
EN'ICHI	円一
EN'YA	円谷
ENA	恵奈
ENAKO	恵奈子
ENAMI	榎並
ENARI	江成
ENATSU	江夏
ENDA	遠田
ENDO	遠藤
ENIWA	恵庭
ENKICHI	円吉
ENOHARA	榎原
ENOKI	榎
ENOKIDA	榎田
ENOKIDO	榎戸
ENOKIYA	榎谷
ENOMOTO	榎本
ENZAN	塩山
ERA	江良
ERI	依理
ERIGUCHI	江里口
ERIHA	栄利波
ERIKA	恵利佳
ERIKAWA	江利川
ERIKO	恵利子
ERINA	恵利奈
ESAKA	江坂
ESAKI	江崎
ESASHI	江刺
ESUMI	江角
ETO	江藤
ETSUE	悦江
ETSUKAZU	悦一
ETSUKO	恵津子
ETSUMI	恵津美
ETSUNARI	悦成
ETSUO	悦夫
ETSURO	悦朗
ETSUYA	悦也
ETSUYO	悦代
ETSUZO	悦三
EZAKI	江崎
EZAWA	江沢
EZOE	江副
EZUMI	江角
EZURA	江連
EZURE	江連
FU	福
FUCHI	淵
FUCHIDA	淵田
FUCHIGAMI	淵上
FUCHINO	淵野
FUCHIUE	淵上
FUCHU	婦中
FUDEO	筆雄
FUEDA	笛田
FUEKI	笛木
FUJI	富士
FUJIBAYASHI	藤林
FUJIE	不二恵
FUJIEDA	藤枝
FUJIHARA	藤原
FUJIHASHI	藤橋
FUJIHIKO	不二彦
FUJIHIRA	藤平
FUJII	藤井
FUJIIDERA	藤井寺
FUJIIKE	藤池
FUJIKA	不二香
FUJIKAKE	藤掛
FUJIKAWA	藤川
FUJIKI	藤木
FUJIKO	不二子
FUJIKURA	藤倉
FUJIMA	藤間
FUJIMAKI	藤巻
FUJIMARU	藤丸
FUJIMATSU	藤松
FUJIMI	富士美
FUJIMORI	藤森
FUJIMOTO	藤元
FUJIMURA	藤村
FUJINAGA	藤永
FUJINAKA	藤中
FUJINAMI	藤波
FUJINAWA	藤縄
FUJINE	藤根
FUJINO	藤野
FUJINOMIYA	富士宮
FUJINUKI	藤貫
FUJINUMA	藤沼
FUJIO	不二夫
FUJIOKA	藤岡
FUJISAKA	藤坂
FUJISAKI	藤咲
FUJISATO	藤里
FUJISAWA	藤沢
FUJISE	藤瀬
FUJISHIMA	藤島
FUJISHIRO	藤代
FUJISHITA	藤下
FUJITA	藤田
FUJITANI	藤谷
FUJITO	藤戸
FUJITOMI	藤冨
FUJITSUKA	藤塚
FUJIU	藤生
FUJIURA	藤浦
FUJIWARA	冨士原
FUJIYA	冨士哉
FUJIYAMA	藤山
FUJIYO	不二世
FUJIYOSHI	藤吉
FUJIYOSHIDA	富士吉田
FUJIZUKA	藤塚
FUKABORI	深堀
FUKADA	深田
FUKAE	深江
FUKAGAWA	深川
FUKAI	深井
FUKAISHI	深石
FUKAMACHI	深町
FUKAMI	深海
FUKAMIZU	深水
FUKANO	深野
FUKAO	深尾
FUKASAKU	深作
FUKASE	深瀬
FUKASHI	洸
FUKATSU	深津
FUKAUMI	深海
FUKAURA	深浦
FUKAWA	布川
FUKAYA	深谷
FUKAYAMA	深山
FUKAZAWA	深沢
FUKIAGE	吹上
FUKIAI	葺合
FUKIKO	冨紀子
FUKINO	吹野
FUKITA	吹田
FUKO	風子
FUKU	福
FUKUCHI	福地
FUKUCHIYAMA	福知山
FUKUDA	福田
FUKUDOME	福留
FUKUDOMI	福富
FUKUE	福江
FUKUGAWA	福川
FUKUGI	福城
FUKUHARA	福原
FUKUHIRO	副弘
FUKUI	福井
FUKUICHI	福一
FUKUICHIRO	福一郎
FUKUISHI	福石
FUKUJI	福二
FUKUJIRO	福次郎
FUKUKE	福家
FUKUKO	福子
FUKUMA	福間
FUKUMARU	福丸
FUKUMATSU	福松
FUKUMI	富久美
FUKUMITSU	福光
FUKUMIZU	福水
FUKUMORI	福森
FUKUMOTO	福元
FUKUMURA	福村
FUKUMURO	福室
FUKUNAGA	福永
FUKUNAKA	福中
FUKUNISHI	福西
FUKUNO	福野
FUKUO	二九雄
FUKUOKA	福岡
FUKURA	福浦
FUKUROI	袋井
FUKUSABURO	福三郎
FUKUSAKI	福崎
FUKUSHI	福士
FUKUSHIGE	福茂
FUKUSHIMA	福島
FUKUSHIRO	福四郎
FUKUSUKE	福助
FUKUTANI	福谷
FUKUTARO	福太郎
FUKUTOME	福留
FUKUTOMI	福富
FUKUYA	福家
FUKUYAMA	福山
FUKUYOSHI	福吉
FUKUZAWA	福沢
FUKUZO	福三
FUKUZUMI	福住
FUMI	冨実
FUMIAKI	史明
FUMIE	二三江
FUMIHARA	文原
FUMIHIDE	史英
FUMIHIKO	史彦
FUMIHIRO	史裕
FUMIHITO	文人
FUMIKA	史佳
FUMIKAZU	史一
FUMIKI	文樹
FUMIKIYO	文清
FUMIKO	二三子
FUMIMARU	文丸
FUMIMASA	文正
FUMIMOTO	文元
FUMINA	史奈
FUMINARI	文成
FUMINO	史乃
FUMINOBU	文信
FUMINORI	史紀
FUMIO	二三夫
FUMITAKA	文孝
FUMITAKE	文丈
FUMITERU	文昭
FUMITO	史人
FUMITOSHI	文俊
FUMIYA	史也
FUMIYAMA	文山
FUMIYASU	文康
FUMIYO	二三代
FUMIYOSHI	文好
FUMIYUKI	文之
FUMOTO	麓
FUNABA	船場
FUNABASHI	舟橋
FUNABIKI	船曳
FUNADA	舟田
FUNAGATA	舟形
FUNAI	船井
FUNAKA	府中
FUNAKI	舟木
FUNAKOSHI	舟越
FUNAKUBO	舟久保
FUNAKURA	船倉
FUNAMI	舟見
FUNAMIZU	船水
FUNAMOTO	舟本
FUNAOKA	船岡
FUNASAKA	船坂
FUNASAKI	船崎
FUNATO	船戸
FUNATOGAWA	船渡川
FUNATSU	舟津
FUNAYAMA	舟山
FUNEHIKI	船引
FURANO	富良野
FURIHATA	降旗
FURUBAYASHI	古林
FURUCHI	古内
FURUDACHI	古舘
FURUDONO	古殿
FURUE	古恵
FURUFUJI	古藤
FURUGORI	古郡
FURUGUCHI	古口
FURUHASHI	古橋
FURUHATA	古畑
FURUHIRA	古平
FURUI	古井
FURUICHI	古市
FURUIKE	古池
FURUKAWA	古川
FURUKI	古木
FURUKOSHI	古越
FURUKUBO	古久保
FURUMATA	古俣
FURUMI	古見
FURUMIYA	古宮
FURUMORI	古森
FURUMOTO	古本
FURUMURA	古村
FURUNO	古野
FURUSAWA	古沢
FURUSE	古瀬
FURUSEKI	古関
FURUSHIMA	古島
FURUTA	古田
FURUTATE	古館
FURUYA	古家
FURUYAMA	古山
FUSA	房
FUSAE	房恵
FUSAJI	房次
FUSAKAZU	房一
FUSAKICHI	房吉
FUSAKO	夫佐子
FUSAMASA	房勝
FUSAMI	房実
FUSAO	房夫
FUSAYO	房代
FUSE	布施
FUSEKI	伏木
FUSHIKI	伏木
FUSHIMI	伏見
FUSSA	福生
FUTABA	二葉
FUTAGAMI	二上
FUTAI	二井
FUTAKAMI	二上
FUTAKATA	二方
FUTAKAWA	二川
FUTAKI	二木
FUTAMI	二美
FUTAMURA	二村
FUTAO	二夫
FUTATSUGI	二木
FUTATSUGUCHI	二口
FUTATSUI	二井
FUTOSHI	大
FUTTSU	富津
FUWA	不破
FUYA	布谷
FUYUHIKO	冬彦
FUYUKA	冬佳
FUYUKI	冬樹
FUYUKO	冬子
FUYUMI	冬実
FUZHI	福治
GAKU	学
GAKUTA	額田
GAMAGORI	蒲郡
GAMO	蒲生
GANG	剛
GAO	高
GEN	元
GEN'ICHI	元一
GEN'ICHIRO	源一郎
GENBEI	源兵衛
GENG	耕
GENGA	源河
GENGO	源吾
GENGORO	源五郎
GENJI	源二
GENJIRO	源次郎
GENKAI	玄海
GENKI	源基
GENKICHI	源吉
GENMA	弦間
GENNOSUKE	源之助
GENPEI	源平
GENSAKU	元作
GENTARO	元太郎
GENZABURO	元三郎
GENZO	源三
GIFU	岐阜
GIICHI	儀一
GIN'ICHI	銀一
GINJI	銀二
GINJIRO	銀次郎
GINNOJO	銀之丞
GINNOSUKE	銀之助
GINOWAN	宜野湾
GINTARO	銀太郎
GINZABURO	銀三郎
GINZO	銀蔵
GISABURO	義三郎
GO	剛
GOBO	御坊
GODA	郷田
GOHARA	郷原
GOHEI	剛平
GOHONGI	五本木
GOI	五井
GOICHI	五一
GOJI	剛二
GOJIMA	五島
GOJO	五条
GOJOME	五城目
GOKA	五霞
GOKAMI	後上
GOKAN	後閑
GOKITA	五木田
GOMA	後間
GOMI	五味
GOMIFUCHI	五味淵
GOMIKAWA	五味川
GONDA	権田
GONDO	権藤
GONG	功
GONGPING	公平
GONJIRO	権次郎
GONKICHI	権吉
GONMORI	権守
GONNO	権野
GONO	郷野
GONOHE	五戸
GONOI	五野井
GONSUKE	権助
GORO	五郎
GOSE	御所
GOSEKI	後関
GOSEN	五泉
GOSHIMA	五島
GOSHOGAWARA	五所川原
GOSHORA	御所浦
GOTANDA	五反田
GOTARO	剛太郎
GOTENBA	御殿場
GOTO	五島
GOTODA	後藤田
GOTSU	合津
GOZO	剛三
GUANG	光
GUANGDE	光徳
GUANGHUI	光輝
GUANGPING	光平
GUANGYI	光一
GUANYI	貫一
GUI	圭
GUIWU	桂吾
GUIYI	桂一
GUIZHI	貴志
GUN'ICHI	軍一
GUNJI	軍司
GUNMA	群馬
GUNPEI	軍兵
GUNZO	軍造
GUOBAO	国保
GUOFU	国府
GUSHIKAWA	具志川
GUSHIKEN	具志堅
GYODA	行田
HABA	幅
HABARA	羽原
HABASHI	羽橋
HABATA	幅田
HABE	羽部
HABIKINO	羽曳野
HABU	土生
HABUCHI	羽渕
HABUKA	羽深
HACHIJO	八丈
HACHIMORI	八森
HACHINOHE	八戸
HACHIOJI	八王子
HACHIRO	八朗
HACHIROGATA	八郎潟
HACHIRYU	八竜
HACHISAKA	八坂
HACHISU	蜂巣
HACHISUKA	蜂須賀
HACHIYA	八谷
HADA	波田
HADANO	秦野
HAGA	羽賀
HAGI	萩
HAGIHARA	萩原
HAGIMORI	萩森
HAGIMOTO	萩元
HAGINOYA	萩野谷
HAGIO	萩尾
HAGITA	萩田
HAGITANI	萩谷
HAGIUDA	萩生田
HAGIWARA	萩原
HAGIYA	萩谷
HAGURO	羽黒
HAIBAO	海宝
HAIKO	羽衣子
HAINO	灰野
HAIPING	海平
HAISHI	羽石
HAIZHOU	海舟
HAJI	土師
HAJIKA	初鹿
HAJIME	一
HAJIMU	甫
HAKAMADA	袴田
HAKARU	恕
HAKATA	博多
HAKI	杷木
HAKII	波木井
HAKO	葉子
HAKODA	箱田
HAKODATE	函館
HAKOISHI	箱石
HAKOMORI	箱守
HAKONE	箱根
HAKOYAMA	箱山
HAKOZAKI	箱崎
HAKUI	羽咋
HAKUSHU	白州
HAMA	浜
HAMABE	浜辺
HAMACHI	浜地
HAMADA	浜田
HAMAGAMI	浜上
HAMAGUCHI	浜口
HAMAHATA	浜畑
HAMAI	浜井
HAMAIKE	浜池
HAMAKAWA	浜川
HAMAKITA	浜北
HAMAKO	浜子
HAMAMATSU	浜松
HAMAMOTO	浜本
HAMAMURA	浜村
HAMANA	浜名
HAMANAKA	浜中
HAMANISHI	浜西
HAMANO	浜野
HAMAO	浜尾
HAMAOKA	浜岡
HAMAOMOTE	浜表
HAMASAKI	浜崎
HAMASHIMA	浜島
HAMASUNA	浜砂
HAMATANI	浜谷
HAMATSU	浜津
HAMAUE	浜上
HAMAYA	浜谷
HAMAZAKI	浜崎
HAMOCHI	羽茂
HAMURA	羽村
HAN'YA	半谷
HANA	花
HANABATA	花畑
HANABUSA	花房
HANADA	花田
HANAE	花恵
HANAGA	花香
HANAGATA	花形
HANAHARA	花原
HANAI	花井
HANAIZUMI	花泉
HANAKAWA	花川
HANAKI	花木
HANAKO	花子
HANAMAKI	花巻
HANAMI	花見
HANAMIGAWA	花見川
HANAMOTO	花本
HANAMURA	花村
HANANO	花野
HANAOKA	花岡
HANARI	羽成
HANASAKI	花崎
HANASAWA	花沢
HANASHI	葉梨
HANASHIMA	花島
HANATANI	花谷
HANAUE	花上
HANAWA	塙
HANAYAMA	花山
HANAYO	花世
HANAZATO	花里
HANAZONO	花園
HANAZUKA	花塚
HANBEE	半兵衛
HANDA	半田
HANDO	半藤
HANE	羽根
HANEBUKA	羽深
HANEDA	羽根田
HANEFUKI	羽吹
HANEHARA	羽原
HANEISHI	羽石
HANEYAMA	羽山
HANGAI	半谷
HANIU	土生
HANIWARA	埴原
HANJIRO	伴次郎
HANMA	半間
HANNAN	阪南
HANNO	飯能
HANSHIRO	半四郎
HANSUKE	伴助
HANTANI	半谷
HANYU	羽生
HANZAWA	半沢
HAO	浩
HAOPING	浩平
HAORONG	浩栄
HARA	原
HARABE	原辺
HARADA	原田
HARAGUCHI	原口
HARAKAWA	原川
HARAKI	原木
HARAKO	原子
HARAMACHI	原町
HARANO	原野
HARASAKI	原崎
HARASAWA	原沢
HARASHIMA	原島
HARAYAMA	原山
HARIGAI	針谷
HARIKAE	張替
HARIMA	張間
HARIMAYA	針間矢
HARIMOTO	張本
HARIO	針生
HARIYA	針谷
HARU	春
HARUDA	治田
HARUE	春恵
HARUFUMI	晴文
HARUHARA	春原
HARUHIKO	春彦
HARUHIRO	晴広
HARUHISA	春久
HARUHITO	晴仁
HARUJI	春次
HARUKA	春佳
HARUKAWA	春川
HARUKI	春喜
HARUKICHI	春吉
HARUKO	春子
HARUMI	春実
HARUMITSU	春充
HARUMOTO	春元
HARUNA	春名
HARUNO	春乃
HARUNOBU	晴信
HARUNORI	治憲
HARUNOSUKE	春之助
HARUO	春夫
HARUOMI	晴臣
HARUSHI	治司
HARUSHIGE	晴重
HARUSUKE	治助
HARUTA	春田
HARUTAKA	治隆
HARUTARO	春太郎
HARUTOSHI	春年
HARUYA	春也
HARUYAMA	春山
HARUYASU	晴康
HARUYO	春代
HARUYOSHI	春好
HARUYUKI	春之
HARUZO	春蔵
HASAKI	波崎
HASAMA	挾間
HASE	長谷
HASEBE	長谷部
HASEGAWA	長谷川
HASEMI	長谷見
HASEYAMA	長谷山
HASHI	橋
HASHIBA	橋場
HASHIDA	橋田
HASHIDATE	橋立
HASHIGAMI	橋上
HASHIGUCHI	橋口
HASHII	橋井
HASHIKAWA	橋川
HASHIKURA	橋倉
HASHIMA	橋間
HASHIMOTO	橋元
HASHIMURA	橋村
HASHINO	橋野
HASHITANI	橋谷
HASHIUE	橋上
HASHIURA	橋浦
HASHIYA	橋谷
HASHIYADA	橋谷田
HASHIZAKI	橋崎
HASHIZO	橋蔵
HASHIZUME	橋爪
HASUDA	蓮田
HASUI	蓮井
HASUIKE	蓮池
HASUKO	蓮子
HASUMI	蓮実
HASUNUMA	蓮沼
HASUO	蓮尾
HASUYO	蓮代
HATA	波多
HATADA	畑田
HATAGUCHI	畑口
HATAI	畑井
HATAKEYAMA	畑山
HATAMOTO	畑本
HATANAKA	畑中
HATANO	幡野
HATASAWA	畑沢
HATASHITA	畑下
HATASU	毅
HATAYA	旗谷
HATAYAMA	畑山
HATO	羽藤
HATOGAI	鳩貝
HATOKO	鳩子
HATOMI	羽冨
HATORI	羽鳥
HATOYAMA	鳩山
HATSUE	初恵
HATSUGAI	初谷
HATSUGORO	初五郎
HATSUHIKO	初彦
HATSUICHI	初一
HATSUKAICHI	廿日市
HATSUKI	葉月
HATSUKO	初子
HATSUMI	初実
HATSUO	初夫
HATSUSAWA	初沢
HATSUSE	初瀬
HATSUSHIBA	初芝
HATSUTA	初田
HATSUTANI	初谷
HATSUTARO	初太郎
HATSUYA	初谷
HATSUYAMA	初山
HATSUYO	初代
HATSUZAWA	初沢
HATTA	八田
HAYAFUNE	早舩
HAYAKAWA	早川
HAYAKO	早子
HAYAMA	巴山
HAYAMI	早水
HAYAMIZU	速水
HAYANO	早野
HAYAO	速夫
HAYASAKA	早坂
HAYASAKI	早崎
HAYASE	早瀬
HAYASHI	早矢仕
HAYASHIBARA	林原
HAYASHIBE	林部
HAYASHIDA	林田
HAYASHIZAKI	林崎
HAYATA	早田
HAYATO	勇人
HAYATSU	早津
HAZAMA	狭間
HAZU	羽津
HAZUKI	葉月
HAZUMI	羽住
HEIDAYU	平太夫
HEIHACHI	平八
HEIHACHIRO	平八郎
HEIICHI	平一
HEIICHIRO	平一郎
HEIJI	平次
HEIJIRO	平次郎
HEIKICHI	兵吉
HEIROKU	平六
HEISAKU	平作
HEISUKE	平介
HEITARO	平太郎
HEIZABURO	平三郎
HEIZO	平蔵
HEKINAN	碧南
HENG	恒
HENMI	辺見
HERAI	戸来
HIBARA	日原
HIBI	日比
HIBIKI	響
HIBINO	日比野
HIBIYA	日比谷
HIDA	樋田
HIDAKA	日高
HIDANO	肥田野
HIDE	日出
HIDEAKI	日出昭
HIDEFUMI	秀文
HIDEHARU	秀春
HIDEHIKO	秀彦
HIDEHIRO	秀博
HIDEHISA	秀久
HIDEHO	秀穂
HIDEICHI	秀一
HIDEJI	秀二
HIDEJIRO	秀二郎
HIDEKA	秀香
HIDEKATSU	秀勝
HIDEKAZU	秀一
HIDEKI	秀喜
HIDEKICHI	秀吉
HIDEKO	日出子
HIDEKUNI	秀圀
HIDEMASA	英征
HIDEMI	日出実
HIDEMICHI	英道
HIDEMITSU	秀三
HIDEMUNE	英宗
HIDENAO	英直
HIDENARI	秀成
HIDENOBU	秀信
HIDENORI	秀典
HIDENOSUKE	秀之助
HIDEO	偉夫
HIDEOMI	秀臣
HIDERO	秀朗
HIDESATO	秀郷
HIDESHI	秀司
HIDESHIGE	英茂
HIDESHIMA	秀嶋
HIDETADA	秀忠
HIDETAKA	秀孝
HIDETAKE	秀武
HIDETARO	秀太郎
HIDETO	秀人
HIDETOMI	秀富
HIDETOSHI	秀俊
HIDETSUGU	秀嗣
HIDEYA	秀也
HIDEYASU	秀保
HIDEYO	秀世
HIDEYOSHI	秀吉
HIDEYUKI	秀之
HIEDA	稗田
HIFUMI	一二三
HIGA	比嘉
HIGAKI	桧垣
HIGANO	日向野
HIGASA	日笠
HIGASHI	東
HIGASHIDA	東田
HIGASHIDE	東出
HIGASHIGUCHI	東口
HIGASHIHARA	東原
HIGASHIHIROSHIMA	東広島
HIGASHIJIMA	東嶋
HIGASHIKAWA	東川
HIGASHIKURUME	東久留米
HIGASHIMATSUYAMA	東松山
HIGASHIMOTO	東本
HIGASHIMURA	東村
HIGASHIMURAYAMA	東村山
HIGASHINADA	東灘
HIGASHINARI	東成
HIGASHINE	東根
HIGASHIO	東尾
HIGASHIOSAKA	東大阪
HIGASHISUMIYOSHI	東住吉
HIGASHITANI	東谷
HIGASHIURA	東浦
HIGASHIYAMA	東山
HIGASHIYAMATO	東大和
HIGASHIYODOGAWA	東淀川
HIGASHIYURI	東由利
HIGETA	日下田
HIGO	日護
HIGUCHI	樋口
HIGUMA	樋熊
HIGURE	日暮
HIHARA	日原
HIJI	日出
HIJIKATA	土方
HIJIRI	聖
HIKA	比嘉
HIKAGE	日景
HIKARI	光
HIKARU	光
HIKATA	干潟
HIKAWA	樋川
HIKI	比企
HIKICHI	引地
HIKIDA	引田
HIKIMA	引間
HIKITA	引田
HIKODA	彦田
HIKOHARU	彦治
HIKOICHI	彦一
HIKOJI	彦治
HIKOJIRO	彦四郎
HIKONE	彦根
HIKOSABURO	彦三郎
HIKOSAKA	彦坂
HIKOSAKU	彦作
HIKOTARO	彦太郎
HIKOYOSHI	彦好
HIKUMA	日隈
HIME	日女
HIMEDO	姫戸
HIMEJI	姫路
HIMENO	姫野
HIMI	氷見
HIMIKO	卑弥呼
HIMORI	桧森
HINAI	比内
HINAKO	彼奈子
HINATA	日向
HINO	日野
HINODE	日出
HINOHARA	日野原
HINUMA	日沼
HIOKI	日沖
HIRA	平
HIRABAYASHI	平林
HIRADE	平出
HIRADO	平戸
HIRAFUKI	平吹
HIRAGA	平賀
HIRAGURI	平栗
HIRAHARA	平原
HIRAI	平井
HIRAIDE	平出
HIRAIKE	平池
HIRAISHI	平石
HIRAIWA	平岩
HIRAIZUMI	平泉
HIRAKA	平賀
HIRAKATA	平形
HIRAKAWA	平川
HIRAKI	平木
HIRAKO	平子
HIRAKU	啓
HIRAMA	平間
HIRAMATSU	平松
HIRAMI	平見
HIRAMINE	平峯
HIRAMITSU	平光
HIRAMOTO	平元
HIRANAI	平内
HIRANAKA	平中
HIRANO	平野
HIRANUMA	平沼
HIRAO	平尾
HIRAOKA	平岡
HIRARA	平良
HIRASAKA	平坂
HIRASAKI	平崎
HIRASAWA	平沢
HIRASE	平瀬
HIRASHIMA	平島
HIRATA	平田
HIRATSUKA	平塚
HIRAUCHI	平内
HIRAYA	平谷
HIRAYAMA	平山
HIRAYANAGI	平柳
HIRO	博夫
HIROAKI	博彰
HIROBE	広部
HIROBUMI	博文
HIROCHIKA	博盟
HIROE	博恵
HIROFUMI	博史
HIROHARA	広原
HIROHARU	博治
HIROHASHI	広橋
HIROHATA	広畑
HIROHIDE	博英
HIROHIKO	博彦
HIROHISA	博久
HIROHITO	博人
HIROI	広井
HIROICHI	博一
HIROISHI	広石
HIROJI	博治
HIROKA	広佳
HIROKATSU	広勝
HIROKAWA	広川
HIROKAZU	博一
HIROKI	博喜
HIROKICHI	博吉
HIROKO	博子
HIROKUNI	宏邦
HIROMAE	広前
HIROMARU	博丸
HIROMASA	博政
HIROMASU	博益
HIROMATSU	広末
HIROMI	博実
HIROMICHI	博通
HIROMITSU	博允
HIROMOTO	博元
HIROMU	博睦
HIRONAKA	広中
HIRONAO	寛直
HIRONARI	浩成
HIRONO	広野
HIRONOBU	博信
HIRONORI	博則
HIRONOSUKE	広之助
HIROSABURO	広三郎
HIROSAKI	広崎
HIROSAKU	広作
HIROSAWA	広沢
HIROSE	広瀬
HIROSHI	亘
HIROSHIGE	博繁
HIROSHIMA	広島
HIROSUKE	広助
HIROTA	広田
HIROTADA	博忠
HIROTAKA	博孝
HIROTAKE	弘赳
HIROTANI	広谷
HIROTATSU	弘達
HIROTO	博人
HIROTOMO	広友
HIROTOSHI	博俊
HIROTOYO	博豊
HIROTSU	広津
HIROTSUGU	博嗣
HIROWATARI	広渡
HIROYA	博也
HIROYAMA	広山
HIROYASU	博安
HIROYO	啓代
HIROYOSHI	博善
HIROYUKI	博之
HIRUKAWA	蛭川
HIRUMA	昼間
HIRUTA	蛭田
HISA	久
HISAAKI	久彰
HISADA	久田
HISAE	久恵
HISAFUMI	久文
HISAHARU	久晴
HISAHIKO	久彦
HISAHIRO	久寛
HISAI	久井
HISAICHI	久一
HISAJI	久次
HISAJIMA	久島
HISAKATSU	久克
HISAKAWA	久川
HISAKAZU	久一
HISAKI	久木
HISAKICHI	久吉
HISAKO	久子
HISAMATSU	久末
HISAMI	久実
HISAMITSU	久三
HISAMOTO	久本
HISANAGA	久永
HISANAO	久尚
HISANARI	久成
HISANO	久野
HISANOBU	久信
HISANORI	久典
HISAO	久夫
HISAOKA	久岡
HISASHI	久
HISASHICHI	寿七
HISATADA	久忠
HISATAKA	久孝
HISATERU	久照
HISATO	久人
HISATOMI	久冨
HISATOSHI	久俊
HISATSUGU	久嗣
HISAYA	久也
HISAYAMA	久山
HISAYASU	久靖
HISAYO	久代
HISAYOSHI	久佳
HISAYUKI	久之
HISHIDA	菱田
HISHIKAWA	菱川
HISHIKI	菱木
HISHINUMA	菱沼
HISHIYA	菱谷
HISHIYAMA	菱山
HISOKA	密
HITA	日田
HITACHI	日立
HITACHIOTA	常陸太田
HITAI	比田井
HITO	仁雄
HITOKI	一樹
HITOMI	一美
HITOSHI	一史
HITOTSUGI	一木
HITOYA	人也
HITOYOSHI	人吉
HITSUME	日詰
HIUE	樋上
HIURA	日浦
HIWATA	樋渡
HIWATARI	樋渡
HIWATASHI	樋渡
HIYAMA	日山
HIYOSHI	日吉
HOASHI	帆足
HOBARA	保原
HODACHI	保立
HODAKA	保高
HODOSHIMA	程島
HODOTSUKA	保戸塚
HOFU	防府
HOGARI	帆刈
HOGAWA	穂川
HOI	保井
HOIZUMI	保泉
HOJO	北条
HOKARI	帆刈
HOKASONO	外園
HOKKAIDO	北海道
HOKOTA	鉾田
HOKUGO	北郷
HOKURA	保倉
HOKUTO	北斗
HOMARE	誉
HON	本
HON'YABAKEI	本耶馬溪
HONAMI	保奈美
HONBO	本保
HONDA	本多
HONDO	本堂
HONG	宏
HONGO	本郷
HONGPING	宏平
HONGYI	弘一
HONJO	本庄
HONMA	本間
HONMIYA	本宮
HONNA	本名
HONOBE	保延
HONSHU	本州
HONTANI	本谷
HONZAWA	本沢
HORAGUCHI	洞口
HORI	堀
HORIAI	堀合
HORIBA	堀場
HORIBE	堀部
HORIE	堀江
HORIGOME	堀篭
HORIGUCHI	堀口
HORII	堀井
HORIIE	堀家
HORIIKE	堀池
HORIKAWA	堀川
HORIKI	堀木
HORIKIRI	堀切
HORIKOSHI	堀越
HORIMOTO	堀本
HORINAKA	堀中
HORINO	堀野
HORINOCHI	堀之内
HORIO	堀尾
HORIOKA	堀岡
HORISAKI	堀崎
HORISAWA	堀沢
HORIUCHI	堀内
HORIYAMA	堀山
HOSAKA	保坂
HOSAKU	豊作
HOSHI	星
HOSHIAI	星合
HOSHIBA	干場
HOSHIDA	星田
HOSHIDE	星出
HOSHII	星井
HOSHIJIMA	星嶋
HOSHIKA	星加
HOSHIKAWA	干川
HOSHIKO	星子
HOSHIMOTO	星本
HOSHINA	保科
HOSHINO	星埜
HOSHINOYA	星野谷
HOSHIYA	星谷
HOSHIYAMA	星山
HOSOBUCHI	細淵
HOSOCHI	細内
HOSODA	細田
HOSOE	細江
HOSOGAI	細貝
HOSOGAYA	細萱
HOSOGI	細木
HOSOGOSHI	細越
HOSOI	細井
HOSOJIMA	細島
HOSOKAWA	細川
HOSOKI	細木
HOSOMI	細見
HOSONE	細根
HOSONO	細野
HOSONUMA	細沼
HOSOYA	細矢
HOSOYAMA	細山
HOSUKE	豊助
HOTAKA	保孝
HOTANI	保谷
HOTCHI	発地
HOTODA	保土田
HOTOZUKA	保戸塚
HOTTA	堀田
HOYA	保谷
HOZUMI	保住
HUANG	晃
HUI	恵
HUILING	恵玲
HUIZHI	恵志
HYOE	兵衛
HYOGO	兵庫
HYOKICHI	兵吉
HYOTA	俵太
HYUGA	日向
IBA	井場
IBARA	井原
IBARAKI	茨城
IBASHI	伊橋
IBATA	井畑
IBAYASHI	伊林
IBE	井部
IBI	伊比
IBUKA	井深
IBUKI	伊吹
IBUSUKI	指宿
ICHIBA	一場
ICHIDA	市田
ICHIEI	市衛
ICHIGE	市毛
ICHIGORO	一五郎
ICHIHARA	原
ICHIHASHI	市橋
ICHII	一井
ICHIJI	伊地知
ICHIJIMA	市島
ICHIKAI	市貝
ICHIKAWA	市川
ICHIKI	一木
ICHIKO	一子
ICHIKURA	一倉
ICHIMARU	一丸
ICHIMIYA	一宮
ICHIMURA	一村
ICHINO	市野
ICHINOHE	一戸
ICHINOMIYA	一宮
ICHINOSE	一之瀬
ICHINOSEKI	一関
ICHINOZAWA	市野沢
ICHIO	一夫
ICHIOKA	市岡
ICHIRO	一朗
ICHISE	市瀬
ICHISHIMA	市島
ICHISUGI	一杉
ICHITANI	一谷
ICHITARO	一太郎
ICHITO	市東
ICHITSUKA	市塚
ICHIYAMA	市山
ICHIYANAGI	一柳
ICHIYO	一世
ICHIZAWA	市沢
ICHIZO	一三
ICHIZUKA	市塚
IDA	井田
IDE	井出
IDEGUCHI	井手口
IDEHARA	出原
IDEI	出井
IDEKAWA	出川
IDEMIZU	出水
IDEMURA	出村
IDENO	出野
IDETA	出田
IDO	井戸
IEDA	家田
IEIRI	家入
IEKAZU	家和
IEMASA	家正
IEMURA	家村
IENAGA	家永
IETADA	家忠
IETSUGU	家継
IEYASU	家康
IFUJI	井藤
IGA	伊賀
IGAI	猪飼
IGAKI	井垣
IGAMI	伊神
IGARASHI	五十嵐
IGATA	井形
IGAWA	伊川
IGETA	井下田
IGI	猪木
IGUCHI	井口
IGUSA	井草
IHANA	猪鼻
IHARA	井原
IHOKO	五百子
II	井伊
IIDA	飯田
IIDAKA	飯高
IIDATE	飯館
IIDE	飯豊
IIHAMA	飯浜
IIHARA	飯原
IIIZUMI	飯泉
IIJIMA	飯島
IIKAWA	飯川
IIKURA	飯倉
IIMORI	飯森
IIMURA	飯村
IIMURO	飯室
IINO	飯野
IINUMA	飯沼
IIO	飯尾
IIOKA	飯岡
IISAKA	飯坂
IISATO	飯郷
IITAGAWA	飯田川
IITAKA	飯高
IIYAMA	飯山
IIYOSHI	飯吉
IIZAKA	飯坂
IIZAWA	飯沢
IIZUKA	飯塚
IIZUMI	飯泉
IJICHI	伊地知
IJIMA	井島
IJIRI	井尻
IJURO	伊重郎
IKAHATA	五十畑
IKAHO	伊香保
IKAI	猪飼
IKAMI	伊神
IKARI	五十里
IKAWA	井川
IKE	池
IKEBE	池辺
IKEDA	池田
IKEDO	池戸
IKEGAI	池谷
IKEGAME	池亀
IKEGAMI	池上
IKEGAWA	池川
IKEGUCHI	池口
IKEHARA	池原
IKEHATA	池畑
IKEJIMA	池島
IKEJIRI	池尻
IKEKAWA	池川
IKEMATSU	池松
IKEMORI	池森
IKEMOTO	池本
IKEMURA	池村
IKENAGA	池永
IKENO	池野
IKEO	池尾
IKESHITA	池下
IKETANI	池谷
IKETO	池戸
IKEUCHI	池内
IKEURA	池浦
IKEYA	池谷
IKEYAMA	池山
IKEZAKI	池崎
IKEZAWA	池沢
IKEZOE	池添
IKEZOI	池添
IKEZU	池津
IKI	伊木
IKKO	一行
IKOMA	生駒
IKU	育
IKUE	幾恵
IKUFUMI	幾文
IKUHIRO	育弘
IKUINA	生稲
IKUINE	生稲
IKUJIMA	生島
IKUKATA	生方
IKUKO	伊久子
IKUMA	井熊
IKUMI	幾実
IKUNO	生野
IKUO	幾夫
IKURA	伊倉
IKURO	幾朗
IKUSAWA	生沢
IKUSHIMA	生島
IKUTA	生田
IKUTARO	郁太郎
IKUYA	生也
IKUYO	幾世
IKUZAWA	生沢
IKUZO	幾三
IMABARI	今治
IMABAYASHI	今林
IMABETSU	今別
IMABORI	今堀
IMADA	今田
IMADE	今出
IMAE	今江
IMAEDA	今枝
IMAFUKU	今福
IMAGAWA	今川
IMAHASHI	今橋
IMAHORI	今堀
IMAI	今井
IMAICHI	今市
IMAIZUMI	今泉
IMAKI	今木
IMAKITA	今北
IMAKO	今子
IMAMICHI	今道
IMAMIYA	今宮
IMAMOTO	今本
IMAMURA	今村
IMANAKA	今中
IMANARI	今成
IMANISHI	今西
IMAO	今尾
IMAOKA	今岡
IMARI	伊万里
IMASAKA	今坂
IMASATO	今里
IMASEKI	今関
IMASHI	乃
IMASHIRO	今城
IMAYOSHI	今吉
IMAZATO	今里
IMAZAWA	今沢
IMAZEKI	今関
IMAZU	今津
IMIZU	出水
IMOKAWA	芋川
IMOTO	井元
IMURA	井村
INA	伊奈
INABA	稲場
INABE	稲辺
INADA	稲田
INADOMI	稲富
INAGAKI	稲垣
INAGAWA	稲川
INAGE	稲毛
INAGEDA	稲毛田
INAGI	稲城
INAHARA	稲原
INAHASHI	稲橋
INAI	稲井
INAISHI	稲石
INAKAWA	稲川
INAKI	稲木
INAKUMA	稲熊
INAMASU	稲増
INAMI	井波
INAMORI	稲森
INAMOTO	稲元
INAMURA	稲村
INANO	稲野
INANOBE	稲野辺
INAO	稲生
INAOKA	稲岡
INARI	稲荷
INASAKA	稲坂
INASAKI	稲崎
INASAWA	稲沢
INATANI	稲谷
INATOME	稲留
INATOMI	稲冨
INATSUKI	稲月
INAWASHIRO	猪苗代
INAYAMA	稲山
INAYOSHI	稲吉
INAZAWA	稲沢
INDO	印藤
INEKI	稲木
INEKO	稲子
INETSUMI	稲積
INIWA	伊庭
INNAI	院内
INNAMI	印南
INNOSHIMA	因島
INO	井野
INODA	猪田
INOE	井上
INOGUCHI	井野口
INOHANA	猪鼻
INOHARA	猪原
INOKA	猪岡
INOKI	猪木
INOKO	猪子
INOKOSHI	猪越
INOKUMA	猪熊
INOMATA	猪俣
INORA	猪之良
INOSE	猪瀬
INOSHITA	井下
INOSUKE	伊之助
INOTSUME	猪爪
INOYAMA	猪山
INUBUSE	犬伏
INUI	乾
INUKAI	犬飼
INUMARU	犬丸
INUYAMA	犬山
INUZUKA	犬塚
INZAI	印西
IO	猪尾
IOHARA	庵原
IOKA	井岡
IOKAWA	五百川
IORI	伊織
IPPEI	一兵
IRIE	入江
IRIGUCHI	入口
IRIKURA	入倉
IRIMAJIRI	入交
IRIMURA	入村
IRINO	入野
IRISAWA	入沢
IRITANI	入谷
IRIYAMA	入山
IROBE	色部
IROKAWA	色川
IRUMA	入間
ISA	伊佐
ISABURO	伊三郎
ISAE	功恵
ISAGO	砂金
ISAHAYA	諌早
ISAKA	井坂
ISAKI	井崎
ISAKO	伊佐子
ISAKU	伊作
ISAMI	伊佐実
ISAMU	偉
ISANO	伊佐野
ISAO	五三雄
ISATO	勇人
ISAWA	井沢
ISAYAMA	伊佐山
ISE	伊勢
ISEDA	伊勢田
ISEHARA	伊勢原
ISEKI	井関
ISERI	井芹
ISESAKI	伊勢崎
ISEYA	伊勢谷
ISEYAMA	伊勢山
ISEZAKI	伊勢崎
ISHI	石
ISHIAI	石合
ISHIAKI	石明
ISHIBA	石場
ISHIBASHI	石橋
ISHIBE	石部
ISHIBIKI	石引
ISHIDA	石田
ISHIDAKA	石高
ISHIDE	石出
ISHIDO	石堂
ISHIDOYA	石戸谷
ISHIGAKI	石垣
ISHIGAME	石亀
ISHIGAMI	石上
ISHIGE	石下
ISHIGOOKA	石郷岡
ISHIGUCHI	石口
ISHIGURI	石栗
ISHIGURO	石黒
ISHIHAMA	石浜
ISHIHARA	石原
ISHII	石井
ISHIJIMA	石島
ISHIKARI	石狩
ISHIKAWA	石川
ISHIKI	一色
ISHIKO	石河
ISHIKOSHI	石越
ISHIKURA	石倉
ISHIMAKI	石巻
ISHIMARU	石丸
ISHIMATSU	石松
ISHIMI	石見
ISHIMORI	石森
ISHIMOTO	石本
ISHIMURA	石村
ISHIN	維新
ISHINABE	石鍋
ISHINO	石野
ISHINOMAKI	石巻
ISHIO	石尾
ISHIOKA	石岡
ISHISONE	石曽根
ISHITA	井下
ISHITANI	石谷
ISHITO	石戸
ISHITOBI	石飛
ISHITSUKI	石附
ISHIURA	石浦
ISHIWA	石和
ISHIWATA	石和田
ISHIWATARI	石渡
ISHIYAMA	石山
ISHIZAKA	石坂
ISHIZAKI	石崎
ISHIZAWA	石沢
ISHIZEKI	石関
ISHIZONE	石曽根
ISHIZU	石津
ISHIZUKA	石塚
ISO	五三夫
ISOBE	磯辺
ISODA	磯田
ISOE	磯恵
ISOGAI	磯谷
ISOGAMI	磯上
ISOGO	磯子
ISOHATA	五十畑
ISOJIMA	磯島
ISOKAWA	五十川
ISOME	磯目
ISOMURA	磯村
ISONO	磯野
ISOYA	磯谷
ISOYAMA	磯山
ISOZAKI	磯崎
ISSA	一茶
ISSAKU	一作
ISSEI	一成
ISUKE	伊助
ISUMI	夷隅
ISUZU	五十鈴
ITABASHI	板橋
ITAGAKI	板垣
ITAI	板井
ITAKO	潮来
ITAKURA	板倉
ITAMI	伊丹
ITANI	井谷
ITANO	板野
ITARU	之
ITASAKA	板坂
ITASAWA	板沢
ITAYA	板屋
ITAYAMA	板山
ITAYANAGI	板柳
ITAZU	板津
ITO	井藤
ITODA	糸田
ITOE	糸枝
ITOGA	糸賀
ITOHISA	糸久
ITOI	糸井
ITOIGAWA	糸魚川
ITOKAWA	糸川
ITOKAZU	糸数
ITOKO	糸子
ITOMAN	糸満
ITOYAMA	糸山
ITSUKI	樹
ITSUKO	伊津子
ITSUMI	逸実
ITSUO	五夫
ITSURO	逸朗
ITSUWA	五和
ITSUYA	逸哉
IUCHI	井内
IURA	井浦
IWAASA	岩浅
IWABE	岩辺
IWABUCHI	岩淵
IWADATE	岩楯
IWADE	岩出
IWADEYAMA	岩出山
IWAFUNE	岩舟
IWAGAMI	岩上
IWAHARA	岩原
IWAHASHI	岩橋
IWAHORI	岩堀
IWAI	岩井
IWAIDA	岩井田
IWAIDE	岩出
IWAJIRO	岩次郎
IWAKATA	岩片
IWAKAWA	岩川
IWAKI	岩城
IWAKICHI	岩吉
IWAKIRI	岩切
IWAKOSHI	岩越
IWAKUNI	岩国
IWAKURA	岩倉
IWAMA	岩間
IWAMARU	岩丸
IWAMATSU	岩松
IWAMI	厳実
IWAMIZAWA	岩見沢
IWAMORI	岩森
IWAMOTO	岩元
IWAMURA	岩村
IWAMURO	岩室
IWANADE	岩撫
IWANAGA	岩永
IWANAMI	岩波
IWANE	岩根
IWANO	岩野
IWANORI	岩典
IWANUMA	岩沼
IWAO	厳
IWAOKA	岩岡
IWASA	岩佐
IWASAKA	岩坂
IWASAKI	岩崎
IWASAWA	岩沢
IWASE	岩瀬
IWASHIMA	岩島
IWASHIRO	岩代
IWASHITA	岩下
IWATA	岩田
IWATANI	岩谷
IWATARU	岩垂
IWATATSU	岩立
IWATE	岩手
IWATO	岩戸
IWATSU	岩津
IWATSUBO	岩坪
IWATSUKI	岩月
IWAUCHI	岩内
IWAWAKI	岩脇
IWAZO	岩蔵
IYA	井谷
IYAMA	井山
IYO	伊世
IYODA	伊与田
IYOGI	五代儀
IYOKO	伊代子
IYOMISHIMA	伊予三島
IZAKI	井崎
IZAWA	伊沢
IZEKI	井関
IZU	伊豆
IZUHARA	厳原
IZUMI	出水
IZUMIDA	和泉田
IZUMIKAWA	泉川
IZUMIKO	泉子
IZUMIMOTO	泉本
IZUMIO	泉尾
IZUMIOTSU	泉大津
IZUMISANO	泉佐野
IZUMISAWA	和泉沢
IZUMIYA	泉谷
IZUMIYAMA	泉山
IZUMO	出雲
IZUMOZAKI	出雲崎
IZURU	出
IZUTSU	井筒
JAPAN	日本
JIAN	健
JIANG	将
JIANWU	健吾
JIANYI	健一
JIAO	角
JIAOYI	教一
JIBIKI	地引
JIE	節
JIHEI	治平
JIICHI	治一
JIN	仁
JIN'ICHI	仁一
JIN'ICHIRO	甚市郎
JINBA	神馬
JINBE	神部
JINBO	神保
JING	京
JINGJI	京吉
JINGPING	京平
JINGU	神宮
JINGUJI	神宮司
JINGYI	精一
JINJI	甚二
JINKICHI	仁吉
JINKO	仁子
JINNAI	陣内
JINNO	神農
JINNOCHI	陣内
JINPACHI	甚八
JINROKU	甚六
JINTARO	甚太郎
JINTO	神藤
JINUSHI	地主
JINWU	金吾
JINYI	晋一
JINZABURO	仁三郎
JINZANG	金蔵
JINZHI	金治
JINZO	仁三
JIRO	二朗
JISAKU	治作
JISUKE	治助
JITSUKATA	実方
JITSUKAWA	実川
JITSUKO	実子
JITSUO	実男
JITTOKU	拾得
JIUPING	久平
JIUZHI	久治
JIZANG	吉蔵
JO	丈
JOBOJI	浄法寺
JOETSU	上越
JOHANA	城端
JOHOKU	常北
JOJI	丈二
JOJIMA	城島
JOKICHI	城吉
JONAN	城南
JOSHIMA	城嶋
JOSUKE	譲介
JOTARO	丈太郎
JOYO	上陽
JU	菊
JUICHI	十一
JUJI	十司
JUJIRO	重次郎
JUKICHI	重吉
JUMONJI	十文字
JUN	俊
JUN'ICHI	淳一
JUN'ICHIRO	淳一郎
JUN'YA	淳哉
JUNA	樹奈
JUNGO	淳吾
JUNJI	淳司
JUNJIRO	潤二郎
JUNKICHI	順吉
JUNKO	旬子
JUNNOSUKE	淳之助
JUNPEI	淳平
JUNRO	淳郎
JUNTA	淳太
JUNZO	淳三
JUO	十王
JURI	朱理
JURO	重郎
JUSABURO	寿三郎
JUSAKU	十作
JUZO	重蔵
KABA	蒲
KABAHARA	蒲原
KABASAWA	樺沢
KABATA	加畑
KABAYAMA	樺山
KABE	加辺
KABETANI	壁谷
KABEYA	壁谷
KABUKI	蕪木
KABURAGI	冠城
KABUYAMA	蕪山
KACHIKO	勝子
KADA	加田
KADO	加登
KADOGUCHI	門口
KADOI	門井
KADOKAWA	角川
KADOKURA	角倉
KADOMA	門真
KADOMATSU	門松
KADONO	門野
KADOTA	角田
KADOWAKI	門脇
KADOYA	角屋
KAE	佳恵
KAEDE	楓
KAEKO	佳恵子
KAGA	加賀
KAGAMI	加賀美
KAGAMIISHI	鏡石
KAGAWA	加川
KAGAYA	加賀屋
KAGAYAMA	加賀山
KAGE	鹿毛
KAGEKI	景樹
KAGEO	影夫
KAGESAWA	影沢
KAGEYAMA	影山
KAGIMOTO	鍵本
KAGIWADA	鍵和田
KAGIYA	鍵谷
KAGIYAMA	鍵山
KAGOMIYA	篭宮
KAGOSHIMA	篭島
KAGOTANI	篭谷
KAHO	佳帆
KAHOKU	鹿北
KAHORI	佳保利
KAI	快
KAIBARA	貝原
KAIBE	海部
KAIBO	海保
KAICHI	嘉一
KAICHIRO	嘉一郎
KAIDA	会田
KAIDO	海藤
KAIEDA	海江田
KAIHEI	海平
KAIHO	海保
KAIICHI	開一
KAIJI	開次
KAIKI	海記
KAINO	海野
KAINUMA	海沼
KAIONJI	海音寺
KAISAWA	会沢
KAISE	海瀬
KAISHU	海舟
KAITA	貝田
KAITO	垣内
KAIYA	海谷
KAIZO	海造
KAIZU	海津
KAIZUKA	貝塚
KAJI	加地
KAJII	梶井
KAJIKAWA	梶川
KAJIKI	加治木
KAJIMA	梶間
KAJIMOTO	梶本
KAJIMURA	梶村
KAJINO	梶野
KAJISA	加治佐
KAJITA	梶田
KAJITANI	梶谷
KAJITSUKA	梶塚
KAJIURA	梶浦
KAJIWARA	梶原
KAJIYA	加治屋
KAJIYAMA	梶山
KAKAMIGAHARA	各務原
KAKEFUDA	掛札
KAKEGAWA	掛川
KAKEHASHI	梯
KAKEHI	筧
KAKEI	筧
KAKEYA	掛合
KAKIHARA	柿原
KAKIKI	柿木
KAKIMI	垣見
KAKIMOTO	垣本
KAKINOKI	柿木
KAKINUMA	柿沼
KAKITA	垣田
KAKITANI	柿谷
KAKIUCHI	垣内
KAKIZAKI	柿崎
KAKIZAWA	柿沢
KAKIZONO	柿園
KAKO	佳子
KAKOGAWA	加古川
KAKU	加来
KAKUBARI	角張
KAKUCHI	角地
KAKUDA	角田
KAKUDATE	角舘
KAKUEI	角栄
KAKUI	角井
KAKUKAWA	角川
KAKUKO	佳久子
KAKUMOTO	角本
KAKUNAMI	角南
KAKUNO	角野
KAKUNODATE	角館
KAKURA	鹿倉
KAKURAI	加倉井
KAKUTARO	角太郎
KAKUYA	角屋
KAKUYAMA	角山
KAKUYUKI	角幸
KAMACHI	蒲地
KAMAGATA	鎌形
KAMAHARA	鎌原
KAMAI	釜井
KAMAISHI	釜石
KAMAKARI	鎌苅
KAMAKURA	鎌倉
KAMANO	鎌野
KAMATA	蒲田
KAMATAKI	鎌滝
KAMATANI	釜谷
KAME	鹿目
KAMEDA	亀田
KAMEI	亀井
KAMEJI	亀次
KAMEJIMA	亀嶋
KAMEJIRO	亀次郎
KAMEKAWA	亀川
KAMEKICHI	亀吉
KAMEKURA	亀倉
KAMEMURA	亀村
KAMENOSUKE	亀之助
KAMEO	亀夫
KAMEOKA	亀岡
KAMETANI	亀谷
KAMETARO	亀太郎
KAMEYAMA	亀山
KAMEYO	亀代
KAMEZAWA	亀沢
KAMI	上
KAMIBE	神部
KAMICHI	上地
KAMIDE	上出
KAMIFUJI	神藤
KAMIFUKUOKA	上福岡
KAMIGAKI	上垣
KAMIGUCHI	上口
KAMIGYO	上京
KAMIHARA	上原
KAMIHIRA	上平
KAMII	上井
KAMIICHI	上市
KAMIISHI	上石
KAMIJIMA	上島
KAMIKAWA	上川
KAMIKAWACHI	上河内
KAMIKI	神気
KAMIKITA	上北
KAMIKO	神子
KAMIKUBO	上久保
KAMIKURA	上倉
KAMIMA	上間
KAMIMOTO	上本
KAMIMURA	神村
KAMINAGA	神永
KAMINAKA	上中
KAMINISHI	上西
KAMINO	神野
KAMINOKAWA	上三川
KAMINOYAMA	上山
KAMINUMA	上沼
KAMIO	神尾
KAMIOKA	神岡
KAMISAKA	上坂
KAMISATO	上里
KAMISAWA	神沢
KAMISHIMA	上島
KAMISHIRO	上代
KAMISU	神栖
KAMITA	上田
KAMITANI	上谷
KAMITONO	上遠野
KAMITSU	神津
KAMITSUKI	上月
KAMIURA	上浦
KAMIYA	上谷
KAMIYAMA	上山
KAMIYAMADA	上山田
KAMIYASU	上保
KAMO	加茂
KAMODA	鴨田
KAMOGAWA	鴨川
KAMOI	鴨井
KAMOSHIDA	鴨志田
KAMOSHITA	鴨下
KAMOTO	鹿本
KAMURA	加村
KAN	完
KAN'ICHI	勘一
KAN'ICHIRO	寛一郎
KAN'ONJI	観音寺
KANA	佳奈
KANABO	金棒
KANADA	金田
KANAE	佳奈枝
KANAEDA	金枝
KANAGAWA	神奈川
KANAGI	金木
KANAI	叶
KANAISHI	金石
KANAIZUMI	金泉
KANAKI	金木
KANAKO	佳名子
KANAKUBO	金久保
KANAMARU	金丸
KANAME	要
KANAMI	佳奈実
KANAMORI	金森
KANAMOTO	金本
KANAMURA	金村
KANAOKA	金岡
KANAOYA	金親
KANARI	佳奈利
KANASAGO	金砂郷
KANASAKA	金坂
KANASAKI	金崎
KANASUGI	金杉
KANAUCHI	金内
KANAUMI	金海
KANAWA	金輪
KANAYAMA	金山
KANAZAKI	金崎
KANAZAWA	金沢
KANBA	神庭
KANBARA	神原
KANBAYASHI	上林
KANBE	神戸
KANBEE	勘兵衛
KANBI	寛美
KANDA	神田
KANDACHI	神立
KANDO	菅藤
KANEBAKO	金箱
KANEDA	兼田
KANEDAKA	金高
KANEHARA	金原
KANEHARU	兼春
KANEHIKO	鐘彦
KANEHIRA	兼平
KANEHIRO	兼弘
KANEKAWA	金川
KANEKI	金木
KANEKICHI	兼吉
KANEKO	兼古
KANEMAKI	金巻
KANEMARU	金丸
KANEMATSU	兼松
KANEMITSU	兼光
KANEMOTO	金本
KANEMURA	金村
KANENARI	金成
KANENO	金野
KANENORI	兼典
KANEO	兼夫
KANESAKA	兼坂
KANESAKI	金崎
KANESASHI	金刺
KANESHIGE	金重
KANESHIMA	金島
KANETOSHI	兼敏
KANETSU	金津
KANETSUKA	金塚
KANETSUNA	金綱
KANEUCHI	金内
KANEYA	金谷
KANEYAMA	金山
KANEYASU	金安
KANEYOSHI	金義
KANEYUKI	金幸
KANEZASHI	金刺
KANG	康
KANGO	勘吾
KANGPING	康平
KANI	可児
KANIE	蟹江
KANITA	蟹田
KANJI	勘治
KANJU	完寿
KANKE	菅家
KANKI	神吉
KANNA	柑奈
KANNARI	神成
KANNO	管野
KANO	加納
KANOCHI	叶内
KANOKO	佳乃子
KANOSE	鹿瀬
KANOYA	鹿屋
KANRA	甘楽
KANSAKU	神作
KANTA	寛太
KANTARO	勘太郎
KANTO	関東
KANUMA	鹿沼
KANZAKI	神埼
KANZAN	寒山
KANZO	勘蔵
KAO	佳緒
KAOHSIUNG	高雄
KAOKO	香子
KAORI	佳央理
KAORU	彪
KAORUKO	薫子
KARAHASHI	唐橋
KARAKAMA	唐鎌
KARAKAWA	唐川
KARAKI	唐木
KARAKIDA	唐木田
KARAMATSU	唐松
KARASAWA	唐沢
KARASHIMA	辛島
KARASUYAMA	烏山
KARATANI	柄谷
KARATSU	唐津
KARAYA	柄谷
KARIBE	刈部
KARINA	香利奈
KARINO	狩野
KARITA	刈田
KARIYA	仮屋
KARUBE	軽部
KARUIZAWA	軽井沢
KARUMAI	軽米
KASAGAWA	笠川
KASAGI	笠木
KASAHARA	笠原
KASAI	加西
KASAJIMA	笠島
KASAKAKE	笠懸
KASAKI	笠木
KASAKURA	笠倉
KASAMA	笠間
KASAMATSU	笠松
KASANO	笠野
KASAOKA	笠岡
KASATANI	笠谷
KASE	加瀬
KASEDA	加世田
KASEYA	加瀬谷
KASHIBA	香芝
KASHIHARA	柏原
KASHIMA	加島
KASHIMADA	鹿島田
KASHIMADAI	鹿島台
KASHIMOTO	樫本
KASHIMURA	柏村
KASHINO	樫野
KASHIWA	柏
KASHIWABA	柏葉
KASHIWADA	柏田
KASHIWAGI	柏木
KASHIWAI	柏井
KASHIWAKUMA	柏熊
KASHIWAKURA	柏倉
KASHIWAMURA	柏村
KASHIWARA	柏原
KASHIWASE	柏瀬
KASHIWATANI	柏谷
KASHIWAYA	柏谷
KASHIWAZAKI	柏崎
KASHIYAMA	樫山
KASORI	加曽利
KASUGA	春日
KASUGAI	春日井
KASUKABE	春日部
KASUKAWA	粕川
KASUMI	佳澄
KASUYA	粕屋
KATA	加田
KATABAMI	方波見
KATABUCHI	片淵
KATADA	堅田
KATAGAI	片貝
KATAGAMI	片上
KATAGIRI	片桐
KATAGISHI	片岸
KATAHIRA	片平
KATAI	片井
KATAKURA	片倉
KATAMOTO	片本
KATANE	片根
KATANIWA	片庭
KATANO	交野
KATAOKA	片岡
KATASE	片瀬
KATAYAMA	形山
KATAYANAGI	片柳
KATAYORI	片寄
KATO	加登
KATOGI	加藤木
KATORI	香取
KATSU	勝
KATSUAKI	克明
KATSUBE	勝部
KATSUE	克恵
KATSUHARA	勝原
KATSUHARU	克春
KATSUHATA	勝旗
KATSUHIDE	克秀
KATSUHIKO	克彦
KATSUHIRO	克博
KATSUHISA	克久
KATSUHITO	勝人
KATSUI	勝井
KATSUICHI	克一
KATSUJI	克二
KATSUJIRO	勝次郎
KATSUKAWA	勝川
KATSUKI	克喜
KATSUKO	佳津子
KATSUKURA	勝倉
KATSUMA	勝間
KATSUMASA	克昌
KATSUMATA	勝亦
KATSUME	勝目
KATSUMI	佳津美
KATSUMORI	勝盛
KATSUMOTO	勝元
KATSUMURA	勝村
KATSUNARI	勝也
KATSUNO	勝野
KATSUNOBU	勝伸
KATSUNORI	克典
KATSUNOSHIN	勝之進
KATSUNOSUKE	勝之助
KATSUNUMA	勝沼
KATSUO	克夫
KATSUOGI	鰹木
KATSURA	勝浦
KATSURADA	桂田
KATSURAGAWA	桂川
KATSURAGI	桂木
KATSURAKO	桂子
KATSURAYAMA	葛山
KATSURO	克朗
KATSUSABURO	勝三朗
KATSUSAWA	勝沢
KATSUSHI	克史
KATSUSHIGE	勝重
KATSUSHIKA	葛飾
KATSUSHIMA	勝島
KATSUSHIRO	勝四郎
KATSUSUKE	勝亮
KATSUTA	勝田
KATSUTAKA	勝孝
KATSUTANI	勝谷
KATSUTARO	勝太郎
KATSUTO	克人
KATSUTOSHI	克俊
KATSUYA	克也
KATSUYAMA	勝山
KATSUYASU	勝康
KATSUYO	克代
KATSUYOSHI	克吉
KATSUYUKI	克之
KATSUZO	克三
KAWA	川
KAWABATA	川畑
KAWABE	川辺
KAWABUCHI	川淵
KAWACHI	川地
KAWACHINAGANO	河内長野
KAWADA	川田
KAWADE	川出
KAWAGISHI	川岸
KAWAGOE	川越
KAWAGUCHI	川口
KAWAGUCHIKO	河口湖
KAWAHARA	川原
KAWAHARADA	河原田
KAWAHASHI	川橋
KAWAHATA	川畑
KAWAHIGASHI	川東
KAWAHIRA	川平
KAWAI	川井
KAWAIDE	川出
KAWAJI	川路
KAWAJIMA	川島
KAWAJIRI	川尻
KAWAKAMI	川上
KAWAKATSU	川勝
KAWAKITA	川北
KAWAKUBO	川久保
KAWAMATA	川俣
KAWAMATSU	川松
KAWAMI	川見
KAWAMINAMI	河南
KAWAMORI	川森
KAWAMORITA	川守田
KAWAMOTO	川元
KAWAMUKI	川向
KAWAMURA	川村
KAWANA	川名
KAWANABE	川鍋
KAWANAKA	川中
KAWANAMI	川波
KAWANISHI	川西
KAWANO	川野
KAWANOBE	川野辺
KAWANOE	川之江
KAWAOKA	川岡
KAWARA	香春
KAWARADA	川原田
KAWARAI	河原井
KAWARAZAKI	河原崎
KAWASAKI	川崎
KAWASATO	川里
KAWASE	川瀬
KAWASHIMA	川島
KAWASHITA	川下
KAWASOE	川副
KAWASUMI	川住
KAWATANI	川谷
KAWATE	川手
KAWATO	川人
KAWAUCHI	川内
KAWAURA	川浦
KAWAWA	川和
KAWAWADA	川和田
KAWAYA	川谷
KAWAZOE	川副
KAWAZU	川津
KAWAZURA	川面
KAYA	佳也
KAYABA	榧場
KAYAKO	佳也子
KAYAMA	加山
KAYAMORI	萱森
KAYANO	茅野
KAYANUMA	萱沼
KAYASHIMA	茅島
KAYO	佳世
KAYOKO	佳与子
KAYOMI	佳代美
KAZA	風
KAZAMA	風間
KAZAMATSURI	風祭
KAZAMI	風見
KAZAOKA	風岡
KAZATO	風戸
KAZAWA	賀沢
KAZO	加須
KAZU	和
KAZUAKI	一彰
KAZUCHIKA	一親
KAZUE	一恵
KAZUEI	一栄
KAZUFUMI	一文
KAZUHARU	一春
KAZUHEI	和平
KAZUHIDE	一秀
KAZUHIKO	一彦
KAZUHIRA	一平
KAZUHIRO	一博
KAZUHISA	一久
KAZUHITO	一人
KAZUHO	一歩
KAZUICHI	一一
KAZUJI	一二
KAZUKI	一喜
KAZUKIYO	一清
KAZUKO	一子
KAZUMA	一真
KAZUMASA	一将
KAZUMI	一三
KAZUMICHI	一路
KAZUMITSU	一光
KAZUMORI	一守
KAZUNARI	一也
KAZUNE	和音
KAZUNO	数野
KAZUNOBU	一伸
KAZUNORI	一典
KAZUO	一夫
KAZUOMI	一臣
KAZURO	和郎
KAZUSA	加津佐
KAZUSHI	一司
KAZUSHIGE	一成
KAZUTAKA	一孝
KAZUTAMI	一民
KAZUTERU	一輝
KAZUTO	一人
KAZUTOMI	万富
KAZUTOMO	一智
KAZUTOSHI	一俊
KAZUTOYO	一豊
KAZUTSUGU	一継
KAZUYA	一也
KAZUYO	一世
KAZUYORI	和頼
KAZUYOSHI	一吉
KAZUYUKI	一之
KEBUKAWA	癸生川
KEI	佳
KEIDA	慶田
KEIGO	啓五
KEIHACHI	敬八
KEIHO	啓輔
KEIICHI	啓一
KEIICHIRO	啓一郎
KEIJI	啓之
KEIJIRO	啓二朗
KEIJU	圭樹
KEIKI	慶喜
KEIKICHI	啓吉
KEIKO	佳子
KEINO	慶野
KEINOSUKE	圭之助
KEIRA	計良
KEIREI	恵玲
KEISAKU	啓作
KEISEN	桂川
KEISHI	啓之
KEISHIRO	慶四郎
KEISUKE	佳介
KEITA	啓太
KEITARO	啓太朗
KEIYA	佳哉
KEIZABURO	啓三郎
KEIZO	啓三
KEMUYAMA	煙山
KEN	健
KEN'ICHI	健一
KEN'ICHIRO	健一朗
KEN'YA	健也
KENGO	健吾
KENJI	健之
KENJIRO	健二郎
KENJU	憲寿
KENKICHI	健吉
KENMOCHI	剣持
KENMOKU	見目
KENNOSUKE	健之助
KENRO	健朗
KENSAKU	健作
KENSHI	健之
KENSHIN	健信
KENSUKE	健介
KENTA	健太
KENTARO	健太郎
KENTO	賢人
KENZABURO	健三郎
KENZO	健三
KESAE	今朝恵
KESAJI	今朝治
KESAO	今朝夫
KESENNUMA	気仙沼
KESHI	芥子
KEZUKA	毛塚
KIBA	木場
KIBE	木部
KIBUNE	木船
KIBUSE	木伏
KICHIBEE	吉兵衛
KICHIGORO	吉五郎
KICHIJI	吉次
KICHIMATSU	吉松
KICHINOSUKE	吉之助
KICHIO	吉夫
KICHIRO	吉郎
KICHISE	吉瀬
KICHITARO	吉太郎
KICHIYA	吉弥
KICHIZO	吉蔵
KIDA	喜田
KIDACHI	木立
KIDERA	木寺
KIDO	城戸
KIDOGUCHI	木戸口
KIDOKORO	城所
KIE	喜恵
KIEKO	喜恵子
KIGA	木賀
KIGASAWA	気賀沢
KIGAWA	木川
KIGOSHI	木越
KIGUCHI	木口
KIGURE	木暮
KIHACHI	喜八
KIHACHIRO	喜八郎
KIHARA	木原
KIHATA	木幡
KIHEE	喜兵衛
KIHEI	喜兵衛
KIHEIJI	紀兵二
KIHIRA	紀平
KIICHI	喜一
KIICHIRO	喜一郎
KIJIMA	木島
KIKEGAWA	亀掛川
KIKO	紀子
KIKU	菊
KIKUCHI	菊地
KIKUCHIHARA	菊地原
KIKUE	喜久恵
KIKUHARA	菊原
KIKUHARU	菊春
KIKUI	菊井
KIKUIRI	菊入
KIKUJI	喜久治
KIKUJIRO	菊次郎
KIKUKA	菊鹿
KIKUKAWA	菊川
KIKUKO	喜久子
KIKUMA	菊間
KIKUMATSU	菊松
KIKUMI	喜久実
KIKUMOTO	菊本
KIKUNO	菊野
KIKUO	喜久夫
KIKUOKA	菊岡
KIKUSABURO	菊三朗
KIKUSHIMA	菊島
KIKUSUI	菊水
KIKUTA	菊田
KIKUTANI	菊谷
KIKUTARO	菊太郎
KIKUYA	菊谷
KIKUYAMA	菊山
KIKUYO	亀久代
KIKUZAWA	菊沢
KIKUZO	菊蔵
KIMA	木間
KIMATA	木俣
KIMI	君
KIMIAKI	公明
KIMIE	公恵
KIMIHIDE	公秀
KIMIHIKO	公彦
KIMIHIRO	公博
KIMIHISA	公久
KIMIHITO	公人
KIMIJIMA	君島
KIMIKA	君香
KIMIKAZU	公一
KIMIKICHI	君吉
KIMIKO	亀美子
KIMINARI	公成
KIMINOBU	公信
KIMINORI	公典
KIMIO	公夫
KIMITAKA	公孝
KIMITO	公人
KIMITOSHI	公俊
KIMITSU	君津
KIMIWADA	君和田
KIMIYA	公也
KIMIYASU	公康
KIMIYO	公代
KIMIYOSHI	公佳
KIMIZUKA	君塚
KIMORI	喜盛
KIMOTO	木元
KIMURA	木村
KIN	欣
KIN'ICHI	欣一
KIN'ICHIRO	欣一郎
KIN'YA	勤也
KINAI	箭内
KINAMI	木南
KINBARA	金原
KINDA	金田
KINEBUCHI	木根淵
KINEYA	杵屋
KINGO	欣吾
KINGORO	金五郎
KINJI	均治
KINJIRO	謹治郎
KINKO	欽子
KINNO	金野
KINNOSUKE	欽之助
KINO	木野
KINOCHI	木野内
KINOSHITA	木下
KINOSUKE	喜之助
KINPEI	金平
KINSABURO	金三郎
KINSAKU	金作
KINSHICHI	金七
KINSHIRO	金四郎
KINSUKE	金助
KINTARO	金太郎
KINU	絹
KINUE	絹恵
KINUGASA	衣笠
KINUGAWA	絹川
KINUKO	絹子
KINUYAMA	絹山
KINUYO	絹世
KINZABURO	金三郎
KINZO	金三
KIOKA	木岡
KIRA	吉良
KIRIE	希里江
KIRIHARA	桐原
KIRIKO	季理子
KIRINO	桐野
KIRISHIMA	桐島
KIRITA	桐田
KIRITANI	桐谷
KIRIYA	桐谷
KIRIYAMA	桐山
KIRO	喜郎
KIROKU	喜六
KIRYU	桐生
KISABURO	吉三郎
KISAE	季佐恵
KISAI	騎西
KISAKATA	象潟
KISAKU	喜作
KISANUKI	木佐貫
KISAO	喜三男
KISARA	木皿
KISARAGI	如月
KISARAZU	木更津
KISAWA	鬼沢
KISE	木瀬
KISEKO	貴世子
KISHI	岸
KISHIBE	岸部
KISHICHI	喜七
KISHICHIRO	喜七郎
KISHIDA	岸田
KISHIGAMI	岸上
KISHIHARA	岸原
KISHII	岸井
KISHIKAWA	岸川
KISHIKO	季史子
KISHIMA	貴島
KISHIMOTO	岸本
KISHINAMI	岸波
KISHINO	岸野
KISHIO	喜司夫
KISHIOKA	岸岡
KISHIRO	喜四郎
KISHISHITA	岸下
KISHIWADA	岸和田
KISO	木曽
KISOFUKUSHIMA	木曽福島
KISUKE	喜助
KITA	北
KITABAYASHI	北林
KITADA	北田
KITADATE	北舘
KITADE	北出
KITAGAKI	北垣
KITAGATA	北方
KITAGAWA	北川
KITAGISHI	北岸
KITAGO	北郷
KITAGUCHI	北口
KITAHAMA	北浜
KITAHARA	北原
KITAHATA	北畑
KITAHIROSHIMA	北広島
KITAHORI	北堀
KITAI	北井
KITAIBARAKI	北茨城
KITAIDE	北出
KITAIKE	北池
KITAIWAI	北祝
KITAJIMA	北島
KITAKA	橘高
KITAKAMI	北上
KITAKATA	北方
KITAKAWABE	北川辺
KITAKO	喜多子
KITAKUBO	北久保
KITAKYUSHU	北九州
KITAMI	北見
KITAMORI	北森
KITAMOTO	北本
KITAMURA	北村
KITANAKA	北中
KITANI	木谷
KITANISHI	北西
KITANO	北埜
KITAO	北尾
KITAOKA	北岡
KITARO	喜太郎
KITATANI	北谷
KITATSUME	北爪
KITAUCHI	北内
KITAUE	北上
KITAURA	北浦
KITAWAKI	北脇
KITAYA	北谷
KITAYAMA	北山
KITAZAKI	北崎
KITAZATO	北里
KITAZAWA	北沢
KITAZONO	北園
KITAZUME	北爪
KITO	木藤
KITSUDAKA	橘高
KITSUGI	木次
KITSUKI	杵築
KITSUNAI	橘内
KITSUREGAWA	喜連川
KITTA	橘田
KIUCHI	木内
KIURA	木浦
KIWA	喜和
KIWAKO	喜和子
KIWAMU	極
KIYA	木屋
KIYAMA	帰山
KIYASU	喜安
KIYO	喜世
KIYOAKI	清明
KIYODA	喜代田
KIYOE	季代恵
KIYOFUJI	清藤
KIYOFUMI	清文
KIYOHARA	清原
KIYOHARU	清春
KIYOHIDE	喜代秀
KIYOHIKO	喜代彦
KIYOHIRO	清宏
KIYOHISA	清久
KIYOHITO	清仁
KIYOJI	喜代二
KIYOKA	清岡
KIYOKATSU	清勝
KIYOKAWA	清川
KIYOKAZU	清一
KIYOKI	清貴
KIYOKO	喜世子
KIYOKUMA	清熊
KIYOMA	清磨
KIYOMASA	清昌
KIYOMATSU	喜代松
KIYOMI	公世美
KIYOMITSU	清光
KIYOMIYA	清宮
KIYOMOTO	清本
KIYONARI	清成
KIYONO	清野
KIYONOBU	喜代信
KIYONORI	清則
KIYOSAWA	清沢
KIYOSE	清瀬
KIYOSHI	亮
KIYOSHIGE	清茂
KIYOSHIMA	清嶋
KIYOSHIRO	清志郎
KIYOTA	清田
KIYOTAKA	喜代隆
KIYOTAKE	清武
KIYOTERU	清照
KIYOTO	清人
KIYOTOSHI	清俊
KIYOTSUGU	喜代継
KIYOTSUKA	清塚
KIYOYUKI	清之
KIYOZO	喜代造
KIZAKI	木崎
KIZASHI	萌
KIZAWA	木沢
KIZO	喜蔵
KIZU	木津
KIZUKA	木塚
KIZUKURI	木造
KO	光
KOAMI	小網
KOANA	小穴
KOBA	木場
KOBARI	小針
KOBASHI	小橋
KOBAYAKAWA	小早川
KOBAYASHI	古林
KOBE	神戸
KOBI	小尾
KOBINATA	小日向
KOBITSU	小櫃
KOBORI	小堀
KOBUNA	小鮒
KOBUNE	小船
KOCHI	小内
KODA	古宇田
KODACHI	小太刀
KODAIRA	小平
KODAKA	小高
KODAMA	児玉
KODATE	小舘
KODERA	古寺
KODO	古藤
KOEDA	小枝
KOEI	幸衛
KOENUMA	肥沼
KOETSU	光悦
KOFU	甲府
KOFUJI	小藤
KOGA	古河
KOGAI	小貝
KOGANEI	小金井
KOGANEZAWA	小金沢
KOGATA	小方
KOGAWA	古川
KOGI	小木
KOGISO	小木曽
KOGO	向後
KOGOSHI	小越
KOGUCHI	古口
KOGURE	小暮
KOGUSURI	小薬
KOHACHI	幸八
KOHAMA	小浜
KOHARI	小張
KOHARU	小春
KOHASE	小長谷
KOHASHI	小橋
KOHEI	光平
KOHIGASHI	小東
KOHINATA	小日向
KOHIRA	古平
KOHIYAMA	小桧山
KOIBUCHI	鯉淵
KOICHI	光一
KOICHIRO	光一郎
KOIDE	小出
KOIDO	小井土
KOIKE	古池
KOIKO	恋子
KOINOSUKE	鯉之助
KOINUMA	鯉沼
KOISHI	小石
KOISHIKAWA	小石川
KOISO	小磯
KOITABASHI	小板橋
KOITO	小糸
KOIWA	小岩
KOIWAI	小岩井
KOIZUMI	古泉
KOJI	光二
KOJIKA	小鹿
KOJIMA	児島
KOJIRO	光次郎
KOJUN	孝順
KOKABU	古株
KOKABUTO	小甲
KOKAI	小海
KOKAJI	小梶
KOKAN	古閑
KOKATA	国府方
KOKATSU	小勝
KOKAWA	古川
KOKETSU	纐纈
KOKI	光喜
KOKICHI	好吉
KOKO	公子
KOKONOE	九重
KOKORO	心
KOKUBO	小久保
KOKUBU	国分
KOKUBUNJI	国分寺
KOKUFU	国府
KOKUHO	国保
KOKUNI	小国
KOKURAKITA	小倉北
KOKURAMINAMI	小倉南
KOMA	小間
KOMABA	駒場
KOMACHI	小町
KOMADA	駒田
KOMAE	狛江
KOMAGATA	駒形
KOMAI	駒井
KOMAKI	小牧
KOMAKINE	駒木根
KOMAMIYA	駒宮
KOMAMURA	駒村
KOMANO	駒野
KOMATA	古俣
KOMATANI	駒谷
KOMATSU	小松
KOMATSUBARA	小松原
KOMATSUDA	小松田
KOMATSUSHIMA	小松島
KOMATSUZAKI	小松崎
KOMAYA	駒谷
KOMAZAKI	駒崎
KOMAZAWA	駒沢
KOMECHI	古明地
KOMEHANA	米花
KOMEI	孔明
KOMEOKA	米岡
KOMETA	米田
KOMETANI	米谷
KOMEZAKI	米崎
KOMI	小見
KOMINAMI	小南
KOMINATO	小湊
KOMINE	小峰
KOMINO	小美濃
KOMITO	小見戸
KOMIYA	古宮
KOMIYAMA	小宮山
KOMODA	菰田
KOMOIKE	菰池
KOMORI	古森
KOMORITANI	小森谷
KOMORIYA	小森谷
KOMORO	小師
KOMOTA	小茂田
KOMUKAI	小向
KOMURA	古村
KOMURO	古室
KON	今
KON'YA	紺谷
KONAGAI	小長井
KONAGAYA	小長谷
KONAKA	小中
KONAKAWA	粉川
KONAMI	小南
KONAN	江南
KONATSU	小夏
KONDA	根田
KONDO	近藤
KONISHI	古西
KONITA	小荷田
KONNAI	近内
KONNO	今野
KONO	幸野
KONOHANA	此花
KONOIKE	鴻池
KONOMI	好
KONOSU	鴻巣
KONOSUKE	光之助
KONOURA	金浦
KONPIRA	金比羅
KONSHIRO	今四郎
KONTANI	紺谷
KONUMA	小沼
KORA	小浦
KOREEDA	是枝
KOREKIYO	是清
KORENAGA	是永
KORESAWA	是澤
KORI	桑折
KORIYAMA	郡山
KOSA	甲佐
KOSABURO	幸三郎
KOSAI	湖西
KOSAKA	小坂
KOSAKAI	小坂井
KOSAKI	小崎
KOSAKU	光作
KOSE	古瀬
KOSEI	公生
KOSEKI	古関
KOSHI	合志
KOSHIBA	小柴
KOSHIDA	越田
KOSHIDAKA	腰高
KOSHIGAYA	越谷
KOSHIGOE	腰越
KOSHIHARA	腰原
KOSHIISHI	越石
KOSHIJI	越路
KOSHIKAWA	越川
KOSHIMIZU	小清水
KOSHIMOTO	越本
KOSHIMURA	越村
KOSHINAKA	越中
KOSHINO	越野
KOSHINUMA	越沼
KOSHIO	小塩
KOSHIRO	小四郎
KOSHITSUKA	腰塚
KOSHIYAMA	越山
KOSHIZUKA	腰塚
KOSHO	公章
KOSHOKU	更埴
KOSONE	小曽根
KOSONO	小園
KOSUDA	小須田
KOSUDO	小須戸
KOSUGA	小菅
KOSUGE	小管
KOSUGI	小杉
KOSUKE	光助
KOSUKEGAWA	小助川
KOTA	光太
KOTABE	小田部
KOTACHI	小太刀
KOTADO	古田土
KOTAJIMA	古田島
KOTAKA	小鷹
KOTAKE	小竹
KOTAKI	小滝
KOTANI	小谷
KOTARO	光太郎
KOTEGAWA	古手川
KOTO	古藤
KOTOE	琴恵
KOTOHARU	士美
KOTOKA	琴丘
KOTOKO	琴子
KOTOKU	光徳
KOTOMI	古都美
KOTONO	琴乃
KOTOYO	琴世
KOTSUKI	高月
KOUMI	小海
KOWADA	小和田
KOWASHI	毅
KOWATA	木幡
KOWATARI	古渡
KOYA	古矢
KOYADA	小谷田
KOYAMA	光山
KOYANAGI	小柳
KOYANO	古谷野
KOYASU	子安
KOYAZU	小谷津
KOYO	光洋
KOYU	紘雄
KOYUKI	小雪
KOYURU	越
KOZABURO	好三郎
KOZAKAI	小堺
KOZAKI	小崎
KOZO	光三
KOZONO	小園
KOZU	河津
KOZUE	梢
KOZUKA	小塚
KOZUKI	上月
KOZUTSUMI	小堤
KUAI	快
KUBO	久保
KUBODERA	久保寺
KUBOI	久保井
KUBOKAWA	久保川
KUBOKI	久保木
KUBOMURA	久保村
KUBONIWA	久保庭
KUBONO	久保埜
KUBOSHIMA	窪島
KUBOTA	久保田
KUBOYA	久保谷
KUBOYAMA	久保山
KUCHIKI	朽木
KUDAMATSU	下松
KUDO	工藤
KUGA	久我
KUGE	久下
KUGIMIYA	釘宮
KUGIMOTO	釘本
KUGO	久郷
KUHARA	久原
KUI	魁
KUJI	久慈
KUJIMA	久島
KUJIRAI	鯨井
KUJIRAOKA	鯨岡
KUJU	久住
KUJUKURI	九十九里
KUKI	久喜
KUKIKO	久喜子
KUKIZAKI	茎崎
KUMABE	隈武
KUMAGAI	熊谷
KUMAGAYA	熊谷
KUMAHARU	隈晴
KUMAI	熊井
KUMAKAWA	熊川
KUMAKI	熊木
KUMAKIRI	熊切
KUMAKURA	熊倉
KUMAMOTO	熊本
KUMANO	熊野
KUMAO	熊夫
KUMASAKA	熊坂
KUMASAKI	熊崎
KUMASAWA	熊沢
KUMASHIRO	熊代
KUMATA	熊田
KUMATANI	熊谷
KUMAZAKI	熊崎
KUMAZAWA	熊沢
KUMAZO	熊三
KUME	久米
KUMEDA	久米田
KUMEKAWA	粂川
KUMENO	粂野
KUMI	久実
KUMIDA	汲田
KUMIE	久美恵
KUMIKO	久実子
KUMIO	久美夫
KUMIYO	久美代
KUMON	公文
KUMOTO	久本
KUN	昆
KUNIAKI	国明
KUNIE	久仁恵
KUNIEDA	国枝
KUNIHARA	国原
KUNIHARU	邦治
KUNIHEI	国平
KUNIHIDE	邦秀
KUNIHIKO	国彦
KUNIHIRO	国博
KUNIHISA	邦久
KUNIHITO	国人
KUNII	国井
KUNIICHI	国一
KUNIICHIRO	国一郎
KUNIJI	邦治
KUNIKATA	国方
KUNIKAZU	邦一
KUNIKO	久仁子
KUNIMATSU	国松
KUNIMI	国見
KUNIMITSU	国光
KUNIMOTO	国本
KUNIO	久仁夫
KUNIOKA	国岡
KUNIRO	邦郎
KUNISADA	国定
KUNISAKI	国崎
KUNISAWA	国沢
KUNISHIGE	国重
KUNISHIMA	国島
KUNITA	国田
KUNITACHI	国立
KUNITAKA	邦孝
KUNITANI	国谷
KUNITARO	国太郎
KUNITERU	国照
KUNITOMI	国冨
KUNITOMO	国友
KUNITOSHI	国俊
KUNITSUGU	邦次
KUNIWAKE	国分
KUNIYA	国谷
KUNIYASU	国安
KUNIYO	邦代
KUNIYOSHI	国吉
KUNIYUKI	国之
KUNJI	勲二
KUNO	久能
KUNUGI	功刀
KURABAYASHI	倉林
KURABE	倉部
KURACHI	倉地
KURAGAMI	倉上
KURAGANE	倉金
KURAHASHI	倉橋
KURAI	倉井
KURAISHI	倉石
KURAKATA	倉方
KURAKICHI	倉吉
KURAKO	倉子
KURAMAE	倉前
KURAMATA	倉又
KURAMI	倉実
KURAMITSU	倉光
KURAMOCHI	倉持
KURAMOTO	倉元
KURANO	蔵野
KURANOSUKE	倉之助
KURAOKA	倉岡
KURASAKI	倉崎
KURASAWA	倉沢
KURASHIGE	倉繁
KURASHIKI	倉敷
KURASHIMA	倉島
KURASHINA	倉品
KURATA	倉田
KURATAKE	倉岳
KURATANI	倉谷
KURATE	鞍手
KURATOMI	倉冨
KURAUCHI	倉内
KURAYA	倉谷
KURAYOSHI	倉吉
KURAZO	倉蔵
KURE	呉
KUREBAYASHI	榑林
KUREMATSU	榑松
KUREMOTO	呉本
KURIBAYASHI	栗林
KURIHARA	栗原
KURIHASHI	栗橋
KURIKI	栗城
KURIKO	久里子
KURIKOMA	栗駒
KURIMATA	栗又
KURIMOTO	栗本
KURIMURA	栗村
KURIOKA	栗岡
KURISAKI	栗崎
KURISHIMA	栗島
KURISU	栗栖
KURITA	栗田
KURITANI	栗谷
KURIU	栗生
KURIYA	栗谷
KURIYAMA	栗山
KURO	黒尾
KUROBANE	黒羽
KUROBE	黒部
KURODA	黒田
KUROE	黒江
KUROGI	黒木
KUROHA	黒羽
KUROHANE	黒羽
KUROI	黒井
KUROISHI	黒石
KUROISO	黒磯
KUROIWA	黒岩
KUROKAWA	黒川
KUROKI	黒木
KUROKO	黒子
KUROKOCHI	黒河内
KURONO	黒野
KURONUMA	黒沼
KUROSAKA	黒坂
KUROSAKI	黒崎
KUROSAWA	黒沢
KUROSE	黒瀬
KUROSHIMA	黒島
KUROSU	黒巣
KUROSUMI	黒住
KUROTAKI	黒滝
KUROTANI	黒谷
KUROYANAGI	畔柳
KUROZUMI	黒住
KURUMA	車
KURUMADA	車田
KURUMADANI	車谷
KURUMATANI	車谷
KURUME	久留米
KURUMI	久瑠美
KURUSU	来栖
KUSABA	草場
KUSACHI	草地
KUSAFUKA	草深
KUSAJIMA	草島
KUSAKA	日下
KUSAKABE	日下部
KUSAKARI	草刈
KUSAKAWA	草川
KUSAKI	草木
KUSAMA	日馬
KUSANAGI	草薙
KUSANO	草野
KUSATSU	草津
KUSAYAGI	草柳
KUSAYANAGI	草柳
KUSHIBIKI	櫛引
KUSHIDA	串田
KUSHIGATA	櫛形
KUSHIHIKI	櫛引
KUSHIKINO	串木野
KUSHIMA	串間
KUSHIRO	久代
KUSU	玖珠
KUSUDA	楠田
KUSUHARA	楠原
KUSUI	楠井
KUSUKI	楠木
KUSUME	楠目
KUSUMI	久住
KUSUMOTO	楠元
KUSUNOKI	楠
KUSUNOSE	楠瀬
KUSUO	九州男
KUSUSE	楠瀬
KUSUYAMA	楠山
KUTSUKAKE	沓掛
KUTSUMA	久津間
KUTSUWADA	轡田
KUTSUZAWA	沓沢
KUWABARA	桑原
KUWAHATA	桑畑
KUWAJIMA	桑島
KUWAKI	桑木
KUWAKO	桑子
KUWAMOTO	桑本
KUWAMURA	桑村
KUWANA	桑名
KUWANO	桑野
KUWASAWA	桑沢
KUWASHIMA	桑島
KUWATA	桑田
KUWAYAMA	桑山
KUYAMA	久山
KUZE	久世
KUZU	葛生
KUZUHARA	葛原
KUZUMAKI	葛巻
KUZUMOTO	葛本
KUZUO	葛生
KUZUOKA	葛岡
KYO	京
KYOA	興亜
KYOGO	恭吾
KYOHEI	享平
KYOICHI	亨一
KYOICHIRO	京一郎
KYOJI	境二
KYOKA	京香
KYOKICHI	京吉
KYOKO	亨子
KYOKUTARO	極太郎
KYONAN	鋸南
KYOSHI	享史
KYOSUKE	匡輔
KYOTA	京太
KYOTANABE	京田辺
KYOTO	京都
KYOWA	協和
KYOZABURO	教三郎
KYUGO	久伍
KYUHEI	久平
KYUICHI	久一
KYUJI	久二
KYUKICHI	久吉
KYURAGI	厳木
KYUSAKU	久作
KYUSHIRO	久四郎
KYUSHU	九州
KYUTARO	久太郎
KYUZABURO	久三郎
KYUZO	久三
LANG	朗
LI	李
LIAN	廉
LIANG	亮
LIANGJI	亮吉
LIANGPING	亮平
LIHUA	麗華
LIJIA	麗佳
LING	令
LINGHUA	玲華
LIPING	利平
LIU	留
LONG	竜
MAAKO	真亜子
MABE	間部
MABUCHI	間淵
MACHI	万智
MACHIDA	町田
MACHIE	町枝
MACHIGIRI	町切
MACHII	町井
MACHIJIMA	町島
MACHIKO	万知子
MACHINO	町野
MACHIYAMA	待山
MACHIYO	町代
MADOKA	円
MADOKORO	間所
MADONO	真殿
MAE	前
MAEBARU	前原
MAEBASHI	前橋
MAEBAYASHI	前林
MAEDA	前田
MAEHARA	前原
MAEHATA	前畑
MAEJIMA	前島
MAEKAWA	前川
MAEMI	万恵美
MAEMURA	前村
MAENAKA	前中
MAENISHI	前西
MAENO	前野
MAEOKA	前岡
MAESAKA	前坂
MAESAKI	前崎
MAESATO	前里
MAEYAMA	前山
MAEZAWA	前沢
MAFUNE	真船
MAGAMI	馬上
MAGARA	真柄
MAGARIBUCHI	曲淵
MAGARIYAMA	曲山
MAGOME	馬篭
MAGOSHI	馬越
MAHA	万葉
MAHITO	真人
MAHO	真保
MAHOKA	真帆香
MAHOKO	真帆子
MAI	真唯
MAIDA	米田
MAIE	真家
MAIKA	真衣香
MAIKO	摩衣子
MAIZURU	舞鶴
MAJIMA	真島
MAKABE	真壁
MAKI	巻
MAKIE	真喜江
MAKIGUCHI	巻口
MAKIHARA	槙原
MAKIKO	万亀子
MAKIMOTO	牧本
MAKIMURA	牧村
MAKINO	槇野
MAKINODA	牧野田
MAKIO	万亀男
MAKISE	牧瀬
MAKISHIMA	巻島
MAKITA	巻田
MAKITO	牧人
MAKIUCHI	牧内
MAKIURA	牧浦
MAKIYAMA	牧山
MAKIYO	満紀代
MAKO	摩子
MAKOTO	一
MAKUCHI	幕内
MAKUDA	幕田
MAKURAZAKI	枕崎
MAMADA	侭田
MAMATA	侭田
MAMI	摩実
MAMIKO	満美子
MAMINA	真美奈
MAMIYA	間宮
MAMORU	保
MAMUROGAWA	真室川
MAN'YA	万谷
MANA	摩奈
MANABE	真辺
MANABU	学
MANAHITO	学人
MANAKA	真中
MANAMI	愛美
MANATSU	真夏
MANATSURU	真鶴
MANBA	万場
MANDA	万田
MANDAI	万代
MANGAI	万谷
MANIWA	間庭
MANJI	万司
MANJIRO	万次郎
MANKICHI	万吉
MANNO	万野
MANNOSUKE	万之助
MANO	真野
MANOME	馬目
MANSAKU	万作
MANTANI	万谷
MANTARO	万太郎
MANZABURO	万三郎
MAO	摩緒
MAOKO	真生子
MARI	万利
MARIA	万梨阿
MARIE	万里恵
MARIHIKO	真理彦
MARII	麻利衣
MARIKA	真理香
MARIKO	万利子
MARINA	満里奈
MARINO	真理乃
MARO	真浪
MARU	丸
MARUBASHI	丸橋
MARUBAYASHI	丸林
MARUGAME	丸亀
MARUHASHI	丸橋
MARUI	丸井
MARUKAWA	丸川
MARUKI	丸木
MARUKO	丸子
MARUMO	丸茂
MARUMORI	丸森
MARUMOTO	丸本
MARUNO	丸野
MARUO	丸尾
MARUOKA	丸岡
MARUSHIMA	丸島
MARUTA	丸田
MARUTANI	丸谷
MARUYA	丸屋
MARUYAMA	丸山
MASA	雅
MASAAKI	将明
MASACHIKA	昌親
MASADA	政田
MASAE	優江
MASAFUMI	将文
MASAFUSA	正房
MASAGO	真砂
MASAGORO	政五郎
MASAHARU	優晴
MASAHIDE	将秀
MASAHIKO	允彦
MASAHIRO	全弘
MASAHISA	昌久
MASAHITO	政仁
MASAHO	正穂
MASAI	正井
MASAICHI	政一
MASAICHIRO	雅一郎
MASAJI	政二
MASAJIRO	政次郎
MASAKA	真坂
MASAKATSU	将克
MASAKAZU	将一
MASAKI	将喜
MASAKICHI	政吉
MASAKIYO	正清
MASAKO	匡子
MASAMI	優美
MASAMICHI	政通
MASAMITSU	政光
MASAMORI	雅守
MASAMURA	正村
MASANAGA	雅永
MASANAO	将尚
MASANARI	将也
MASANO	正野
MASANOBU	将伸
MASANORI	公則
MASANOSUKE	政之助
MASAO	優夫
MASAOKA	政岡
MASAOMI	正臣
MASARO	雅朗
MASARU	優
MASASHI	仁
MASASHIGE	政重
MASATADA	正忠
MASATAKA	全隆
MASATAKE	征武
MASATANE	昌種
MASATARO	政太郎
MASATERU	将輝
MASATETSU	正哲
MASATO	万里
MASATOMI	雅臣
MASATOMO	昌友
MASATOSHI	将俊
MASATSUGU	昌二
MASATSUMI	正積
MASATSUNE	正経
MASAYA	将也
MASAYAMA	当山
MASAYASU	仁康
MASAYO	征代
MASAYOSHI	将義
MASAYUKI	優之
MASAZO	政三
MASAZUMI	昌純
MASE	真瀬
MASEGI	柵木
MASHIBA	真柴
MASHIKI	益城
MASHIKO	益子
MASHIMO	真下
MASHIO	真塩
MASHITA	真下
MASUBUCHI	増淵
MASUDA	升田
MASUDO	益戸
MASUE	増恵
MASUGATA	増形
MASUHARA	増原
MASUHIKO	益彦
MASUHIRO	増広
MASUI	増井
MASUJIMA	増島
MASUKAWA	増川
MASUKICHI	増吉
MASUKO	増子
MASUKURA	増倉
MASUMI	増美
MASUMOTO	升本
MASUMURA	増村
MASUNAGA	増永
MASUNO	増野
MASUO	増夫
MASUOKA	増岡
MASURO	益郎
MASUSHI	益司
MASUTAKA	益孝
MASUTANI	升谷
MASUTARO	増太郎
MASUTO	増人
MASUYA	増谷
MASUYAMA	増山
MASUYO	益世
MASUYUKI	増幸
MASUZAWA	升沢
MASUZO	増造
MATAJI	又司
MATAJIRO	又二郎
MATAKICHI	又吉
MATAMA	真玉
MATANO	俣野
MATANORI	又則
MATAO	又夫
MATASHICHI	又七
MATAYOSHI	又吉
MATAZO	又蔵
MATO	馬渡
MATOBA	的場
MATSUBA	松葉
MATSUBARA	松原
MATSUBASE	松橋
MATSUBASHI	松橋
MATSUBAYASHI	松林
MATSUBUSHI	松伏
MATSUCHI	松内
MATSUDA	松田
MATSUDAI	松代
MATSUDAIRA	松平
MATSUDO	松土
MATSUE	末枝
MATSUEDA	松枝
MATSUFUJI	松藤
MATSUGORO	松五郎
MATSUHASHI	松橋
MATSUHISA	松久
MATSUI	松井
MATSUIDA	松井田
MATSUISHI	松石
MATSUJI	松治
MATSUJIRO	松次郎
MATSUKATA	松方
MATSUKAWA	松川
MATSUKI	末木
MATSUKICHI	松吉
MATSUKO	万津子
MATSUKUMA	松隈
MATSUKURA	松倉
MATSUMAE	松前
MATSUMARU	松丸
MATSUMI	末美
MATSUMIYA	松宮
MATSUMORI	松森
MATSUMOTO	松元
MATSUMURA	松村
MATSUMURO	松室
MATSUNAGA	松永
MATSUNAKA	松中
MATSUNAMI	松並
MATSUNAWA	松縄
MATSUNO	松野
MATSUNOBE	松延
MATSUNOYAMA	松之山
MATSUNUMA	松沼
MATSUO	松夫
MATSUOKA	松岡
MATSURA	松浦
MATSUSAKA	松坂
MATSUSAKI	松崎
MATSUSAWA	松沢
MATSUSE	松瀬
MATSUSHIMA	松島
MATSUSHIRO	松代
MATSUSHITA	松下
MATSUTANI	松谷
MATSUTARO	松太郎
MATSUTOMO	松友
MATSUYA	松谷
MATSUYAMA	松山
MATSUYO	末代
MATSUYOSHI	松吉
MATSUZABURO	松三郎
MATSUZAKA	松阪
MATSUZAKI	松崎
MATSUZAWA	松沢
MATSUZO	松蔵
MATSUZONO	松園
MATTO	松任
MAWATARI	馬渡
MAYA	摩耶
MAYAKO	真矢子
MAYAMA	真山
MAYO	真世
MAYU	真由
MAYUKA	麻由香
MAYUKO	真弓子
MAYUMI	万由美
MAYUO	真由男
MAYURI	麻由里
MAYUZUMI	黛
MAZAKI	真崎
MEDOKI	目時
MEGUMI	恩
MEGUMU	恵
MEGURO	目黒
MEI	芽衣
MEIICHIRO	明一郎
MEIJI	明治
MEIKA	明香
MEIKO	明子
MEISHI	明司
MEITO	名東
MEITOKU	明徳
MEIWA	明和
MEIZO	明蔵
MENDA	免田
MENUMA	妻沼
MERA	目良
MESAKI	目崎
MEZAKI	目崎
MIA	未亜
MIAI	美愛
MIBAYASHI	三林
MIBE	三部
MIBU	壬生
MICHI	未知
MICHIAKI	裕昭
MICHIBATA	道端
MICHIE	三千江
MICHIGAMI	道上
MICHIHARU	美千晴
MICHIHIKO	充彦
MICHIHIRA	長平
MICHIHIRO	充弘
MICHIHISA	通久
MICHIHITO	道人
MICHIHO	三千穂
MICHIJI	道治
MICHIKA	美智香
MICHIKAMI	道上
MICHIKATSU	三千克
MICHIKAZU	道一
MICHIKO	三千子
MICHIMASA	通正
MICHINAKA	道中
MICHINAMI	三千波
MICHINARI	道成
MICHINOBU	道信
MICHINORI	道典
MICHINOSUKE	通之助
MICHIO	三千夫
MICHIRU	未散
MICHISHITA	道下
MICHITAKA	充孝
MICHITAKE	三千丈
MICHIYA	路也
MICHIYAMA	道山
MICHIYASU	通泰
MICHIYO	三千代
MICHIYOSHI	道好
MICHIYUKI	教行
MIDOME	三留
MIDORI	碧
MIDORIKAWA	緑川
MIE	三恵
MIEKO	三恵子
MIENO	三重野
MIFUNE	三船
MIFUYU	未布夕
MIGIHITO	右人
MIGITA	右田
MIGIWA	汀
MIHAMA	美浜
MIHARA	三原
MIHARU	三春
MIHASHI	三橋
MIHIME	美姫
MIHIRA	三平
MIHO	三穂
MIHOKO	三保子
MIHORI	三堀
MIICHI	見市
MIKA	三佳
MIKADO	三角
MIKAE	未華江
MIKAKO	実佳子
MIKAMI	三上
MIKARI	美加理
MIKASA	三笠
MIKAWA	三加和
MIKAYO	美香代
MIKI	三木
MIKIAKI	幹明
MIKIE	幹恵
MIKIHIKO	幹彦
MIKIHISA	幹久
MIKIKO	三希子
MIKIMASA	幹正
MIKIO	三喜夫
MIKIRO	幹朗
MIKITERU	幹輝
MIKIYA	幹也
MIKIYO	幹代
MIKOME	見米
MIKOSHIBA	御子柴
MIKOTO	美琴
MIKU	未来
MIKUNI	三国
MIKURA	三倉
MIKURIYA	御厨
MIMA	美馬
MIMATSU	三松
MIMORI	三森
MIMOTO	三本
MIMURA	三村
MIMURO	三室
MINA	三奈
MINAE	三奈江
MINAGAWA	南川
MINAI	薬袋
MINAKAMI	水上
MINAKATA	南方
MINAKAWA	源川
MINAKI	皆木
MINAKO	三奈子
MINAMATA	水俣
MINAMI	南
MINAMIASHIGARA	南足柄
MINAMIDA	南田
MINAMIDE	南出
MINAMIGUCHI	南口
MINAMIHATA	南畑
MINAMIKATA	南方
MINAMIKAWA	南川
MINAMIKAWACHI	南河内
MINAMIMOTO	南本
MINAMIMURA	南村
MINAMINASU	南那須
MINAMINO	南野
MINAMIOGUNI	南小国
MINAMISATO	南里
MINAMISAWA	南沢
MINAMITANI	南谷
MINAMIYA	南谷
MINAMIYAMA	南山
MINAMIZAWA	南沢
MINAMOTO	源
MINANO	皆野
MINATO	港
MINATOYA	湊谷
MINAYO	美奈代
MINE	三根
MINEDA	峰田
MINEGISHI	峰岸
MINEHIRO	峰浩
MINEJIMA	峰島
MINEKAZU	峯和
MINEKI	峯木
MINEKICHI	峯吉
MINEKO	峯子
MINEMATSU	峰松
MINEMOTO	峯元
MINEMURA	峯村
MINEO	峯夫
MINESAKI	峯崎
MINESHIMA	峯島
MINETA	峯田
MINETOSHI	峰俊
MINEZAKI	峰崎
MINGDE	明徳
MINGZHI	明治
MINO	三野
MINOBE	美濃部
MINOBU	巳信
MINODA	蓑田
MINOGUCHI	箕口
MINOHARU	巳之春
MINOKAMO	美濃加茂
MINOKICHI	味之吉
MINORA	箕浦
MINORI	法
MINORU	利
MINOTA	箕田
MINOWA	箕輪
MINPEI	民平
MIO	三尾
MIOJI	三男司
MIOKO	未央子
MIORI	美織
MIRAI	未来
MIREI	実嶺
MIRI	美里
MISA	実佐
MISAE	操江
MISAKA	三坂
MISAKI	三崎
MISAKO	三沙子
MISAO	三佐男
MISATO	三郷
MISAWA	三沢
MISAYO	美佐代
MISE	三瀬
MISEKI	三関
MISHIBA	三柴
MISHIMA	三島
MISHINA	三品
MISONO	味曽野
MISU	三須
MISUMI	三角
MISUO	美称夫
MISUZU	三鈴
MITA	三田
MITAKA	三鷹
MITAKE	三竹
MITAMURA	三田村
MITANI	三谷
MITARAI	御手洗
MITO	三戸
MITOBE	三戸部
MITOMA	三苫
MITOME	三留
MITOMI	三富
MITOMO	三友
MITORI	美登利
MITSU	光
MITSUAKI	三明
MITSUBORI	三堀
MITSUCHIKA	光親
MITSUDA	光田
MITSUE	三恵
MITSUFUJI	光藤
MITSUFUMI	光文
MITSUGI	貢
MITSUGU	貢
MITSUHACHI	三八
MITSUHARU	充晴
MITSUHASHI	三橋
MITSUHIDE	光秀
MITSUHIKO	三彦
MITSUHIRO	充宏
MITSUHISA	光久
MITSUHITO	充人
MITSUHO	光保
MITSUI	三井
MITSUISHI	三石
MITSUJI	光司
MITSUJIRO	光次郎
MITSUKA	三塚
MITSUKAIDO	水海道
MITSUKE	見附
MITSUKI	三樹
MITSUKO	三子
MITSUMA	三間
MITSUMASA	光政
MITSUMATA	三俣
MITSUMOTO	三本
MITSUMURA	光村
MITSUNAGA	光永
MITSUNARI	光成
MITSUNO	三野
MITSUNOBU	三伸
MITSUNORI	三則
MITSUNOSUKE	満之助
MITSUO	三夫
MITSUOKA	光岡
MITSURO	光郎
MITSURU	充
MITSUSABURO	光三郎
MITSUSAWA	光沢
MITSUSHI	光史
MITSUTA	満田
MITSUTAKA	充孝
MITSUTERU	光輝
MITSUTO	三戸
MITSUTOMO	光智
MITSUTOSHI	三敏
MITSUTSUGU	光次
MITSUWA	三和
MITSUYA	三屋
MITSUYAMA	三山
MITSUYASU	光康
MITSUYO	充代
MITSUYOSHI	三良
MITSUYUKI	光之
MITSUZAWA	光沢
MITSUZO	光三
MITSUZUKA	三塚
MITSUZUMI	光純
MIURA	三浦
MIWA	三輪
MIWAKO	三和子
MIYA	宮
MIYABAYASHI	宮林
MIYABE	宮部
MIYABI	雅
MIYADERA	宮寺
MIYAGAKI	宮垣
MIYAGAMI	宮上
MIYAGAWA	宮川
MIYAGI	宮城
MIYAGINO	宮城野
MIYAGISHI	宮岸
MIYAGISHIMA	宮城島
MIYAGUCHI	宮口
MIYAHARA	宮原
MIYAI	宮井
MIYAIRI	宮入
MIYAJI	宮地
MIYAJIMA	宮島
MIYAKAWA	宮川
MIYAKE	三宅
MIYAKO	三矢子
MIYAKOJIMA	都島
MIYAKONOJO	都城
MIYAKOSHI	宮腰
MIYAKUBO	宮久保
MIYAKURA	宮倉
MIYAMA	三山
MIYAMAE	宮前
MIYAMI	未也美
MIYAMORI	宮森
MIYAMOTO	宮元
MIYAMURA	宮村
MIYANAGA	宮永
MIYANE	宮根
MIYANISHI	宮西
MIYANO	宮野
MIYAO	宮尾
MIYAOKA	宮岡
MIYASAKA	宮坂
MIYASATO	宮里
MIYASHIRO	宮代
MIYASHITA	宮下
MIYATA	宮田
MIYATAKE	宮武
MIYATANI	宮谷
MIYATO	宮戸
MIYAUCHI	宮内
MIYAURA	宮浦
MIYAWAKI	宮脇
MIYAYAMA	宮山
MIYAYOSHI	宮良
MIYAZAKI	宮崎
MIYAZAWA	宮沢
MIYAZOE	宮副
MIYAZONO	宮園
MIYAZU	宮津
MIYO	実代
MIYOJI	三代治
MIYOKAWA	三代川
MIYOKO	三代子
MIYOSHI	三吉
MIYOTA	御代田
MIYOTSUGU	彌代次
MIYU	美優
MIYUI	美唯
MIYUKI	幸
MIZOBATA	溝端
MIZOBE	溝部
MIZOBUCHI	溝淵
MIZOE	溝江
MIZOGUCHI	溝口
MIZOI	溝井
MIZOKAMI	溝上
MIZOKUCHI	溝口
MIZOROGI	溝呂木
MIZOTA	溝田
MIZUCHI	水内
MIZUE	壬江
MIZUGAKI	水垣
MIZUHARA	水原
MIZUHASHI	水橋
MIZUHO	水穂
MIZUI	水井
MIZUIDE	水出
MIZUKA	三塚
MIZUKAWA	水川
MIZUKI	未図紀
MIZUKO	水子
MIZUKOSHI	水越
MIZUKUCHI	水口
MIZUMA	三潴
MIZUMACHI	水町
MIZUMAKI	水巻
MIZUMOTO	水元
MIZUMURA	水村
MIZUNAMI	瑞浪
MIZUNO	水野
MIZUNOYA	水野谷
MIZUNUMA	水沼
MIZUO	瑞夫
MIZUOCHI	水落
MIZUOKA	水岡
MIZUSAKI	水崎
MIZUSAWA	水沢
MIZUSHIMA	水島
MIZUSHINA	水品
MIZUTA	水田
MIZUTANI	水谷
MIZUYO	瑞代
MOBARA	茂原
MOCHIDA	持田
MOCHIFUMI	望史
MOCHIMARU	持丸
MOCHINAGA	持永
MOCHITSUGU	望嗣
MOCHIZUKI	望月
MODEGI	茂出木
MOE	萌
MOEKO	萌子
MOGAKI	茂垣
MOGAMI	最上
MOGI	茂木
MOHEI	茂平
MOICHI	茂一
MOJI	門司
MOKA	真岡
MOMIYAMA	籾山
MOMO	桃
MOMODA	百田
MOMOE	百恵
MOMOHARA	桃原
MOMOI	桃井
MOMOISHI	百石
MOMOKA	桃香
MOMOKO	桃子
MOMOSAWA	桃沢
MOMOSE	百瀬
MOMOTA	百田
MOMOTARO	桃太郎
MOMOYO	桃代
MOMOZO	百三
MONBETSU	紋別
MONDEN	門伝
MONGUCHI	門口
MONMA	門間
MONNO	門野
MONOE	物江
MONTA	門田
MONZEN	門前
MORI	守
MORIAI	森合
MORIAKI	守昭
MORIBAYASHI	森林
MORIBE	森部
MORICHIKA	森近
MORIE	森江
MORIFUJI	森藤
MORIGUCHI	守口
MORIHARA	森原
MORIHARU	盛春
MORIHIKO	守彦
MORIHIRO	守宏
MORIHISA	守久
MORII	森井
MORIICHI	守一
MORIIZUMI	森泉
MORIKAMI	森上
MORIKATSU	森勝
MORIKAWA	守川
MORIKAZU	守一
MORIKI	森木
MORIKO	守子
MORIKUBO	森久保
MORIMASA	守正
MORIMATSU	森松
MORIMICHI	守道
MORIMOTO	守本
MORIMURA	森村
MORINAGA	守永
MORINAKA	森中
MORINISHI	森西
MORINO	森野
MORINOBU	守信
MORIO	守夫
MORIOKA	守岡
MORISAKI	森崎
MORISANE	森実
MORISAWA	森沢
MORISE	森瀬
MORISHIGE	森重
MORISHIMA	森島
MORISHIRI	森尻
MORISHITA	森下
MORISONO	森園
MORITA	守田
MORITAKA	守孝
MORITAKE	森竹
MORITANI	森谷
MORITO	森戸
MORITOSHI	守利
MORIUCHI	森内
MORIWAKI	森脇
MORIYA	守屋
MORIYAMA	守山
MORIYASU	守安
MORIYOSHI	森吉
MORIYUKI	守行
MORIZO	盛蔵
MORIZUMI	森住
MORO	毛呂
MOROBOSHI	諸星
MOROHASHI	諸橋
MOROHOSHI	諸星
MOROI	諸井
MOROKA	師岡
MOROSAWA	諸沢
MOROTA	諸田
MOROTO	諸戸
MOROYAMA	毛呂山
MOROZUMI	両角
MOSABURO	茂三郎
MOTAI	茂田井
MOTEGI	持木
MOTEKI	茂木
MOTO	元夫
MOTOAKI	元明
MOTODA	元田
MOTOE	本江
MOTOEI	基衛
MOTOFUMI	元文
MOTOHARA	本原
MOTOHARU	元春
MOTOHASHI	元橋
MOTOHIKO	元彦
MOTOHIRO	元宏
MOTOHISA	元久
MOTOI	元井
MOTOICHI	元一
MOTOJI	元司
MOTOJIMA	元島
MOTOJIRO	元次郎
MOTOKA	元岡
MOTOKATSU	元勝
MOTOKAWA	本川
MOTOKAZU	元一
MOTOKI	元喜
MOTOKICHI	元吉
MOTOKO	元子
MOTOKUNI	元国
MOTOMATSU	本松
MOTOMI	元美
MOTOMIYA	本宮
MOTOMU	求
MOTOMURA	元村
MOTONARI	元成
MOTONO	本野
MOTONOBU	元信
MOTONORI	元憲
MOTOSHI	元史
MOTOSUGI	本杉
MOTOSUKE	元助
MOTOTANI	元谷
MOTOTSUGU	基嗣
MOTOYA	元也
MOTOYAMA	元山
MOTOYASU	元保
MOTOYO	紀代
MOTOYOSHI	元吉
MOTOYUKI	元之
MOTOZAWA	本沢
MOTOZUMI	元澄
MUGIKURA	麦倉
MUGISHIMA	麦島
MUGURUMA	六車
MUIKA	六日
MUKADA	向田
MUKAGAWA	向川
MUKAI	向
MUKAIHARA	向原
MUKAIISEKI	向井関
MUKAIYA	向谷
MUKAIYAMA	向山
MUKASA	六笠
MUKAWA	武川
MUKO	向日
MUKODA	向田
MUKOJIMA	向島
MUKOYAMA	向山
MUKUO	椋尾
MUNAKATA	宗像
MUNAMURA	宗村
MUNEAKI	宗昭
MUNEHIKO	宗彦
MUNEHIRA	宗平
MUNEHIRO	宗博
MUNEHISA	宗久
MUNEHITO	宗人
MUNEKATA	宗像
MUNEKAWA	宗川
MUNEKAZU	宗一
MUNEKI	宗樹
MUNEKIYO	宗清
MUNENORI	宗典
MUNEO	宗夫
MUNESHI	宗司
MUNETA	宗田
MUNETADA	宗忠
MUNETAKA	宗孝
MUNETOSHI	宗利
MUNETSUGU	宗嗣
MUNEYOSHI	宗吉
MUNEYUKI	宗之
MURA	村
MURABAYASHI	村林
MURAGISHI	村岸
MURAGUCHI	村口
MURAHASHI	村橋
MURAI	村井
MURAISHI	村石
MURAKAMI	村上
MURAKATA	村形
MURAKAWA	村川
MURAKI	村木
MURAKOSHI	村越
MURAMATSU	村松
MURAMOTO	村元
MURANAKA	村中
MURANISHI	村西
MURANO	村野
MURANUSHI	村主
MURAO	村尾
MURAOKA	村岡
MURASAKI	村崎
MURASAWA	村沢
MURASE	村瀬
MURASHIMA	村島
MURASUGI	村杉
MURATA	村田
MURATANI	村谷
MURAYAMA	村山
MURO	室
MUROBUSE	室伏
MUROBUSHI	室伏
MUROGA	室賀
MUROHASHI	室橋
MUROI	室井
MUROKA	室岡
MUROKAWA	室川
MUROKOSHI	室越
MUROMACHI	室町
MURORAN	室蘭
MUROTA	室田
MUROTANI	室谷
MUROTO	室戸
MUROYA	室屋
MUSASHI	武蔵
MUSASHIMURAYAMA	武蔵村山
MUSASHINO	武蔵野
MUTA	牟田
MUTO	武藤
MUTSU	睦
MUTSUHIKO	睦彦
MUTSUKI	睦月
MUTSUKO	睦子
MUTSUMI	睦
MUTSUO	六夫
MUTSUYO	睦代
MUTSUZAWA	睦沢
MYOE	明絵
MYOGI	妙義
MYOKOKOGEN	妙高高原
NABARI	名張
NABATA	名畑
NABATAME	生田目
NABEKURA	鍋倉
NABESHIMA	鍋島
NABETA	鍋田
NABETANI	鍋谷
NABEYA	鍋谷
NADA	名田
NADACHI	名立
NAE	奈恵
NAEKO	奈恵子
NAEMURA	苗村
NAGABE	長部
NAGAE	永江
NAGAFUCHI	永淵
NAGAFUJI	永藤
NAGAHAMA	永浜
NAGAHARA	永原
NAGAHARU	長春
NAGAHASHI	長橋
NAGAHATA	長畑
NAGAHORI	永堀
NAGAI	永井
NAGAIKE	永池
NAGAISHI	永石
NAGAKAWA	永川
NAGAKI	永木
NAGAKO	永子
NAGAKUBO	永久保
NAGAKURA	永倉
NAGAMASA	永芳
NAGAMATSU	永松
NAGAMI	永見
NAGAMINE	永峯
NAGAMORI	永森
NAGAMOTO	永本
NAGAMURA	永村
NAGANAWA	長縄
NAGANE	長根
NAGANO	永野
NAGANOHARA	長野原
NAGANUMA	永沼
NAGAO	永夫
NAGAOKA	永岡
NAGAOKAKYO	長岡京
NAGAOSA	永長
NAGARA	長柄
NAGAREYAMA	流山
NAGASAKA	永坂
NAGASAKI	長崎
NAGASAKU	永作
NAGASAWA	永沢
NAGASE	永瀬
NAGASHIMA	永島
NAGASHIO	長塩
NAGASU	長洲
NAGATA	永田
NAGATAKE	長竹
NAGATANI	永谷
NAGATO	永戸
NAGATOMI	永冨
NAGATOMO	永友
NAGATORO	長瀞
NAGATOSHI	永敏
NAGATSU	長津
NAGATSUKA	永塚
NAGATSUMA	永妻
NAGAURA	永浦
NAGAWA	名川
NAGAYA	永谷
NAGAYAMA	永山
NAGAYOSHI	永吉
NAGAYUKI	長之
NAGISA	汀
NAGISO	南木曽
NAGO	名護
NAGOSHI	名越
NAGOYA	名児耶
NAGUMO	南雲
NAHA	那覇
NAHO	奈保
NAHOKO	奈保子
NAHOMI	名保美
NAIKI	内木
NAITO	内藤
NAJIMA	名島
NAKA	中
NAKABAYASHI	中林
NAKABE	中部
NAKABORI	中堀
NAKACHI	中地
NAKADA	中田
NAKADAI	中代
NAKADATE	中楯
NAKADE	中出
NAKADO	中堂
NAKAE	中江
NAKAGAKI	中垣
NAKAGAMI	中上
NAKAGAWA	中川
NAKAGAWARA	中川原
NAKAGIRI	中桐
NAKAGOSHI	中越
NAKAGUCHI	中口
NAKAGUKI	中茎
NAKAGYO	中京
NAKAHACHI	中鉢
NAKAHAMA	中浜
NAKAHARA	中原
NAKAHASHI	中橋
NAKAHATA	中畑
NAKAHIGASHI	中東
NAKAHIRA	中平
NAKAI	中井
NAKAIE	中家
NAKAIGAWA	中井川
NAKAIZUMI	中泉
NAKAJI	中路
NAKAJIMA	中島
NAKAJO	中条
NAKAKI	中木
NAKAKITA	中北
NAKAKO	仲子
NAKAKOJI	中小路
NAKAKOSHI	中越
NAKAKUCHI	中口
NAKAKUKI	中久喜
NAKAKURA	中倉
NAKAMA	中間
NAKAMACHI	中町
NAKAMAE	中前
NAKAMAKI	中牧
NAKAMARU	中丸
NAKAMATA	中俣
NAKAMATSU	中松
NAKAMICHI	中路
NAKAMIGAWA	中三川
NAKAMINATO	那珂湊
NAKAMIYA	中宮
NAKAMIZO	中溝
NAKAMORI	中森
NAKAMOTO	中元
NAKAMURA	中村
NAKANE	中根
NAKANIIDA	中新田
NAKANISHI	中西
NAKANIWA	中庭
NAKANO	中野
NAKANOJO	中之条
NAKANOSHIMA	中之島
NAKAO	中尾
NAKAOKA	中岡
NAKASA	仲佐
NAKASAKI	中崎
NAKASATO	中里
NAKASE	中瀬
NAKASEKO	中世古
NAKASEN	中仙
NAKASHIMA	中嶋
NAKASHIRO	中城
NAKASHITA	中下
NAKASHIZU	中静
NAKASONE	中曽根
NAKASONO	中園
NAKASU	中須
NAKASUGI	中杉
NAKASUJI	中筋
NAKATANI	中谷
NAKATO	中東
NAKATOMI	中冨
NAKATSU	中津
NAKATSUBO	中坪
NAKATSUGAWA	中津川
NAKATSUKA	中塚
NAKATSUKASA	中務
NAKATSURU	中津留
NAKATSUYAMA	中津山
NAKAUCHI	中内
NAKAYA	中家
NAKAYAMA	中山
NAKAYASU	中安
NAKAZA	仲佐
NAKAZATO	中里
NAKAZAWA	中沢
NAKAZO	仲三
NAKAZONE	仲宗根
NAKUI	名久井
NAKURA	名倉
NAMAE	生江
NAMAI	生井
NAMAISAWA	生井沢
NAMATAME	生田目
NAMEGATA	行方
NAMEGAWA	滑川
NAMEKATA	行方
NAMEKAWA	滑川
NAMEKI	行木
NAMERIKAWA	滑川
NAMI	名美
NAMIE	奈美恵
NAMIHIKO	南海彦
NAMIKATA	波形
NAMIKAWA	並川
NAMIKI	並木
NAMIKO	凡子
NAMIMA	浪間
NAMIOKA	浪岡
NAMURA	名村
NAN	男
NAN'YA	南谷
NANA	名奈
NANAE	七恵
NANAKO	七子
NANAMI	七海
NANAO	七夫
NANASAWA	七沢
NANASE	七瀬
NANATSUKA	七塚
NANAUMI	七海
NANBA	南場
NANBARA	南原
NANBATA	南畑
NANBO	南保
NANBU	南部
NANGO	南郷
NANIWA	浪速
NANKOKU	南国
NANNO	南野
NANOKO	菜子
NANRI	南里
NAO	奈保
NAOAKI	尚明
NAOATSU	直温
NAOE	尚恵
NAOETSU	直江津
NAOFUMI	尚史
NAOHARU	尚治
NAOHEI	直平
NAOHIDE	直秀
NAOHIKO	尚彦
NAOHIRO	尚博
NAOHISA	尚久
NAOHITO	尚人
NAOI	直井
NAOICHI	尚一
NAOIRI	直入
NAOJI	直二
NAOJIRO	直二郎
NAOKATSU	直克
NAOKAZU	尚一
NAOKI	尚喜
NAOKICHI	直吉
NAOKO	奈保子
NAOMASA	直昌
NAOMI	名保美
NAOMICHI	直道
NAOMITSU	直光
NAOSAKU	直作
NAOSHI	尚史
NAOSHIGE	尚茂
NAOSUKE	直介
NAOTA	尚太
NAOTAKA	尚孝
NAOTAKE	尚剛
NAOTO	尚人
NAOTOKI	尚時
NAOTOMO	直友
NAOTOSHI	尚俊
NAOTSUGU	直嗣
NAOYA	尚也
NAOYOSHI	直由
NAOYUKI	尚之
NARA	奈良
NARABE	奈良部
NARAHA	楢葉
NARAHARA	奈良原
NARAHASHI	奈良橋
NARAI	奈良井
NARAKI	楢木
NARAOKA	奈良岡
NARASAKI	奈良崎
NARASHINO	習志野
NARAZAKI	楢崎
NARIAKI	成明
NARIHISA	成久
NARIKO	形子
NARIMI	也実
NARINOBU	成信
NARINORI	成典
NARIO	成夫
NARITA	成田
NARITOMI	成冨
NARIYO	成世
NARIYUKI	成之
NARUAKI	成明
NARUDOMI	成富
NARUGE	成毛
NARUHIKO	成彦
NARUI	成井
NARUKAWA	成川
NARUKE	成毛
NARUKIYO	成清
NARUKO	成子
NARUKUNI	愛邦
NARUMATSU	成松
NARUMI	成実
NARUMIYA	成宮
NARUO	成尾
NARUOKA	成岡
NARUSAWA	成沢
NARUSE	成瀬
NARUSHIMA	成島
NARUTO	成東
NARUTOSHI	成敏
NARUTSUKA	成塚
NARUYAMA	成山
NASHIMOTO	梨本
NASU	奈須
NASUNO	奈須野
NATORI	名取
NATSU	夏
NATSUE	夏恵
NATSUHIKO	夏彦
NATSUI	夏井
NATSUKAWA	夏川
NATSUKI	夏喜
NATSUKO	名津子
NATSUME	夏目
NATSUMI	夏実
NATSUO	七津男
NATSUYAMA	夏山
NATSUYO	夏代
NAWA	名和
NAWASHIRO	苗代
NAWATA	縄田
NAYA	納谷
NAYORO	名寄
NAYUKI	名雪
NAZE	名瀬
NAZUKA	名塚
NEAGARI	根上
NEDA	根田
NEDACHI	根立
NEDATE	根立
NEGAMI	根上
NEGI	根木
NEGISHI	根岸
NEGORO	根来
NEHASHI	根橋
NEISHI	根石
NEMOTO	根元
NEMURA	根村
NEMURO	根室
NENOKICHI	子之吉
NERIMA	練馬
NEYAGAWA	寝屋川
NEZU	根津
NIBE	仁部
NIDA	仁田
NIEDA	贄田
NIGORIKAWA	濁川
NIHEI	二瓶
NIHIRA	仁平
NIHON'YANAGI	二本柳
NIHONMATSU	二本松
NII	丹生
NIIBE	新部
NIIBORI	新堀
NIIDA	仁井田
NIIDE	新出
NIIGAKI	新垣
NIIGATA	新潟
NIIHAMA	新居浜
NIIHARA	新原
NIII	新居
NIIJIMA	新島
NIIKI	新城
NIIKUNI	新国
NIIKURA	新倉
NIIMI	新実
NIIMIYA	新宮
NIIMOTO	新本
NIIMURA	新村
NIINA	新名
NIINO	新納
NIINUMA	新沼
NIIOKA	新岡
NIISATO	新里
NIISEKI	新関
NIITSU	新津
NIIYA	新家
NIIYAMA	新山
NIIZA	新座
NIIZAWA	新沢
NIIZEKI	新関
NIIZUMA	新妻
NIJIKO	虹子
NIJO	二丈
NIKAHO	仁賀保
NIKAIDO	二階堂
NIKAMI	二上
NIKI	二木
NIKKO	日光
NIMURA	二村
NINAGAWA	蜷川
NINOHE	二戸
NINOMIYA	二宮
NIRASAKI	韮崎
NIRASAWA	韮沢
NIREI	楡井
NISABURO	仁三郎
NISHI	西
NISHIAIZU	西会津
NISHIBAYASHI	西林
NISHIBE	西部
NISHIBORI	西堀
NISHIDA	西田
NISHIDATE	西舘
NISHIDE	西出
NISHIE	西江
NISHIFUJI	西藤
NISHIGAI	西貝
NISHIGAKI	西垣
NISHIGAMI	西上
NISHIGATA	西潟
NISHIGORI	西郡
NISHIGOSHI	西合志
NISHIGUCHI	西口
NISHIHAMA	西浜
NISHIHARA	西原
NISHIHASHI	西橋
NISHIHATA	西畑
NISHIHIRA	西平
NISHII	西井
NISHIJIMA	西島
NISHIKATA	西形
NISHIKAWA	西川
NISHIKI	西木
NISHIKIORI	錦織
NISHIKUBO	西久保
NISHIKURA	西倉
NISHIKYO	西京
NISHIMAE	西前
NISHIMAKI	西巻
NISHIMATSU	西松
NISHIME	西目
NISHIMIYA	西宮
NISHIMORI	西森
NISHIMOTO	西元
NISHIMURA	西村
NISHIMURO	西室
NISHIMUTA	西牟田
NISHINA	仁科
NISHINAKA	西中
NISHINARI	西成
NISHINASUNO	西那須野
NISHINO	西野
NISHINOMIYA	西宮
NISHINOMOTE	西之表
NISHIO	西尾
NISHIOKA	西岡
NISHISAKA	西坂
NISHISENBOKU	西仙北
NISHISHITA	西下
NISHITANI	西谷
NISHITOKYO	西東京
NISHIUCHI	西内
NISHIUE	西上
NISHIUMI	西海
NISHIURA	西浦
NISHIWAKI	西脇
NISHIYAMA	西山
NISHIYODOGAWA	西淀川
NISHIZAKA	西坂
NISHIZAKI	西崎
NISHIZAWA	西沢
NISHIZONO	西園
NISHIZUKA	西塚
NISSHIN	日進
NITA	仁田
NITO	仁藤
NITOBE	二藤部
NITORI	似鳥
NITTA	新田
NIU	丹生
NIWA	丹羽
NIWANO	庭野
NIWATA	庭田
NIWAYAMA	庭山
NO	能生
NOBATA	野畑
NOBE	野辺
NOBEO	延夫
NOBEOKA	延岡
NOBEYUKI	延之
NOBORI	登
NOBORIBETSU	登別
NOBORU	徳
NOBU	信
NOBUAKI	伸明
NOBUE	伸恵
NOBUHARA	信原
NOBUHARU	伸晴
NOBUHIDE	信秀
NOBUHIKO	伸彦
NOBUHIRO	亘宏
NOBUHISA	伸久
NOBUHITO	信人
NOBUJI	信次
NOBUKATSU	信勝
NOBUKAWA	信川
NOBUKAZU	伸和
NOBUKI	信樹
NOBUKICHI	信吉
NOBUKO	伸子
NOBUMASA	伸政
NOBUMITSU	伸光
NOBUNAGA	信長
NOBUNARI	伸成
NOBUO	伸夫
NOBURU	暢
NOBUSAWA	信沢
NOBUSHIGE	信繁
NOBUSUKE	信介
NOBUTA	信太
NOBUTADA	信忠
NOBUTAKA	伸孝
NOBUTO	信人
NOBUTOSHI	伸俊
NOBUTSUGU	信次
NOBUYA	伸也
NOBUYAMA	延山
NOBUYASU	伸康
NOBUYO	伸代
NOBUYOSHI	伸佳
NOBUYUKI	亘行
NOCHI	野内
NODA	野田
NODE	野手
NODERA	野寺
NODOMI	納富
NOGAMI	野上
NOGARIYA	野苅家
NOGATA	直方
NOGAWA	野川
NOGI	野木
NOGUCHI	野口
NOHAGI	野萩
NOHARA	野原
NOHATA	野畑
NOHEJI	野辺地
NOHIRA	野平
NOIKE	野池
NOJI	野地
NOJIMA	野島
NOJIRI	野尻
NOMA	野間
NOMAGUCHI	野間口
NOMI	能美
NOMICHI	野路
NOMIYA	野宮
NOMIYAMA	野見山
NOMIZO	野溝
NOMIZU	野水
NOMO	野茂
NOMOTO	野元
NOMURA	能村
NONAKA	野中
NONAMI	野波
NORIAKI	典明
NORIE	典利江
NORIFUMI	徳文
NORIHIDE	憲秀
NORIHIKO	典彦
NORIHIRO	典宏
NORIHISA	典久
NORIHITO	典仁
NORIKAZU	典一
NORIKO	乃梨子
NORIMASA	則政
NORIMATSU	乗松
NORIMI	紀美
NORIMICHI	徳道
NORIMITSU	宣光
NORIMOTO	紀元
NORIO	典夫
NORIOKI	紀興
NORISHIGE	則茂
NORISUKE	徳介
NORITA	乗田
NORITAKA	典隆
NORITAKE	則武
NORITOSHI	典利
NORITSUGU	憲嗣
NORIYO	典代
NORIYOSHI	典義
NORIYUKI	典之
NORIZUMI	典住
NORO	野呂
NOROSE	野呂瀬
NOSAKA	野坂
NOSE	能勢
NOSHI	熨斗
NOSHIRO	能代
NOSHITA	野下
NOTANI	納谷
NOTO	能登
NOTOJIMA	能登島
NOTOMI	納冨
NOTOYA	能登谷
NOTSU	野津
NOTSUHARU	野津原
NOYA	納谷
NOYAMA	野山
NOYORI	野依
NOZAKA	野坂
NOZAKI	野崎
NOZAWA	能沢
NOZOE	野添
NOZOMI	希
NOZOMU	望
NOZU	野津
NOZUE	野末
NUKADA	額田
NUKAGA	額賀
NUKAYA	糠谷
NUKUI	温井
NUMA	沼
NUMABE	沼部
NUMAGAMI	沼上
NUMAGUCHI	沼口
NUMAJIRI	沼尻
NUMAKURA	沼倉
NUMANO	沼野
NUMAO	沼尾
NUMASAKI	沼崎
NUMASAWA	沼沢
NUMATA	沼田
NUMAZAKI	沼崎
NUMAZU	沼津
NUNOKAWA	布川
NUNOME	布目
NUNOMURA	布村
NUNOTA	布田
NUNOTANI	布谷
NYUZEN	入善
O	王
OAKU	大阿久
OAMI	大網
OAMISHIRASATO	大網白里
OANA	小穴
OARAI	大洗
OASHI	大芦
OBA	大場
OBAMA	小浜
OBANA	小花
OBANAZAWA	尾花沢
OBARA	小原
OBARI	小張
OBATA	小幡
OBAYASHI	大林
OBI	小尾
OBIHIRO	帯広
OBINATA	大日向
OBOKATA	小保方
OBU	大府
OBUCHI	大渕
OBUSE	小布施
OCHI	大地
OCHIAI	落合
ODA	大田
ODAGAKI	小田垣
ODAGAWA	小田川
ODAGI	小田木
ODAGIRI	小田切
ODAGURA	小田倉
ODAJIMA	小田島
ODAKA	小高
ODAKE	小竹
ODAKURA	小田倉
ODANAKA	小田中
ODANO	小田野
ODATE	大舘
ODAWARA	小田原
ODAYAMA	小田山
ODE	大出
ODERA	大寺
OE	大江
OEDA	大枝
OFUCHI	大淵
OFUJI	大藤
OFUNATO	大船渡
OFUSA	大房
OGA	大賀
OGACHI	大勝
OGAKI	大垣
OGAMI	大上
OGANE	大鐘
OGANO	小鹿野
OGASAWARA	小笠原
OGASHIWA	小柏
OGATA	大潟
OGAWA	小川
OGAWARA	大河原
OGI	小城
OGIKUBO	荻久保
OGIMURA	荻村
OGINO	荻野
OGINOME	荻野目
OGISHIMA	荻島
OGISO	小木曽
OGITA	荻田
OGITANI	扇谷
OGIWARA	荻原
OGIYA	扇谷
OGIYAMA	荻山
OGO	大胡
OGOE	大越
OGORI	小郡
OGOSE	生越
OGOSHI	小越
OGUCHI	大口
OGUMA	小熊
OGUNI	小国
OGURA	小倉
OGURI	小栗
OGURO	大黒
OGUSHI	大串
OGUSU	小楠
OHAMA	大浜
OHARA	大原
OHASAMA	大迫
OHASHI	大橋
OHATA	大畑
OHIGASHI	大東
OHINATA	大日向
OHIRA	大平
OHORI	大堀
OHOSHI	大星
OI	大井
OIBE	及部
OIDA	種田
OIE	大家
OIGAWA	大井川
OIIDE	生出
OIKAWA	及川
OIKE	大池
OINUMA	生沼
OISHI	大石
OISHIDA	大石田
OISO	大磯
OITA	大分
OIWA	大岩
OIWAKE	追分
OIZUMI	大泉
OJIMA	小島
OJIYA	小千谷
OKA	岡
OKABAYASHI	岡林
OKABE	岡部
OKACHI	岡地
OKADA	岡田
OKADO	大門
OKAGAKI	岡垣
OKAHARA	岡原
OKAHASHI	岡橋
OKAI	岡井
OKAJIMA	岡島
OKAKURA	岡倉
OKAMATSU	岡松
OKAMOTO	岡元
OKAMURA	岡村
OKANDA	大神田
OKANE	大金
OKANIWA	岡庭
OKANO	岡野
OKASAKA	岡坂
OKATANI	岡谷
OKATO	岡戸
OKAUCHI	岡内
OKAUE	岡上
OKAWA	大川
OKAWARA	大川原
OKAWAUCHI	大川内
OKAYA	岡谷
OKAYAMA	岡山
OKAYASU	岡安
OKAZAKI	岡崎
OKAZAWA	岡沢
OKEDA	桶田
OKEGAWA	桶川
OKETA	桶田
OKETANI	桶谷
OKEYA	桶谷
OKI	大木
OKIGORO	沖五郎
OKIHARA	沖原
OKIMOTO	沖本
OKIMURA	沖村
OKINAKA	沖中
OKINAWA	沖縄
OKINO	沖野
OKITA	大北
OKITO	興人
OKITSU	沖津
OKIYAMA	沖山
OKO	大古
OKOCHI	大河内
OKOGOHIGASHI	小古郷東
OKONOGI	小此木
OKOSHI	大越
OKU	奥
OKUAKI	奥秋
OKUBAYASHI	奥林
OKUBO	大久保
OKUCHI	大口
OKUDA	奥田
OKUDAIRA	奥平
OKUDE	奥出
OKUDERA	奥寺
OKUDO	奥渡
OKUHARA	奥原
OKUI	奥井
OKUIDE	奥出
OKUIZUMI	奥泉
OKUKAWA	奥川
OKUMA	大熊
OKUMOTO	奥本
OKUMURA	奥村
OKUNAKA	奥中
OKUNI	大国
OKUNISHI	奥西
OKUNO	奥野
OKUNUKI	奥貫
OKURA	大倉
OKURI	大栗
OKURO	大黒
OKUSA	大草
OKUSAWA	奥沢
OKUSE	奥瀬
OKUSHI	大串
OKUSHIMA	奥島
OKUSUMI	奥住
OKUTAMA	奥多摩
OKUTANI	奥谷
OKUTOMI	奥冨
OKUTSU	奥津
OKUWAKI	奥脇
OKUYAMA	奥山
OKUZUMI	奥住
OMA	大間
OMACHI	大町
OMAE	大前
OMAGARI	大曲
OMAMA	大間々
OMAMIUDA	大豆生田
OMARU	大丸
OMATA	小俣
OMATSU	大松
OME	青梅
OMI	大見
OMICHI	大道
OMIGAWA	小見川
OMIHACHIMAN	近江八幡
OMINAMI	大南
OMINATO	大湊
OMINE	大峯
OMINO	小美濃
OMIYA	大宮
OMIZO	大溝
OMOKAWA	面川
OMOMO	大桃
OMON	大門
OMONOGAWA	雄物川
OMORI	大森
OMOTE	表
OMOTO	大元
OMUKAI	大向
OMURA	大村
OMURO	大室
OMUTA	大牟田
ONA	小名
ONAI	小内
ONAKA	大中
ONCHI	恩地
ONDA	恩田
ONEDA	大根田
ONETA	大根田
ONIKI	鬼木
ONISAWA	鬼沢
ONISHI	大西
ONITSUKA	鬼塚
ONIZUKA	鬼塚
ONJUKU	御宿
ONO	多
ONODA	小野田
ONODERA	小野寺
ONOE	尾上
ONOGAWA	小野川
ONOGI	大野木
ONOGUCHI	小野口
ONOHARA	小野原
ONOJIMA	小野島
ONOJO	大野城
ONOMICHI	尾道
ONOMURA	小野村
ONOSE	小野瀬
ONOYAMA	小野山
ONOZAKA	小野坂
ONOZAKI	小野崎
ONOZATO	小野里
ONOZAWA	小野沢
ONOZUKA	小野塚
ONUKI	大貫
ONUMA	大沼
OOCHI	大内
OOCHIDA	大内田
OOE	大上
OOKA	大岡
OORA	大浦
OOSA	大長
ORA	邑楽
ORIBE	織部
ORIE	緒利恵
ORIGASA	折笠
ORIHARA	折原
ORIHASHI	折橋
ORII	折井
ORIKASA	折笠
ORIMO	折茂
ORIMOTO	折本
ORISA	織砂
ORITA	折田
ORITO	折戸
ORIYAMA	折山
ORUI	大類
OSA	長
OSABE	刑部
OSADA	長田
OSAFUNE	長船
OSAKA	大坂
OSAKABE	越坂部
OSAKASAYAMA	大阪狭山
OSAKI	大崎
OSAKO	大迫
OSAKU	大作
OSAME	納
OSAMU	一
OSAMURA	長村
OSANAI	小山内
OSANAMI	長南
OSANO	小佐野
OSATO	大里
OSAWA	大沢
OSAWANO	大沢野
OSE	大瀬
OSEKO	大迫
OSHIBA	大柴
OSHIDA	忍田
OSHIGE	大重
OSHIKA	大鹿
OSHIKAWA	押川
OSHIKI	押木
OSHIKIRI	押切
OSHIKUBO	押久保
OSHIMA	大島
OSHIMI	押見
OSHIMIZU	押水
OSHIMOTO	押本
OSHINO	押野
OSHIO	大塩
OSHIRO	大城
OSHITA	大下
OSHITANI	押谷
OSHITARI	忍足
OSHIYAMA	押山
OSONE	大曽根
OSONO	大園
OSOZAWA	遅沢
OSUGA	大菅
OSUGI	大杉
OSUMI	大住
OTA	大田
OTABE	小田部
OTAGAKI	太田垣
OTAHARA	大田原
OTAIRA	大平
OTAKA	大高
OTAKE	大岳
OTAKI	大多喜
OTANI	大谷
OTARU	小樽
OTAWA	大多和
OTAWARA	大田原
OTO	大任
OTOBE	乙部
OTODA	音田
OTOE	乙恵
OTOGURO	乙黒
OTOHATA	乙幡
OTOHIKO	乙彦
OTOKAWA	乙川
OTOKICHI	音吉
OTOKOZAWA	男沢
OTOKU	大徳
OTOMI	大富
OTOMO	大伴
OTONE	大利根
OTORI	大鳥
OTOYO	音世
OTOYOSHI	音義
OTSU	大津
OTSUBE	乙部
OTSUBO	大坪
OTSUHATA	乙幡
OTSUKA	大塚
OTSUKI	大月
OTSUKICHI	乙吉
OWADA	大和田
OWAKI	大脇
OWAKU	大和久
OWANI	大鰐
OWARIASAHI	尾張旭
OWASE	尾鷲
OWASHI	大鷲
OYA	大家
OYABE	小矢部
OYABU	大薮
OYAGI	大八木
OYAIZU	小柳津
OYAKE	小宅
OYAMA	大山
OYAMADA	小山田
OYAMATSU	親松
OYANAGI	大柳
OYANO	大矢野
OYAUCHI	大谷内
OYODO	大淀
OYOSHI	大吉
OYU	大湯
OZAKI	小崎
OZAWA	小沢
OZE	小瀬
OZEKI	大関
OZONE	小曽根
OZONO	大園
OZU	大図
OZUTSUMI	小堤
PU	朴
QIAN	謙
QIANG	強
QIANLI	千里
QIAO	巧
QING	慶
QINGJI	慶吉
QINGWEN	清文
QINGXI	慶喜
QINYI	欽一
QIUYI	秋一
QUAN	拳
QUANSHUI	泉水
RAITA	雷太
RAKUO	楽雄
RAN	乱
RANKO	蘭子
RANZAN	嵐山
REI	令
REIHOKU	苓北
REIICHI	玲一
REIJI	令司
REIJIRO	礼次郎
REIKA	玲佳
REIKO	令子
REIMI	玲美
REINA	令奈
REIRI	玲里
REIZO	礼三
REMI	礼美
REN	仁
REN'ICHI	錬一
RENA	令奈
RENJI	仁吉
RENJIRO	練二郎
RENTARO	廉太郎
RENZABURO	廉三郎
REONA	玲央名
RI	李
RIA	里亜
RICHIKO	利智子
RIE	利恵
RIEKO	利恵子
RIHACHI	利八
RIHEI	利平
RIHO	梨保
RIICHI	利一
RIICHIRO	理一郎
RIKA	利佳
RIKAKO	利佳子
RIKI	力
RIKICHI	利吉
RIKIISHI	力石
RIKIO	力夫
RIKIRO	力郎
RIKIYA	力也
RIKIYO	力世
RIKIZABURO	力三郎
RIKIZO	力三
RIKO	理子
RIKUGAWA	陸川
RIKUKO	陸子
RIKUO	陸夫
RIKUZENTAKATA	陸前高田
RIMI	梨美
RIN	倫
RINA	利奈
RINKO	倫子
RINO	梨乃
RINTARO	倫太郎
RINZO	林造
RIO	梨生
RIOKO	利央子
RISA	利佐
RISABURO	利三郎
RISAKO	利佐子
RISAKU	利作
RISUKE	利助
RITARO	理太郎
RITSUJI	律次
RITSUKO	利津子
RITSUMI	律実
RITSUO	律夫
RITSUTO	律人
RITSUYA	律哉
RITTO	栗東
RIYA	里矢
RIYO	理代
RIYOKO	利代子
RO	朗
ROKUGO	六郷
ROKUNOHE	六戸
ROKUNOSUKE	六之助
ROKURO	六郎
ROKUSABURO	六三郎
ROKUSEI	鹿西
ROKUSUKE	六助
ROKUTARO	録太郎
ROMI	路美
RUI	塁
RUIKO	塁子
RUKA	流花
RUMI	流美
RUMIKO	瑠美子
RUMOI	留萌
RUN	潤
RURI	留里
RURIKO	瑠璃子
RURUKO	瑠縷子
RUTSUKO	路津子
RYO	了
RYOGO	了悟
RYOHEI	亮平
RYOICHI	亮一
RYOICHIRO	良一郎
RYOJI	了二
RYOKA	涼香
RYOKICHI	亮吉
RYOKO	了子
RYONOSUKE	良之助
RYOO	了夫
RYOSAKU	良作
RYOSUKE	了介
RYOTA	亮太
RYOTARO	涼太郎
RYOTSU	両津
RYOYA	良哉
RYOZEN	霊山
RYOZO	良三
RYU	留
RYUGO	竜吾
RYUHEI	龍平
RYUHOKU	竜北
RYUICHI	柳一
RYUICHIRO	竜一郎
RYUJI	竜二
RYUJIRO	竜二郎
RYUJO	隆丈
RYUKI	隆輝
RYUKICHI	竜吉
RYUKO	柳子
RYUKYU	琉球群島
RYUMA	竜馬
RYUNOSUKE	竜之介
RYUSAKU	竜作
RYUSHI	竜志
RYUSUKE	竜介
RYUTA	竜太
RYUTARO	柳太郎
RYUYA	竜弥
RYUZO	留三
SABAE	鯖江
SABURI	佐分利
SABURO	三朗
SACHI	佐知
SACHIE	佐智恵
SACHIHIKO	幸彦
SACHIHIRO	幸弘
SACHIKO	佐千子
SACHIMI	幸美
SACHIO	佐千夫
SACHIYO	佐千世
SADA	定
SADAAKI	定明
SADAE	定枝
SADAHARU	定春
SADAHIKO	貞彦
SADAHIRO	定宏
SADAHISA	貞久
SADAICHI	定一
SADAJI	定二
SADAJIRO	定二郎
SADAKATA	定方
SADAKAZU	定一
SADAKICHI	定吉
SADAKO	定子
SADAMASA	定昌
SADAMI	貞美
SADAMICHI	貞道
SADAMITSU	貞光
SADAMU	定
SADANOBU	貞信
SADANORI	貞典
SADAO	定夫
SADAOMI	定臣
SADASHI	貞司
SADATO	定人
SADATOSHI	定俊
SADATSUGU	定嗣
SADAYO	定世
SADAYOSHI	定好
SADAYUKI	定之
SADAZUMI	貞純
SADO	佐渡
SAE	佐恵
SAEGUSA	三枝
SAEKI	佐伯
SAEKO	佐恵子
SAEMI	三絵美
SAGA	佐賀
SAGAE	寒河江
SAGAMIHARA	相模原
SAGAMIKO	相模湖
SAGANOSEKI	佐賀関
SAGARA	相楽
SAGAWA	佐川
SAGEHASHI	提箸
SAGI	鷺
SAGITANI	鷺谷
SAGIYA	鷺谷
SAGUCHI	佐口
SAHARA	佐原
SAHASHI	佐橋
SAHEI	佐平
SAHO	佐帆
SAHODA	佐保田
SAI	佐井
SAICHI	佐一
SAICHIRO	佐一郎
SAIDA	斎田
SAIDO	道祖土
SAIGA	斉賀
SAIGAWA	犀川
SAIGO	西郷
SAIICHI	才一
SAIJO	西条
SAIKA	西河
SAIKAWA	斉川
SAIKI	佐伯
SAIKICHI	才吉
SAIKO	彩子
SAINEN	西念
SAINO	斉野
SAITAMA	埼玉
SAITO	斎藤
SAIWAI	幸
SAJI	佐二
SAJIMA	佐島
SAJIRO	佐次郎
SAJURO	佐十郎
SAKA	坂
SAKABA	坂場
SAKABE	坂部
SAKADO	坂戸
SAKAE	富
SAKAGAMI	坂上
SAKAGAWA	酒川
SAKAGI	坂木
SAKAGUCHI	坂口
SAKAHARA	坂原
SAKAI	坂井
SAKAIDA	境田
SAKAIDE	坂出
SAKAIMINATO	境港
SAKAINO	境野
SAKAIRI	坂入
SAKAJIRI	坂尻
SAKAKI	坂城
SAKAKO	坂子
SAKAKURA	坂倉
SAKAMA	坂間
SAKAMAKI	坂巻
SAKAMI	酒見
SAKAMOTO	坂元
SAKAMURA	坂村
SAKAN	昌
SAKANASHI	坂梨
SAKANE	坂根
SAKANISHI	坂西
SAKANIWA	坂庭
SAKANO	坂野
SAKAO	坂尾
SAKARAI	逆井
SAKARI	盛
SAKASAI	逆井
SAKASHI	智
SAKASHITA	坂下
SAKATA	坂田
SAKATANI	坂谷
SAKATO	坂戸
SAKAUCHI	坂内
SAKAUE	坂上
SAKAYORI	坂寄
SAKAZAKI	坂崎
SAKAZUME	坂詰
SAKETA	酒田
SAKI	佐季
SAKICHI	佐吉
SAKIE	佐紀江
SAKIKO	佐喜子
SAKIMI	咲美
SAKIMOTO	崎本
SAKIMURA	崎村
SAKIO	先雄
SAKITA	崎田
SAKIYAMA	崎山
SAKO	佐古
SAKODA	迫田
SAKON	左近
SAKU	佐久
SAKUJI	作次
SAKUJIRO	作次郎
SAKUKO	佐久子
SAKUMA	佐久間
SAKUMI	朔美
SAKUMOTO	作本
SAKUO	佐久雄
SAKURA	佐倉
SAKURABA	桜庭
SAKURABAYASHI	桜林
SAKURADA	桜田
SAKURAGAWA	桜川
SAKURAGI	桜木
SAKURAI	桜井
SAKURAKO	桜子
SAKURAMOTO	桜本
SAKURANIWA	桜庭
SAKURASHIN	桜新
SAKURAUCHI	桜内
SAKURAYA	桜谷
SAKURAYAMA	桜山
SAKURAZAWA	桜沢
SAKUSABE	作佐部
SAKUTA	作田
SAKUTARO	作太郎
SAKUYAMA	作山
SAKUZO	作蔵
SAKYO	左京
SAMATA	佐俣
SAMEGUCHI	鮫口
SAMEJIMA	鮫島
SAMON	佐門
SAMUKAWA	寒川
SAN'YUTEI	三遊亭
SANADA	真田
SANAE	佐奈江
SANAMI	佐波
SANBE	三部
SANBONGI	三本木
SANBU	山武
SANDA	三田
SANDAYU	三太夫
SANETOSHI	実俊
SANGO	山後
SANGU	三宮
SANJI	三次
SANJO	三条
SANKAWA	三川
SANKICHI	三吉
SANMIYA	三宮
SANMON	山門
SANNO	三野
SANNOHE	三戸
SANNOMIYA	三宮
SANNOSUKE	三之助
SANO	佐野
SANPEI	三平
SANPOKU	山北
SANSHIRO	三四郎
SANTA	三田
SANTARO	三太郎
SANTO	山東
SANUGA	佐怒賀
SANUI	讃井
SANUKI	佐貫
SANWA	三和
SANZO	三三
SAORI	佐緒理
SAOTOME	五月女
SAPPORO	札幌
SARA	沙羅
SARASA	更紗
SARASHINA	更科
SARATANI	更谷
SARI	沙理
SARUTA	猿田
SARUWATARI	猿渡
SARUYA	猿谷
SARUYAMA	猿山
SASAGE	捧
SASAGURI	篠栗
SASAYAMA	篠山
SASE	佐瀬
SASEBO	佐世保
SASHIDA	指田
SASHIMA	猿島
SASO	佐宗
SASUKE	佐助
SATA	佐多
SATAKE	佐武
SATANI	佐谷
SATARO	佐太郎
SATO	佐東
SATOAKI	聖明
SATOE	里恵
SATOKO	佐登子
SATOMI	佐登美
SATOMURA	里村
SATONAKA	里中
SATORU	了
SATOSHI	佐敏
SATSUKA	佐塚
SATSUKI	五月
SATSUKO	佐津子
SATTE	幸手
SAWA	沢
SAWABE	沢辺
SAWACHI	沢地
SAWADA	沢田
SAWAFUJI	沢藤
SAWAGUCHI	沢口
SAWAHARA	沢原
SAWAHATA	沢畑
SAWAI	沢井
SAWAIKE	沢池
SAWAKI	佐脇
SAWAKO	佐和子
SAWAMOTO	沢本
SAWAMURA	沢村
SAWANAKA	沢中
SAWANO	沢野
SAWANOBORI	沢登
SAWARA	佐原
SAWASAKI	沢崎
SAWATA	佐和田
SAWATANI	沢谷
SAWATARI	猿渡
SAWAYA	沢谷
SAWAYAMA	沢山
SAWAYANAGI	沢柳
SAWAZAKI	沢崎
SAYA	小夜
SAYAKA	沙也加
SAYAKO	清子
SAYAMA	佐山
SAYO	佐世
SAYOKO	佐代子
SAYUMI	佐由美
SAYURI	小有里
SAZUKA	佐塚
SEBATA	瀬畑
SEFUJI	瀬藤
SEGA	瀬賀
SEGAMI	瀬上
SEGAWA	瀬川
SEGI	瀬木
SEGUCHI	瀬口
SEI	征
SEIBUN	清文
SEIDA	清田
SEIDO	清藤
SEIGO	征吾
SEIGORO	政五郎
SEIHACHI	清八
SEIHIRO	誠宏
SEIICHI	征一
SEIICHIRO	成一郎
SEIJI	征二
SEIJIRO	征二郎
SEIKE	清家
SEIKI	清喜
SEIKICHI	清吉
SEIKO	勢子
SEINA	清名
SEINO	情野
SEINOSUKE	征之助
SEIRA	征良
SEIRO	聖籠
SEIROKU	清六
SEISAKU	清作
SEISHI	征之
SEISHICHI	清七
SEISHIRO	征四郎
SEISUKE	清介
SEITA	清太
SEITARO	清太郎
SEITO	清藤
SEIYA	世弥
SEIYU	征勇
SEIZABURO	清三郎
SEIZO	晴三
SEKI	石
SEKIDA	関田
SEKIDO	関戸
SEKIGAMI	関上
SEKIGAWA	関川
SEKIGUCHI	関口
SEKIHARA	関原
SEKII	関井
SEKIJO	関城
SEKIMIZU	関水
SEKIMOTO	関本
SEKIMURA	関村
SEKINE	関根
SEKINO	関野
SEKIOKA	関岡
SEKITA	赤田
SEKITO	石戸
SEKIUCHI	関内
SEKIWA	関和
SEKIYA	関屋
SEKIYADO	関宿
SEKIYAMA	関山
SEKIZAKI	関崎
SEKIZAWA	関沢
SEKIZUKA	関塚
SEKO	世古
SEMA	瀬間
SEN	宣
SEN'ICHI	仙一
SEN'ICHIRO	千一郎
SENA	世奈
SENBA	仙波
SENBOKU	仙北
SENCHO	千丁
SENDA	仙田
SENDAI	仙台
SENGA	千賀
SENGOKU	仙石
SENHATA	千畑
SENJI	仙司
SENJIRO	仙次郎
SENKAWA	泉川
SENKICHI	仙吉
SENNAN	泉南
SENNOSUKE	仙之助
SENO	妹尾
SENRI	千里
SENRO	千朗
SENSUI	泉水
SENSUKE	専助
SENTARO	仙太郎
SENUMA	瀬沼
SENZAKI	先崎
SENZO	仙蔵
SENZUI	泉水
SEO	瀬尾
SERA	世良
SERIKAWA	芹川
SERINA	瀬理奈
SERITA	芹田
SERIZAWA	芹沢
SESHIMO	瀬下
SESHITA	瀬下
SETA	瀬田
SETAGAYA	世田谷
SETAKA	瀬高
SETANI	瀬谷
SETO	瀬戸
SETOGAWA	瀬戸川
SETOGUCHI	瀬戸口
SETOI	瀬戸井
SETOYAMA	瀬戸山
SETSU	節
SETSUDA	説田
SETSUJI	節次
SETSUKO	世津子
SETSUMI	節美
SETSUO	摂夫
SETSURO	節郎
SETSUYA	節也
SETSUYUKI	節之
SETTSU	摂津
SEYA	瀬谷
SEYAMA	瀬山
SEZAI	瀬在
SEZAKI	瀬崎
SHANDONG	山東
SHANGPING	尚平
SHANGZHI	尚治
SHANJI	善吉
SHANRONG	善栄
SHEN	慎
SHENG	勝
SHENGPING	昇平
SHI	石
SHIBA	斯波
SHIBACHI	芝地
SHIBAGAKI	柴垣
SHIBAHARA	柴原
SHIBAKI	柴木
SHIBAMOTO	柴本
SHIBANO	柴野
SHIBANUMA	柴沼
SHIBASAKI	芝崎
SHIBATA	新発田
SHIBATANI	柴谷
SHIBAYA	柴谷
SHIBAYAMA	柴山
SHIBAZAKI	柴崎
SHIBETSU	士別
SHIBUE	渋江
SHIBUI	渋井
SHIBUICHI	四分一
SHIBUKAWA	渋川
SHIBUKI	渋木
SHIBUSAWA	渋沢
SHIBUTA	渋田
SHIBUTANI	渋谷
SHIBUYA	渋谷
SHICHI	志知
SHICHIJO	七城
SHICHINOHE	七戸
SHICHINOSUKE	七之助
SHICHIRI	七里
SHICHIRO	七郎
SHICHIZO	七三
SHIDA	信太
SHIDO	志藤
SHIGA	志賀
SHIGAMA	四釜
SHIGEAKI	成章
SHIGEEDA	重枝
SHIGEFUMI	成史
SHIGEHARA	茂原
SHIGEHARU	繁春
SHIGEHIDE	繁秀
SHIGEHIKO	滋彦
SHIGEHIRO	繁浩
SHIGEHISA	繁久
SHIGEHITO	茂人
SHIGEHO	茂穂
SHIGEICHI	茂一
SHIGEJI	繁次
SHIGEKATSU	茂勝
SHIGEKAWA	重川
SHIGEKAZU	成和
SHIGEKI	成樹
SHIGEKICHI	繁吉
SHIGEKO	恵子
SHIGEKUNI	茂国
SHIGEMASA	繁昌
SHIGEMATSU	繁松
SHIGEMI	成美
SHIGEMITSU	成光
SHIGEMORI	重森
SHIGEMOTO	重初
SHIGEMURA	重村
SHIGENAO	滋直
SHIGENARI	重成
SHIGENO	茂野
SHIGENOBU	成信
SHIGENORI	成則
SHIGEO	成夫
SHIGEOKA	重岡
SHIGEOKI	重沖
SHIGERO	繁郎
SHIGERU	卯
SHIGESABURO	繁三郎
SHIGESADA	重貞
SHIGESHI	彬
SHIGETA	繁田
SHIGETADA	繁忠
SHIGETAKA	繁孝
SHIGETAKE	重武
SHIGETARO	繁太郎
SHIGETO	重人
SHIGETOMI	重冨
SHIGETOSHI	茂俊
SHIGETSUGU	繁次
SHIGETSUNE	繁恒
SHIGEYA	茂也
SHIGEYAMA	茂山
SHIGEYASU	滋康
SHIGEYO	滋代
SHIGEYORI	重頼
SHIGEYOSHI	成由
SHIGEYUKI	成之
SHIGEZABURO	繁三郎
SHIGEZO	繁蔵
SHIHEI	四平
SHIHO	史帆
SHIHOKO	史穂子
SHIHOMI	志保美
SHIIBA	椎葉
SHIIBARA	椎原
SHIIBASHI	椎橋
SHIIDA	椎田
SHIIHARA	椎原
SHIIKI	椎木
SHIINA	椎名
SHIINO	椎野
SHIINOKI	椎木
SHIITANI	椎谷
SHIIYA	椎谷
SHIIZU	椎津
SHIJONAWATE	四条畷
SHIKA	志賀
SHIKADA	鹿田
SHIKAHAMA	鹿浜
SHIKAKURA	鹿倉
SHIKAMA	志鎌
SHIKANAI	鹿内
SHIKANO	鹿野
SHIKATA	四方
SHIKATANI	鹿谷
SHIKAUCHI	鹿内
SHIKAYAMA	鹿山
SHIKI	四季
SHIKIDA	式田
SHIKIKO	式子
SHIKIMA	色摩
SHIKISHIMA	敷島
SHIKOKU	四国
SHIMA	島
SHIMABARA	島原
SHIMABUKURO	島袋
SHIMADA	島田
SHIMAGAGE	島影
SHIMAGAMI	島上
SHIMAGUCHI	島口
SHIMAJIRI	嶋尻
SHIMAKATA	島方
SHIMAKAWA	島川
SHIMAKO	島子
SHIMAKURA	島倉
SHIMAMOTO	島本
SHIMAMUNE	島宗
SHIMAMURA	島村
SHIMANAKA	島中
SHIMANE	島根
SHIMANO	島野
SHIMANUKI	島貫
SHIMAOKA	島岡
SHIMASAWA	島沢
SHIMATANI	島谷
SHIMAUCHI	島内
SHIMAYA	島谷
SHIMAYAMA	島山
SHIMAZAKI	島崎
SHIMAZAWA	嶋沢
SHIMAZU	島津
SHIME	七五三
SHIMEO	七五三夫
SHIMIYA	四宮
SHIMIZU	志水
SHIMO	下
SHIMOCHI	下地
SHIMODA	下田
SHIMODAIRA	下平
SHIMODATE	下館
SHIMODE	下出
SHIMOFUSA	下総
SHIMOGAWARA	下川原
SHIMOGO	下郷
SHIMOGUCHI	下口
SHIMOGYO	下京
SHIMOHARA	下原
SHIMOHIRA	下平
SHIMOI	下井
SHIMOJI	下地
SHIMOJIMA	下島
SHIMOKA	下岡
SHIMOKAWA	下川
SHIMOKOBE	下河辺
SHIMOKOSHI	霜越
SHIMOKURA	下倉
SHIMOMA	下間
SHIMOMICHI	下道
SHIMOMOTO	下元
SHIMOMURA	下村
SHIMONAKA	下中
SHIMONISHI	下西
SHIMONITA	下仁田
SHIMONO	下野
SHIMONOSEKI	下関
SHIMORA	下浦
SHIMOSAKA	下坂
SHIMOSAKI	下崎
SHIMOSATO	下里
SHIMOSAWA	下沢
SHIMOSUWA	下諏訪
SHIMOTANI	下谷
SHIMOTOME	下斗米
SHIMOTORI	下鳥
SHIMOTSUMA	下妻
SHIMOYA	下谷
SHIMOYAMA	下山
SHIMOYAMADA	下山田
SHIMOZATO	下里
SHIMOZONO	下園
SHIMOZU	下津
SHIMOZUMA	下妻
SHIMURA	志村
SHIN	伸
SHIN'ICHI	伸一
SHIN'ICHIRO	伸一郎
SHIN'YA	伸也
SHINA	志奈
SHINADA	品田
SHINAE	史奈恵
SHINAGAWA	品川
SHINAKO	史奈子
SHINANO	信濃
SHINBA	榛葉
SHINBARA	新原
SHINBO	新保
SHINBORI	新堀
SHINBUKU	新福
SHINCHI	新地
SHINDO	新堂
SHINGAI	真貝
SHINGAKI	新垣
SHINGO	伸五
SHINGU	新宮
SHINJI	伸二
SHINJIRO	伸次郎
SHINJO	新庄
SHINJUKU	新宿
SHINKAI	新海
SHINKAWA	新川
SHINKI	新木
SHINKICHI	伸吉
SHINKO	伸子
SHINMA	新間
SHINMACHI	新町
SHINMEI	新名
SHINMI	新見
SHINMINATO	新湊
SHINMIYA	新宮
SHINMOTO	新本
SHINMURA	新村
SHINNAN'YO	新南陽
SHINNOSUKE	信之介
SHINO	志乃
SHINOBU	忍
SHINODA	信太
SHINOHARA	篠原
SHINOHE	四戸
SHINOKI	篠木
SHINOMIYA	四宮
SHINOMOTO	篠本
SHINOSHIMA	篠島
SHINOYAMA	篠山
SHINOZAKI	篠崎
SHINOZAWA	篠沢
SHINOZUKA	篠塚
SHINPA	榛葉
SHINPEI	信平
SHINROKU	真六
SHINSAKU	新作
SHINSHI	進士
SHINSHIRO	新城
SHINSHUSHIN	信州新
SHINSUKE	伸介
SHINTAKU	新宅
SHINTANI	新谷
SHINTARO	伸太郎
SHINTONE	新利根
SHINZABURO	新三郎
SHINZAKI	新崎
SHINZAWA	新沢
SHINZO	伸三
SHIO	史緒
SHIOBARA	塩原
SHIODA	塩田
SHIOE	史緒恵
SHIOGAMA	塩竃
SHIOI	塩井
SHIOIRI	塩入
SHIOJI	塩路
SHIOJIMA	塩島
SHIOJIRI	塩尻
SHIOKAWA	塩川
SHIOMI	史緒実
SHIONO	塩野
SHIONOME	塩野目
SHIONOYA	塩野谷
SHIORA	塩浦
SHIORI	史織
SHIOSAKA	塩坂
SHIOTANI	塩谷
SHIOTSUKA	塩塚
SHIOTSUKI	塩月
SHIOWAKI	塩脇
SHIOYA	塩屋
SHIOYAMA	塩山
SHIOZAKI	塩崎
SHIOZAWA	塩沢
SHIOZU	塩津
SHIOZUKI	塩月
SHIRAE	白江
SHIRAFUJI	白藤
SHIRAGAMI	白神
SHIRAHAMA	白浜
SHIRAHASHI	白橋
SHIRAHATA	白幡
SHIRAI	白井
SHIRAISHI	白石
SHIRAIWA	白岩
SHIRAKAMI	白神
SHIRAKATA	白方
SHIRAKAWA	白川
SHIRAKI	白木
SHIRAKO	白子
SHIRAKURA	白倉
SHIRAMIZU	白水
SHIRANE	白根
SHIRANUHI	不知火
SHIRAO	白尾
SHIRAOKA	白岡
SHIRASAKA	白坂
SHIRASAKI	白崎
SHIRASAWA	白沢
SHIRASE	白瀬
SHIRASU	白須
SHIRASUNA	白砂
SHIRATAKA	白鷹
SHIRATAKI	白滝
SHIRATANI	白谷
SHIRATO	白土
SHIRATORI	白取
SHIRATSUCHI	白土
SHIRAYAMA	白山
SHIRO	史朗
SHIROCHI	城内
SHIROE	白江
SHIROGANE	白銀
SHIROI	城井
SHIROISHI	白石
SHIROIWA	白岩
SHIROKAMI	白神
SHIROMIZU	白水
SHIROMOTO	城本
SHIRONE	白根
SHIRONO	城野
SHIROSAKA	白坂
SHIROSAKI	白崎
SHIROSAWA	白沢
SHIROSU	白須
SHIROSUNA	白砂
SHIROTA	代田
SHIROTANI	城谷
SHIROTO	城戸
SHIROYAMA	城山
SHIROYANAGI	白柳
SHIROZU	白水
SHISABURO	治三郎
SHISHIDO	宍戸
SHISHIKURA	宍倉
SHITANAKA	下中
SHITARA	設楽
SHITAZAWA	下沢
SHITO	市東
SHIUNJI	紫雲寺
SHIWA	志和
SHIZU	志津
SHIZUE	志津恵
SHIZUHARU	静春
SHIZUHIKO	鎮彦
SHIZUKA	静
SHIZUKO	志津子
SHIZUKU	雫
SHIZUKUISHI	雫石
SHIZUMA	静馬
SHIZUME	鎮目
SHIZUO	志津夫
SHIZUOKA	静岡
SHIZUYA	静谷
SHIZUYO	志津代
SHO	勝
SHOBARA	庄原
SHOBU	庄武
SHOGAWA	庄川
SHOGO	将吾
SHOGORO	昭吾郎
SHOHACHI	庄八
SHOHEI	尚平
SHOICHI	勝一
SHOICHIRO	彰一郎
SHOJI	勝二
SHOJIRO	正次郎
SHOKEI	紹慶
SHOKICHI	庄吉
SHOKO	唱子
SHONAI	庄内
SHONAN	沼南
SHONOSUKE	庄之助
SHOROKU	昇六
SHORYU	昇竜
SHOSAKU	正作
SHOSEI	照星
SHOSHICHI	昭七
SHOSUKE	彰祐
SHOTA	昇太
SHOTARO	昇太郎
SHOWA	庄和
SHOZABURO	庄三郎
SHOZO	勝三
SHU	周
SHUGO	修吾
SHUGORO	脩五郎
SHUHEI	修平
SHUICHI	修一
SHUICHIRO	修一郎
SHUJI	修二
SHUKICHI	周吉
SHUKO	修子
SHULI	樹利
SHUMI	修実
SHUN	俊
SHUN'ICHI	俊一
SHUN'ICHIRO	俊一郎
SHUN'YA	俊哉
SHUNJI	俊二
SHUNKICHI	俊吉
SHUNPEI	俊平
SHUNRO	俊郎
SHUNROKU	俊六
SHUNSAKU	俊作
SHUNSUKE	俊介
SHUNTA	俊太
SHUNTARO	俊太郎
SHUNZO	俊三
SHUSAKU	修作
SHUSUKE	修介
SHUTA	秀太
SHUYA	秀哉
SHUZEN	秀全
SHUZO	修三
SIJI	四季
SIPING	四平
SO	創
SOBASHIMA	傍島
SOBEI	壮平
SOBUE	祖父江
SODA	左右田
SODEYAMA	袖山
SOEDA	添田
SOEJIMA	副島
SOENO	添野
SOETA	添田
SOEYA	添谷
SOFUE	祖父江
SOGA	曾我
SOGABE	曽我部
SOGAWA	十川
SOGI	曽木
SOGO	十河
SOHACHI	宗八
SOHEI	創平
SOICHI	壮一
SOICHIRO	壮一郎
SOJA	総社
SOJI	創二
SOJIRO	壮二郎
SOKA	草加
SOKICHI	壮吉
SOKO	草子
SOKUN	宗薫
SOMA	相馬
SOMEGORO	染五郎
SOMEI	染井
SOMEKAWA	染川
SOMEKO	染子
SOMEMIYA	染宮
SOMENO	染野
SOMEYA	染谷
SONE	曾根
SONEDA	曽根田
SONEHARA	曽根原
SONO	園
SONOBE	園部
SONODA	其田
SONOE	園恵
SONOKO	園子
SONOMI	園美
SONOSUKE	惣之助
SONOYAMA	園山
SORIMACHI	反町
SORITA	反田
SOROKU	壮六
SOSAKU	宗作
SOSHI	曽雌
SOSHICHI	壮七
SOSHIRO	惣四郎
SOSUKE	創介
SOTA	創太
SOTANI	曽谷
SOTARO	宗太郎
SOTOIKE	外池
SOTOKICHI	外吉
SOTOME	五月女
SOTOYA	外谷
SOTOYAMA	外山
SOTOZAKI	外崎
SOWA	総和
SOYA	創也
SOYAMA	曽山
SOYO	蘇陽
SOZABURO	僧三郎
SOZEN	宗全
SUBARA	須原
SUBARU	昴
SUDA	須田
SUDO	周藤
SUE	末
SUEDA	末田
SUEGORO	末五郎
SUEHARU	末春
SUEHIRO	末広
SUEICHI	末一
SUEJI	末次
SUEJIRO	末次郎
SUEKI	末木
SUEKICHI	末吉
SUEKO	寿恵子
SUEMATSU	末松
SUEMITSU	末光
SUEMORI	末盛
SUEMURA	末村
SUENAGA	末永
SUEO	季夫
SUEOKA	末岡
SUETAKA	季孝
SUETAKE	末武
SUETARO	末太郎
SUETOMI	末冨
SUETSUGU	末次
SUEYOSHI	末吉
SUEZAWA	末沢
SUEZO	末蔵
SUGA	菅
SUGADA	須賀田
SUGAHARA	菅原
SUGAI	菅井
SUGAKO	寿賀子
SUGAMA	菅間
SUGAMATA	菅又
SUGAMOTO	菅本
SUGANAMI	菅波
SUGANO	菅野
SUGANUMA	菅沼
SUGASAWA	菅沢
SUGASAWARA	菅佐原
SUGATA	菅田
SUGAWA	須川
SUGAWARA	菅原
SUGAYA	菅家
SUGAYAMA	菅山
SUGENAMI	菅波
SUGEO	菅生
SUGETA	菅田
SUGI	杉
SUGIBAYASHI	杉林
SUGIBUCHI	杉淵
SUGIE	杉江
SUGIHARA	杉原
SUGII	杉井
SUGIKI	杉木
SUGIMORI	杉森
SUGIMOTO	杉元
SUGIMURA	杉村
SUGINAMI	杉並
SUGINO	杉野
SUGIO	杉夫
SUGIOKA	杉岡
SUGISAKA	杉坂
SUGISAKI	杉崎
SUGISAWA	杉沢
SUGISHIMA	杉島
SUGISHITA	杉下
SUGITA	杉田
SUGITANI	杉谷
SUGITO	杉戸
SUGIUCHI	杉内
SUGIURA	杉浦
SUGIYAMA	杉山
SUGIZAKI	杉崎
SUGO	菅生
SUGUHO	直穂
SUGURO	勝呂
SUGURU	俊
SUHARA	栖原
SUIBARA	水原
SUITA	吹田
SUITSU	水津
SUKAGAWA	須賀川
SUKAMA	須釜
SUKE	輔
SUKEGAWA	佑川
SUKEHACHIRO	助八郎
SUKEJIRO	助次郎
SUKEMITSU	祐光
SUKENAO	助直
SUKEO	助夫
SUKETAKA	祐尭
SUKIE	鍬柄
SUKUMO	宿毛
SUMA	須磨
SUMAKO	寿摩子
SUMI	住
SUMIAKI	澄明
SUMIDA	墨田
SUMIE	住恵
SUMIHARU	純治
SUMIHIKO	澄彦
SUMIHIRO	純宏
SUMII	角井
SUMIKA	寿美佳
SUMIKAWA	住川
SUMIKO	壽美子
SUMIKURA	角倉
SUMIMOTO	住本
SUMINAMI	角南
SUMINO	住野
SUMINOE	住之江
SUMINORI	純典
SUMIO	住夫
SUMIRE	寿美礼
SUMITA	住田
SUMITAKA	住孝
SUMITANI	住谷
SUMITO	澄人
SUMITOMO	住友
SUMITOSHI	純俊
SUMIYA	角屋
SUMIYAMA	住山
SUMIYO	寿美世
SUMIYOSHI	住吉
SUMOMO	李
SUMOTO	栖本
SUNADA	砂田
SUNAGA	須永
SUNAGAWA	砂川
SUNAHARA	砂原
SUNAMI	角南
SUNANAGA	砂永
SUNAO	侃
SUNAOKA	砂岡
SUNAOSHI	砂押
SUNATSUKA	砂塚
SUNAYAMA	砂山
SUNOCHI	須之内
SUNOHARA	春原
SUOMI	須緒美
SUPING	素平
SURUGA	駿河
SUSA	諏佐
SUSAKI	須崎
SUSONO	裾野
SUSUKIDA	薄田
SUSUMU	一
SUTEHARU	捨春
SUTEKO	捨子
SUWA	諏訪
SUWABE	諏訪部
SUYAMA	陶山
SUZAKA	須坂
SUZAKI	洲崎
SUZAWA	須沢
SUZU	珠洲
SUZUE	鈴恵
SUZUI	鈴井
SUZUKA	鈴香
SUZUKAWA	鈴川
SUZUKI	鈴木
SUZUKICHI	鈴吉
SUZUKO	鈴子
SUZUMURA	鈴村
SUZUNE	涼音
SUZUNO	鈴野
SUZUO	鈴夫
SUZUTA	鈴田
SUZUYO	鈴代
TABATA	田幡
TABAYASHI	田林
TABE	田部
TABEI	田部井
TABUCHI	田淵
TABUSE	田伏
TACHI	舘
TACHIARAI	大刀洗
TACHIBANA	橘
TACHIHARA	立原
TACHIKAWA	太刀川
TACHIKI	立木
TACHIKO	多智子
TACHISAWA	立沢
TACHIZAKI	立崎
TACHIZAWA	立沢
TADA	多田
TADAAKI	忠彰
TADAE	唯衛
TADAFUMI	忠文
TADAHARU	忠春
TADAHIKO	忠彦
TADAHIRO	忠博
TADAHISA	忠久
TADAHITO	忠人
TADAIE	忠家
TADAKATSU	忠克
TADAKAZU	忠一
TADAKI	但木
TADAKIYO	忠清
TADAKO	忠子
TADAMASA	忠政
TADAMI	只見
TADAMICHI	忠通
TADAMITSU	忠光
TADANAO	忠尚
TADANARI	忠成
TADANO	但野
TADANOBU	忠伸
TADANORI	忠典
TADAO	只夫
TADAOKI	忠興
TADASHI	伊
TADASHIGE	忠重
TADASU	矩
TADASUKE	忠助
TADATAKA	忠孝
TADATOSHI	唯利
TADATSUGU	忠次
TADAYA	忠也
TADAYASU	忠泰
TADAYORI	忠頼
TADAYOSHI	唯義
TADAYUKI	忠之
TADENUMA	蓼沼
TADO	田戸
TADOKORO	田所
TAE	多恵
TAEKO	多恵子
TAEMI	妙美
TAGA	多賀
TAGAJO	多賀城
TAGAMI	田上
TAGASHIRA	田頭
TAGATA	田形
TAGATANI	多賀谷
TAGAWA	多川
TAGAYA	多賀谷
TAGO	多胡
TAGUCHI	田口
TAGUMA	田熊
TAGUSARI	田鎖
TAHARA	田原
TAI	台
TAICHI	太一
TAICHIRO	太一朗
TAIEI	大栄
TAIGEN	泰源
TAIHEI	泰平
TAIHOKU	台北
TAIICHI	太一
TAIICHIRO	太一郎
TAIJI	泰二
TAIJIRO	泰次郎
TAIKO	泰子
TAIMA	当麻
TAIMEI	岱明
TAINAKA	田井中
TAIPING	泰平
TAIRA	平
TAISAKU	泰作
TAISEI	泰正
TAISHA	大社
TAISHIRO	泰四郎
TAISHO	大正
TAISUKE	太亮
TAITO	台東
TAIYUAN	泰源
TAIZO	戴三
TAJIKA	田近
TAJIMA	但馬
TAJIMI	多治見
TAJIRI	田尻
TAJIRO	多治郎
TAKA	高
TAKAAKI	孝明
TAKABA	高場
TAKABAYASHI	高林
TAKABE	高部
TAKACHI	高地
TAKACHIO	高知尾
TAKADA	高田
TAKADAIRA	高平
TAKADERA	高寺
TAKAE	孝恵
TAKAFUJI	高藤
TAKAFUMI	孝史
TAKAGAKI	高垣
TAKAGI	高城
TAKAGISHI	高岸
TAKAGIWA	高際
TAKAGUCHI	高口
TAKAHAGI	高萩
TAKAHAMA	高浜
TAKAHANE	高羽
TAKAHARA	高原
TAKAHARU	孝治
TAKAHASHI	高梁
TAKAHATA	高畑
TAKAHIDE	孝秀
TAKAHIKO	孝彦
TAKAHIRA	高平
TAKAHIRO	孝博
TAKAHISA	喬久
TAKAHITO	孝人
TAKAHORI	高堀
TAKAI	高井
TAKAICHI	隆一
TAKAISHI	高石
TAKAIWA	高岩
TAKAJI	孝二
TAKAKAZU	孝一
TAKAKO	卓子
TAKAKU	高久
TAKAKUMO	高雲
TAKAKUNI	孝久爾
TAKAKURA	高倉
TAKAKUSAGI	高草木
TAKAKUWA	高桑
TAKAMA	高間
TAKAMASA	孝政
TAKAMATSU	高松
TAKAMI	多芳美
TAKAMICHI	孝充
TAKAMINE	高峯
TAKAMITSU	孝光
TAKAMIYA	高宮
TAKAMIZAWA	高見沢
TAKAMIZU	高水
TAKAMORI	隆盛
TAKAMOTO	高本
TAKAMURA	高村
TAKANA	孝奈
TAKANAKA	高中
TAKANAMI	高波
TAKANAO	孝尚
TAKANARI	孝成
TAKANASHI	高梨
TAKANE	高根
TAKANEZAWA	高根沢
TAKANI	高荷
TAKANISHI	高西
TAKANO	高埜
TAKANOBU	孝伸
TAKANORI	孝典
TAKANOSU	鷹巣
TAKANUMA	高沼
TAKAO	喬夫
TAKAOKA	高岡
TAKAOKI	隆興
TAKARA	宝
TAKARABE	財部
TAKARADA	宝田
TAKARAI	宝井
TAKARAZUKA	宝塚
TAKARO	隆郎
TAKASAGO	高砂
TAKASAKA	高坂
TAKASAKI	高崎
TAKASAWA	高沢
TAKASE	高瀬
TAKASHI	上
TAKASHIBA	高柴
TAKASHIGE	孝成
TAKASHIKA	高鹿
TAKASHIMA	高島
TAKASHIMIZU	高清水
TAKASHINA	高品
TAKASHIO	高塩
TAKASHITA	高下
TAKASU	高須
TAKASUGA	高須賀
TAKASUGI	高杉
TAKASUKA	高須賀
TAKASUMI	孝澄
TAKATA	高田
TAKATAMA	高玉
TAKATANI	高谷
TAKATERU	隆輝
TAKATO	孝人
TAKATOMO	孝友
TAKATORI	高取
TAKATOSHI	孝俊
TAKATOYO	隆豊
TAKATSU	高津
TAKATSUDO	高津戸
TAKATSUGU	孝次
TAKATSUKA	高塚
TAKATSUKI	高月
TAKAUCHI	高内
TAKAURA	高浦
TAKAYA	孝哉
TAKAYAMA	高山
TAKAYANAGI	高柳
TAKAYASU	孝保
TAKAYO	孝世
TAKAYOSHI	孝允
TAKAYUKI	享之
TAKAZO	隆三
TAKE	武
TAKEAKI	丈明
TAKEBAYASHI	武林
TAKEBE	武部
TAKEBUCHI	竹淵
TAKECHI	武市
TAKEDA	武田
TAKEE	武江
TAKEFU	武生
TAKEFUMI	健文
TAKEGAMI	竹上
TAKEGAWA	竹川
TAKEGOSHI	竹腰
TAKEGUCHI	竹口
TAKEHANA	竹花
TAKEHARA	武原
TAKEHARU	武敏
TAKEHIDE	健英
TAKEHIKO	丈彦
TAKEHIRA	竹平
TAKEHIRO	丈裕
TAKEHISA	丈久
TAKEHITO	丈人
TAKEI	武井
TAKEICHI	武一
TAKEISHI	武石
TAKEJI	武二
TAKEJIRO	武次郎
TAKEKAWA	武川
TAKEKAZU	武一
TAKEKI	岳樹
TAKEKO	丈子
TAKEKOSHI	竹腰
TAKEKUMA	武隈
TAKEKUNI	丈邦
TAKEMAE	竹前
TAKEMASA	武政
TAKEMATA	竹俣
TAKEMATSU	竹松
TAKEMI	武実
TAKEMITSU	健光
TAKEMIYA	武宮
TAKEMORI	竹森
TAKEMOTO	武本
TAKEMURA	武村
TAKENAGA	竹永
TAKENAKA	武中
TAKENO	武野
TAKENOBU	武信
TAKENOCHI	竹之内
TAKENORI	孟紀
TAKENOSHITA	竹之下
TAKEO	丈夫
TAKEOKA	武岡
TAKERO	猛郎
TAKERU	健
TAKESABURO	竹三郎
TAKESAKI	竹崎
TAKESAKO	竹迫
TAKESHI	丈
TAKESHIMA	武島
TAKESHIRO	武四郎
TAKESHITA	武下
TAKETA	竹田
TAKETANI	武谷
TAKETO	丈人
TAKETOMI	武冨
TAKETOSHI	武俊
TAKETSUGU	武次
TAKEUCHI	武内
TAKEUE	竹上
TAKEWAKI	竹脇
TAKEYA	武谷
TAKEYAMA	武山
TAKEYO	健世
TAKEYOSHI	武喜
TAKEYUKI	健之
TAKEZAKI	竹崎
TAKEZAWA	武沢
TAKEZO	武三
TAKI	多喜
TAKICHI	太吉
TAKIE	多喜枝
TAKIGAMI	滝上
TAKIGAWA	滝川
TAKIGUCHI	滝口
TAKIHARA	滝原
TAKII	滝井
TAKIKAWA	滝川
TAKIKO	多喜子
TAKIMOTO	滝本
TAKIMURA	滝村
TAKINAMI	滝波
TAKINE	滝根
TAKINO	滝野
TAKIO	多喜夫
TAKISE	滝瀬
TAKISHIMA	滝島
TAKISHITA	滝下
TAKITA	瀧田
TAKITANI	滝谷
TAKIUCHI	滝内
TAKIUE	滝上
TAKIWAKI	滝脇
TAKIYA	滝谷
TAKIYAMA	滝山
TAKIYO	多喜代
TAKIZAWA	滝沢
TAKIZO	多喜蔵
TAKKO	田子
TAKO	多古
TAKU	卓
TAKUBO	田久保
TAKUEI	卓英
TAKUHARU	琢治
TAKUICHI	卓一
TAKUJI	卓二
TAKUMA	卓真
TAKUMI	匠
TAKUO	卓夫
TAKURA	田倉
TAKURO	卓朗
TAKUSHI	卓史
TAKUYA	卓也
TAKUZO	卓三
TAMA	多摩
TAMADA	玉田
TAMAE	玉恵
TAMAGAMI	玉上
TAMAGAWA	玉川
TAMAI	玉井
TAMAKA	圭郁
TAMAKI	玉城
TAMAKICHI	玉吉
TAMAKO	多摩子
TAMAKOSHI	玉越
TAMAMI	多摩実
TAMAMOTO	玉本
TAMAMURA	玉村
TAMAMUSHI	玉虫
TAMANA	玉名
TAMANO	玉野
TAMAO	多摩夫
TAMAOKA	玉岡
TAMAOKI	玉置
TAMARI	玉利
TAMARU	田丸
TAMASAWA	玉沢
TAMATANI	玉谷
TAMATE	玉手
TAMATSUKURI	玉造
TAMAYA	玉谷
TAMAYAMA	玉山
TAMAYO	多満代
TAMAZAWA	玉沢
TAMEGAI	為我井
TAMEHIRO	為広
TAMEICHIRO	為一郎
TAMEJI	為治
TAMEKAZU	為一
TAMEKICHI	為吉
TAMEKO	多米子
TAMEO	為夫
TAMESHIGE	為重
TAMEYOSHI	為義
TAMI	多美
TAMIAKI	民明
TAMIE	多美恵
TAMIHIKO	民彦
TAMIJI	多美次
TAMIKO	多美子
TAMIO	多美夫
TAMITOSHI	民俊
TAMIYA	田宮
TAMIYASU	民保
TAMIYO	民代
TAMIYOSHI	民好
TAMO	保夫
TAMORI	田森
TAMOTSU	保
TAMUKE	田向
TAMURA	田村
TAN	丹
TANAAMI	棚網
TANABE	田名部
TANADA	棚田
TANAGURA	棚倉
TANAHASHI	棚橋
TANAI	棚井
TANAKA	田中
TANAKI	棚木
TANAMI	田波
TANAMURA	棚村
TANASAWA	棚沢
TANASE	棚瀬
TANASHI	田無
TANBA	丹波
TANBO	反保
TANEDA	種子田
TANEICHI	種市
TANEMURA	種村
TANEO	種男
TANGE	丹下
TANI	谷
TANIAI	谷合
TANIBE	谷部
TANIDA	谷田
TANIE	谷江
TANIFUJI	谷藤
TANIGAKI	谷垣
TANIGAMI	谷上
TANIGAWA	谷川
TANIGUCHI	谷口
TANIHARA	谷原
TANIHATA	谷畑
TANIHIRA	谷平
TANII	谷井
TANIMOTO	谷本
TANIMURA	谷村
TANINAKA	谷中
TANINO	谷野
TANIOKA	谷岡
TANIOKU	谷奥
TANISHIMA	谷島
TANITO	谷藤
TANIUCHI	谷内
TANIUE	谷上
TANIWAKI	谷脇
TANIYAMA	谷山
TANIZAKI	谷崎
TANIZAWA	谷沢
TANIZU	谷津
TANJI	丹治
TANNAI	丹内
TANNO	丹野
TANO	田野
TANOCHI	田内
TANOE	田上
TANOGUCHI	田野口
TANOI	田野井
TANORA	田浦
TANSEI	丹生
TANUMA	田沼
TANUSHIMARU	田主丸
TANZAWA	丹沢
TAO	田尾
TAOKA	田岡
TARAGI	多良木
TARAO	多羅尾
TARO	太朗
TARUI	樽井
TARUKAWA	樽川
TARUMI	垂水
TARUMIZU	垂水
TARUMOTO	樽本
TARUYA	樽谷
TASABURO	多三郎
TASAKA	田坂
TASHIRO	田代
TASUKE	助
TASUKU	亮
TATARA	多田羅
TATE	楯
TATEBAYASHI	立林
TATEBE	建部
TATEDA	舘田
TATEIRI	立入
TATEISHI	建石
TATEIWA	立岩
TATEJIMA	立島
TATEMATSU	立松
TATENO	館野
TATEO	建夫
TATEOKA	立岡
TATESHINA	立科
TATEUCHI	舘内
TATEYAMA	立山
TATSU	多津
TATSUE	辰江
TATSUGORO	辰五郎
TATSUHARU	辰春
TATSUHIKO	建彦
TATSUICHI	辰一
TATSUICHIRO	達一郎
TATSUJI	辰二
TATSUJIRO	辰二郎
TATSUKE	田附
TATSUKI	樹
TATSUKO	多津子
TATSUMASA	辰勝
TATSUMI	巽
TATSUMORI	達守
TATSUNO	立野
TATSUNOKUCHI	辰口
TATSUNORI	辰典
TATSUNOSUKE	辰之助
TATSUO	健夫
TATSURO	竜郎
TATSURUHAMA	田鶴浜
TATSUSABURO	辰三郎
TATSUSHI	達司
TATSUTA	立田
TATSUTARO	達太郎
TATSUTOSHI	達俊
TATSUYA	竜也
TATSUYO	多津代
TATSUYUKI	辰之
TATSUZAWA	立沢
TATSUZO	辰三
TAUCHI	田内
TAUE	田上
TAURA	田浦
TAWA	田和
TAWADA	多和田
TAWARA	俵
TAWARAYA	俵谷
TAWARAYAMA	俵山
TAYA	田家
TAYAMA	田山
TAZAKI	田崎
TAZAWA	田沢
TAZAWAKO	田沢湖
TAZOE	田添
TAZUKO	多津子
TEGAWA	手川
TEI	悌
TEIGO	定悟
TEIICHI	禎一
TEIICHIRO	悌一郎
TEIJI	定二
TEIJIRO	定次郎
TEIKICHI	貞吉
TEIKO	汀子
TEINE	手稲
TEIZABURO	貞三郎
TEIZO	禎三
TEJIMA	手島
TENDA	天田
TENG	藤
TENKO	典子
TENMEI	天明
TENNO	天王
TENNOJI	天王寺
TENPAKU	天白
TENRI	天理
TENZO	典三
TERA	寺
TERABAYASHI	寺林
TERACHI	寺地
TERADA	寺田
TERADO	寺戸
TERADOMARI	寺泊
TERAGOCHI	寺河内
TERAGUCHI	寺口
TERAHARA	寺原
TERAI	寺井
TERAKADO	寺門
TERAKAWA	寺川
TERAKI	寺木
TERAKURA	寺倉
TERAMACHI	寺町
TERAMAE	寺前
TERAMOTO	寺元
TERAMURA	寺村
TERANISHI	寺西
TERANO	寺野
TERAO	寺尾
TERAOKA	寺岡
TERASAKA	寺坂
TERASAKI	寺前
TERASAWA	寺沢
TERASHI	寺師
TERASHIMA	寺島
TERASHITA	寺下
TERASU	暉
TERATANI	寺谷
TERAUCHI	寺内
TERAURA	寺浦
TERAWAKI	寺脇
TERAYAMA	寺山
TERU	照
TERUAKI	昭明
TERUCHI	照内
TERUE	照恵
TERUFUMI	照文
TERUHIDE	輝秀
TERUHIKO	照彦
TERUHIRO	輝宏
TERUHISA	照久
TERUHO	輝穂
TERUI	照井
TERUICHI	輝一
TERUJI	照治
TERUKAZU	昭一
TERUKI	輝機
TERUKICHI	照吉
TERUKO	光子
TERUKUNI	光邦
TERUMASA	照正
TERUMI	光美
TERUMICHI	晃道
TERUMITSU	照光
TERUMOTO	輝元
TERUNOBU	輝信
TERUNUMA	照沼
TERUO	光夫
TERUSADA	昭定
TERUSHI	輝士
TERUTO	輝人
TERUTSUGU	輝次
TERUYA	晃弥
TERUYAMA	照山
TERUYO	昭代
TERUYOSHI	光良
TERUYUKI	照之
TESHIGAWARA	勅使川原
TESHIMA	手嶋
TESHIROGI	手代木
TETSU	哲
TETSUAKI	哲明
TETSUE	哲枝
TETSUGORO	鉄五郎
TETSUHIKO	哲彦
TETSUHIRO	哲寛
TETSUJI	哲二
TETSUJIRO	哲次郎
TETSUKAZU	哲一
TETSUKO	哲子
TETSUMI	哲実
TETSUNORI	鉄則
TETSUNOSUKE	鉄之助
TETSUO	哲夫
TETSURO	哲朗
TETSUSABURO	鉄三郎
TETSUSHI	哲史
TETSUTARO	哲太朗
TETSUYA	哲也
TETSUYOSHI	哲良
TETSUZO	哲三
TEZUKA	手塚
TIANMING	天明
TIE	鉄
TO	藤
TOBA	戸羽
TOBARI	戸張
TOBATA	戸畑
TOBE	戸辺
TOBIISHI	飛石
TOBIMATSU	飛松
TOBINAGA	飛永
TOBISAWA	飛沢
TOBITA	飛田
TOBIYAMA	飛山
TOBU	東部
TOCHI	登内
TOCHIGI	栃木
TOCHIO	栃尾
TODA	戸田
TODAKA	戸高
TODATE	戸舘
TODO	藤堂
TODOKI	十時
TODOKORO	冨所
TODOME	留目
TODOROKI	轟
TOE	戸上
TOEDA	戸枝
TOGAMI	戸上
TOGANE	東金
TOGANO	戸叶
TOGASHI	富樫
TOGAWA	外川
TOGI	富来
TOGO	東吾
TOGUCHI	戸口
TOGURA	戸倉
TOHARA	東原
TOHO	東方
TOHOKU	東北
TOI	戸井
TOICHI	十一
TOICHIRO	東一郎
TOIDA	戸井田
TOIKAWA	樋川
TOIKE	外池
TOISHI	戸石
TOITA	戸板
TOIZUMI	戸泉
TOJI	東二
TOJIMA	戸島
TOJIRO	藤二郎
TOJURO	藤十郎
TOKAIRIN	東海林
TOKAMACHI	十日町
TOKANO	戸叶
TOKAWA	東川
TOKI	土岐
TOKICHI	藤吉
TOKIDA	時田
TOKIE	時恵
TOKIEDA	時枝
TOKIHIKO	時彦
TOKIHITO	時人
TOKIJI	時司
TOKIJIRO	時二郎
TOKIKO	富貴子
TOKIMUNE	時宗
TOKINAO	世直
TOKINARI	時成
TOKIO	外喜雄
TOKIOKA	時岡
TOKISAKI	鴇崎
TOKISAWA	時沢
TOKISUKE	時輔
TOKITA	常田
TOKITADA	時忠
TOKITO	時任
TOKIWA	常盤
TOKIYO	時世
TOKIYUKI	時之
TOKO	都甲
TOKOI	床井
TOKONAME	常滑
TOKORO	戸頃
TOKOROZAWA	所沢
TOKU	徳
TOKUDA	徳田
TOKUDOME	徳留
TOKUE	徳江
TOKUGAWA	徳川
TOKUHARA	徳原
TOKUHIKO	督彦
TOKUHIRO	徳弘
TOKUI	徳井
TOKUICHI	徳一
TOKUJI	得二
TOKUJIRO	徳次郎
TOKUJU	徳寿
TOKUJURO	徳十郎
TOKUKAZU	徳一
TOKUKO	徳子
TOKUMA	徳間
TOKUMARU	徳丸
TOKUMASA	得政
TOKUMASU	徳増
TOKUMATSU	徳松
TOKUMI	徳実
TOKUMITSU	徳光
TOKUMOTO	徳本
TOKUMURA	徳村
TOKUNAGA	徳永
TOKUNO	徳野
TOKUNOSUKE	徳之助
TOKUO	得夫
TOKUOKA	徳岡
TOKURA	戸倉
TOKURO	徳朗
TOKUSABURO	徳三郎
TOKUSHI	得志
TOKUSHIGE	徳重
TOKUSHIMA	徳島
TOKUSHIRO	徳四郎
TOKUTAKE	徳武
TOKUTARO	徳太郎
TOKUTOME	徳留
TOKUTOMI	徳冨
TOKUYAMA	徳山
TOKUYO	徳代
TOKUYOSHI	得美
TOKUYUKI	徳之
TOKUZO	得三
TOKYO	東京
TOMA	当摩
TOMABECHI	苫米地
TOMAKOMAI	苫小牧
TOMARI	泊
TOMARU	外丸
TOMATSU	戸松
TOMATSURI	戸祭
TOMEJI	留治
TOMEJIRO	留次郎
TOMEKICHI	留吉
TOMEKO	留子
TOMEO	止夫
TOMEYOSHI	留義
TOMEZO	留蔵
TOMI	冨
TOMIAI	富合
TOMIDAKA	冨高
TOMIE	冨江
TOMIGORO	富五郎
TOMIHARI	冨張
TOMIHIKO	富彦
TOMIHIRO	冨弘
TOMIHISA	冨久
TOMII	冨井
TOMIICHI	富一
TOMIIE	冨家
TOMIJI	富司
TOMIJIRO	富次郎
TOMIKAWA	冨川
TOMIKO	冨美子
TOMIMATSU	冨松
TOMIMOTO	冨本
TOMIMURA	冨村
TOMINAGA	冨永
TOMINARI	冨成
TOMINE	遠峯
TOMINO	冨野
TOMINOSUKE	富之助
TOMIO	冨男
TOMIOKA	富岡
TOMISABURO	富三郎
TOMISATO	冨里
TOMISAWA	富沢
TOMISHIMA	冨島
TOMITA	冨田
TOMITAKA	富隆
TOMITANI	富谷
TOMITARO	冨太郎
TOMITSUKA	冨塚
TOMIURA	富浦
TOMIYA	冨谷
TOMIYAMA	冨山
TOMIYASU	冨安
TOMIYO	富代
TOMIYOSHI	富良
TOMIZO	富三
TOMIZUKA	富塚
TOMO	友夫
TOMOAKI	伴明
TOMOBE	友部
TOMOCHI	砥用
TOMOCHIKA	友親
TOMODA	友田
TOMOE	共笑
TOMOEDA	友枝
TOMOFUMI	友史
TOMOFUSA	友房
TOMOHARU	友春
TOMOHIDE	友秀
TOMOHIKO	友彦
TOMOHIRO	公宏
TOMOHISA	智久
TOMOHITO	友人
TOMOI	友井
TOMOICHI	友一
TOMOJI	友二
TOMOJIRO	友次郎
TOMOKA	友佳
TOMOKATSU	友克
TOMOKAZU	友一
TOMOKI	友喜
TOMOKICHI	友吉
TOMOKIYO	友清
TOMOKO	倫子
TOMOMATSU	友松
TOMOMI	公美
TOMOMICHI	智通
TOMOMITSU	友光
TOMONAGA	友永
TOMONARI	共成
TOMONO	伴野
TOMONOBU	友信
TOMONORI	友典
TOMORI	友利
TOMOSABURO	友三郎
TOMOSAWA	友沢
TOMOSHI	朋史
TOMOSHIGE	友重
TOMOTAKA	友孝
TOMOTO	東本
TOMOTSUGU	智次
TOMOYA	友也
TOMOYASU	友保
TOMOYO	友世
TOMOYORI	友頼
TOMOYOSHI	友好
TOMOYUKI	共行
TOMOZO	友三
TOMURA	外村
TOMURO	戸室
TONAMI	砺波
TONDABAYASHI	富田林
TONE	刀根
TONEGAWA	利根川
TONO	東野
TONOMURA	殿村
TONOSHO	東庄
TONOZUKA	殿塚
TORAHIKO	寅彦
TORAICHI	寅一
TORAIWA	虎岩
TORAJI	寅次
TORAKICHI	寅吉
TORAMI	寅実
TORANOSUKE	寅之助
TORAO	寅夫
TORAZO	寅三
TORIDE	取手
TORIGATA	鳥潟
TORIHARA	鳥原
TORII	鳥井
TORIKAI	鳥飼
TORIKOSHI	鳥越
TORIRO	鶏郎
TORISU	鳥巣
TORITANI	鳥谷
TORITSUKA	鳥塚
TORIUMI	鳥海
TORIYA	鳥屋
TORIYABE	鳥谷部
TORIYAMA	鳥山
TORIZO	酉蔵
TORU	亨
TOSA	土佐
TOSABURO	藤三郎
TOSAKA	登坂
TOSAKI	戸崎
TOSASHIMIZU	土佐清水
TOSHI	俊
TOSHIAKI	俊彰
TOSHIDA	土信田
TOSHIE	俊恵
TOSHIETSU	利悦
TOSHIFUMI	俊史
TOSHIHARU	俊春
TOSHIHIDE	俊秀
TOSHIHIKO	俊彦
TOSHIHIRO	俊博
TOSHIHISA	俊久
TOSHIHITO	俊人
TOSHIICHI	俊一
TOSHIICHIRO	利一郎
TOSHIJI	俊二
TOSHIJIRO	俊二郎
TOSHIKATSU	俊克
TOSHIKAWA	利川
TOSHIKAZU	俊一
TOSHIKI	俊喜
TOSHIKO	俊子
TOSHIKUNI	俊邦
TOSHIKURA	利倉
TOSHIMA	戸島
TOSHIMASA	俊政
TOSHIMI	俊実
TOSHIMICHI	俊道
TOSHIMITSU	俊充
TOSHIMOTO	敏元
TOSHINAGA	俊永
TOSHINAKA	俊仲
TOSHINARI	俊成
TOSHINOBU	俊伸
TOSHINORI	俊典
TOSHINOSUKE	俊之助
TOSHIO	俊夫
TOSHIRO	俊朗
TOSHISABURO	敏三郎
TOSHISHICHI	俊七
TOSHITADA	俊忠
TOSHITAKA	俊孝
TOSHITAKE	俊剛
TOSHITSUGU	俊次
TOSHIYA	俊也
TOSHIYASU	俊保
TOSHIYO	俊代
TOSHIYOSHI	敏義
TOSHIYUKI	俊之
TOSHIZO	俊三
TOSU	鳥栖
TOSUKE	東助
TOTANI	戸谷
TOTARO	藤太郎
TOTSU	戸津
TOTSUKA	戸塚
TOTTORI	鳥取
TOWADA	十和田
TOWADAKO	十和田湖
TOWAKO	十和子
TOYA	外谷
TOYAMA	富山
TOYO	東予
TOYOAKE	豊明
TOYOAKI	豊明
TOYODA	豊田
TOYODOME	豊留
TOYOFUKU	豊福
TOYOGUCHI	豊口
TOYOHARA	豊原
TOYOHARU	豊春
TOYOHASHI	豊橋
TOYOHIKO	豊彦
TOYOHIRA	豊平
TOYOHISA	豊久
TOYOHITO	豊人
TOYOIZUMI	豊泉
TOYOJI	豊二
TOYOJIRO	豊次郎
TOYOKA	豊岡
TOYOKAWA	豊川
TOYOKAZU	豊一
TOYOKI	豊喜
TOYOKICHI	豊吉
TOYOKO	富世子
TOYOMA	登米
TOYOMI	豊実
TOYOMURA	豊村
TOYONAGA	豊永
TOYONAKA	豊中
TOYONO	豊野
TOYORA	豊浦
TOYOSABURO	豊三郎
TOYOSAKA	豊栄
TOYOSAKI	豊崎
TOYOSAKU	豊作
TOYOSAWA	豊沢
TOYOSHI	豊司
TOYOSHIGE	豊茂
TOYOSHIMA	豊島
TOYOSHINA	豊科
TOYOSHIRO	豊四郎
TOYOTA	豊田
TOYOTARO	豊太郎
TOYOTO	豊人
TOYOTSU	豊津
TOYOYAMA	豊山
TOYOYUKI	豊之
TOYOZO	豊三
TOZAKA	戸坂
TOZAKI	外崎
TOZAWA	戸沢
TOZO	藤蔵
TSU	津
TSUBAKI	椿
TSUBAKIHARA	椿原
TSUBAKII	椿井
TSUBAKIMOTO	椿本
TSUBAME	燕
TSUBASA	翼
TSUBATA	津幡
TSUBO	坪
TSUBOCHI	坪内
TSUBOI	坪井
TSUBOKAWA	坪川
TSUBOKURA	坪倉
TSUBONE	坪根
TSUBONO	坪野
TSUBOTA	坪田
TSUBOYA	坪谷
TSUBOYAMA	坪山
TSUBUKI	津吹
TSUBUKU	津布久
TSUBURAYA	円谷
TSUCHIDA	土田
TSUCHIE	土江
TSUCHII	土井
TSUCHIKADO	土門
TSUCHIKAWA	土川
TSUCHIKO	土子
TSUCHIKURA	土倉
TSUCHIMOCHI	土持
TSUCHIMOTO	土本
TSUCHISAWA	土沢
TSUCHITANI	槌谷
TSUCHIURA	土浦
TSUCHIYA	土屋
TSUCHIYAMA	土山
TSUDA	津田
TSUE	津恵
TSUFUKU	津布久
TSUGA	都賀
TSUGANE	津金
TSUGAWA	津川
TSUGE	柘植
TSUGIHIRO	仲央
TSUGIKAZU	二一
TSUGIMASA	次正
TSUGIO	二夫
TSUGUHIDE	次英
TSUGUHIKO	次彦
TSUGUMI	二美
TSUGUO	二男
TSUGUOMI	嗣臣
TSUGURU	告
TSUGUTOSHI	次利
TSUHARA	津原
TSUIKI	築城
TSUKADA	塚田
TSUKAGOSHI	塚越
TSUKAGUCHI	塚口
TSUKAHARA	塚原
TSUKAKO	司子
TSUKAKUCHI	塚口
TSUKAMOTO	塚本
TSUKANO	塚野
TSUKAO	塚尾
TSUKASA	主
TSUKATANI	塚谷
TSUKAYA	司弥
TSUKAZAKI	塚崎
TSUKIDA	月田
TSUKIDATE	月舘
TSUKII	月井
TSUKIJI	築地
TSUKIKO	就子
TSUKIMI	月美
TSUKIMURA	月村
TSUKINO	月乃
TSUKIOKA	月岡
TSUKISHIMA	築島
TSUKIYAMA	築山
TSUKIYO	月代
TSUKIYONO	月夜野
TSUKUDA	佃
TSUKUI	津久井
TSUKUMI	津久見
TSUKURU	作
TSUMAGARI	津曲
TSUMAKI	妻木
TSUMIDA	積田
TSUMIKO	津美子
TSUMITA	積田
TSUMORI	津守
TSUMOTO	津本
TSUMURA	津村
TSUNAGI	津奈木
TSUNAKAWA	綱川
TSUNAN	津南
TSUNAO	綱夫
TSUNASHIMA	綱島
TSUNEAKI	常明
TSUNEATSU	常厚
TSUNEDA	常田
TSUNEHARU	常治
TSUNEHIKO	常彦
TSUNEHIRO	常弘
TSUNEHISA	常久
TSUNEICHI	常一
TSUNEIZUMI	常泉
TSUNEJI	常二
TSUNEJIRO	常次郎
TSUNEKAWA	常川
TSUNEKAZU	常一
TSUNEKI	常木
TSUNEKICHI	常吉
TSUNEKO	常子
TSUNEMASA	庸雅
TSUNEMATSU	常松
TSUNEMI	常美
TSUNEMICHI	恒道
TSUNEMITSU	常満
TSUNENORI	常徳
TSUNEO	典男
TSUNEOKA	常岡
TSUNESABURO	恒三郎
TSUNESAKU	恒策
TSUNETAKA	常隆
TSUNEYA	恒也
TSUNEYAMA	常山
TSUNEYO	常代
TSUNEYOSHI	常喜
TSUNEYUKI	常之
TSUNEZO	常三
TSUNO	津野
TSUNODA	津野田
TSUNOI	角井
TSUNOKAWA	角川
TSURAYUKI	貫之
TSURIZURA	廿楽
TSURU	都留
TSURUE	鶴枝
TSURUGA	敦賀
TSURUGI	鶴来
TSURUHARA	鶴原
TSURUI	鶴井
TSURUICHI	鶴市
TSURUJI	鶴治
TSURUKAI	鶴飼
TSURUKAWA	鶴川
TSURUKI	鶴喜
TSURUKICHI	鶴吉
TSURUKO	鶴子
TSURUMA	鶴間
TSURUMAKI	弦巻
TSURUMATSU	鶴松
TSURUMI	鶴見
TSURUNO	鶴野
TSURUNOSUKE	鶴之助
TSURUO	鶴夫
TSURUOKA	鶴岡
TSURUSAKI	鶴崎
TSURUSAWA	鶴沢
TSURUSHIMA	鶴島
TSURUTA	鶴田
TSURUTANI	鶴谷
TSURUYA	鶴谷
TSURUYO	鶴代
TSUSAKI	津崎
TSUSHIMA	対馬
TSUTAE	拙枝
TSUTAKO	津多子
TSUTANI	津谷
TSUTAO	蔦朗
TSUTAU	伝
TSUTOMU	事
TSUTSUI	筒井
TSUTSUMI	堤
TSUTSUMINO	堤野
TSUYA	津谷
TSUYAKO	津也子
TSUYAMA	津山
TSUYAZAKI	津屋崎
TSUYOKI	毅
TSUYOKO	津与子
TSUYOSHI	侃
TSUYOTO	剛人
TSUYUGUCHI	露口
TSUYUKI	露木
TSUYUKO	露子
TSUYUKUBO	露久保
TSUYUSAKI	露崎
TSUZAKI	津崎
TSUZUKI	続木
TSUZUKO	津都子
TSUZURA	廿楽
TSUZURU	綴
TUO	拓
UBE	宇部
UBUKATA	生形
UBUSAWA	生沢
UCHIBORI	内堀
UCHIDA	内田
UCHIHARA	内原
UCHIHORI	内堀
UCHIIKE	内池
UCHIJIMA	内島
UCHIKAWA	内川
UCHIKI	内木
UCHIKOSHI	打越
UCHIKURA	内倉
UCHIMOTO	内本
UCHIMURA	内村
UCHINADA	内灘
UCHINO	内野
UCHINUMA	内沼
UCHIURA	内浦
UCHIYA	打矢
UCHIYAMA	内山
UDA	宇田
UDAGAWA	宇多川
UDAKA	宇高
UDO	宇都
UDONO	鵜殿
UEBA	上羽
UEBAYASHI	上林
UECHI	上地
UEDA	上田
UEDE	上出
UEDOKO	上床
UEGAKI	上垣
UEHARA	上原
UEHATA	上畑
UEHO	上保
UEHON	上本
UEI	上井
UEISHI	上石
UEJI	植次
UEJIMA	上島
UEKAWA	上川
UEKI	上木
UEKUBO	上久保
UEKUSA	植草
UEMA	上間
UEMATSU	上松
UEMORI	上森
UEMOTO	上本
UEMURA	上村
UENAKA	上中
UENISHI	上西
UENO	上野
UENOHARA	上野原
UENOYAMA	上野山
UEOKA	上岡
UESAKA	上坂
UESATO	上里
UESAWA	上沢
UESHIMA	上嶋
UESHIRO	上代
UESONO	上園
UESUGI	上杉
UETAKE	上竹
UETANI	上谷
UETSUKI	上月
UEYAMA	上山
UEYASU	上保
UEZONO	上園
UGA	宇賀
UGAJIN	宇賀神
UGI	卯木
UGO	羽後
UHEI	宇平
UI	宇井
UICHI	宇一
UJI	宇治
UJIGAWA	宇治川
UJIHARA	氏原
UJIIE	氏家
UJIKI	宇敷
UJITA	宇治田
UKAI	鵜飼
UKAJI	宇梶
UKAWA	鵜川
UKI	宇木
UKIE	有紀恵
UKIHA	浮羽
UKIKO	憂紀子
UKITA	浮田
UKIYA	浮谷
UKON	右近
UKU	宇久
UKYO	右京
UMABA	馬場
UMADA	馬田
UMAKOSHI	馬越
UMANO	馬野
UME	宇目
UMEBAYASHI	梅林
UMEDA	梅田
UMEGAKI	梅垣
UMEHARA	梅原
UMEJIMA	梅島
UMEJIRO	梅次郎
UMEKAWA	梅川
UMEKI	梅木
UMEKICHI	梅吉
UMEKO	梅子
UMEMIYA	梅宮
UMEMORI	梅森
UMEMOTO	梅本
UMEMURA	梅村
UMENO	梅野
UMEO	梅夫
UMEOKA	梅岡
UMESAKI	梅崎
UMESAWA	梅沢
UMETANI	梅谷
UMETARO	梅太郎
UMEYAMA	梅山
UMEZAKI	梅崎
UMEZAWA	梅沢
UMEZONO	梅園
UMEZU	梅津
UMI	宇美
UMIE	海恵
UMIFUJI	海藤
UMIKAMI	海上
UMIKO	海子
UMINO	海野
UMITANI	海谷
UMITO	海人
UMIZU	海津
UNAKAMI	海上
UNAZUKI	宇奈月
UNKICHI	運吉
UNNO	海野
UNO	宇野
UNOKICHI	卯之吉
UNOSAWA	宇野沢
UNOSUKE	卯之助
UNUMA	鵜沼
UO	卯尾
UOCHI	魚地
UOI	魚井
UOTANI	魚谷
UOYA	魚谷
UOZU	魚津
UOZUMI	魚住
URA	浦
URABE	卜部
URAGAMI	浦上
URAGUCHI	浦口
URAI	浦井
URAKAWA	浦川
URAKI	浦木
URANISHI	浦西
URANO	浦野
URAO	浦尾
URARA	麗
URASAKI	浦崎
URASAWA	浦沢
URASHIMA	浦島
URASOE	浦添
URATA	浦田
URATANI	浦谷
URAWA	浦和
URAYAMA	浦山
URAYASU	浦安
URAZAKI	浦崎
URAZAWA	浦沢
URESHINO	嬉野
URITA	瓜田
URIZURA	瓜連
URUMA	漆間
URUNO	宇留野
URUSHIBARA	漆原
URUSHIBATA	漆畑
URUSHIDO	漆戸
URUSHIHARA	漆原
URUSHIHATA	漆畑
URUSHIMA	漆島
URUSHIYAMA	漆山
USA	宇佐
USABURO	卯三郎
USAMI	宇佐美
USAWA	宇沢
USHIBUKA	牛深
USHIDA	牛田
USHIGOE	牛越
USHIJIMA	牛島
USHIKI	牛木
USHIKOSHI	牛越
USHIKU	牛久
USHIKUBO	牛窪
USHIMARU	牛丸
USHIMATSU	丑松
USHIO	潮
USHIODA	潮田
USHIYAMA	牛山
USHIZAWA	牛沢
USHIZO	丑蔵
USU	薄
USUBA	薄葉
USUDA	臼田
USUHA	薄葉
USUI	碓井
USUKI	臼木
USUKURA	臼倉
UTA	右田
UTADA	歌田
UTAGAWA	歌川
UTAKO	唄子
UTARO	卯太郎
UTASHINAI	歌志内
UTASHIRO	歌代
UTAYO	詩代
UTENA	台
UTO	宇土
UTSU	宇津
UTSUGI	宇津木
UTSUKI	宇都木
UTSUMI	内海
UTSUNO	宇津野
UTSUNOMIYA	宇都宮
UWABO	上保
UWAJIMA	宇和島
UYAMA	宇山
UZAWA	鵜沢
UZU	宇津
UZUKI	卯月
WACHI	和地
WADA	和田
WAGATSUMA	我妻
WAGURI	和栗
WAHEI	和平
WAICHI	和一
WAICHIRO	和一郎
WAIDA	和井田
WAITA	和井田
WAJIMA	和島
WAKA	和佳
WAKABA	若葉
WAKABAYASHI	若林
WAKAE	若江
WAKAGI	若木
WAKAHARA	若原
WAKAI	若井
WAKAIRO	若色
WAKAIZUMI	若泉
WAKAKO	和佳子
WAKAMATSU	若松
WAKAMI	若美
WAKAMIYA	若宮
WAKAMORI	若森
WAKAMOTO	若本
WAKAMURA	若村
WAKANA	若奈
WAKANO	若野
WAKAO	若尾
WAKASA	若狭
WAKASHIMA	若島
WAKASUGI	若杉
WAKATA	若田
WAKATABE	若田部
WAKATAKE	若竹
WAKATSUKI	若月
WAKAU	若生
WAKAUME	若梅
WAKAYAGI	若柳
WAKAYAMA	和歌山
WAKAZONO	若園
WAKE	和気
WAKEBE	分部
WAKI	和気
WAKIKO	和帰子
WAKIMOTO	脇本
WAKINO	脇野
WAKISAKA	脇坂
WAKITA	脇田
WAKITANI	脇谷
WAKIYA	脇屋
WAKIYAMA	脇山
WAKKANAI	稚内
WAKO	和光
WAKUDA	和久田
WAKUI	和久井
WAKUKO	和久子
WAKURI	和栗
WAKUTA	和久田
WAN	完
WANG	王
WANIBUCHI	鰐淵
WANJI	万吉
WARABI	蕨
WARAGAI	藁谷
WARASHINA	藁科
WARATANI	藁谷
WARAYA	藁谷
WARITA	割田
WASABURO	和三郎
WASAKU	和作
WASHIDA	鷲田
WASHIMI	鷲見
WASHIMIYA	鷲宮
WASHINO	鷲野
WASHINOSU	鷲巣
WASHIO	鷲尾
WASHIYAMA	鷲山
WASHIZAWA	鷲沢
WASHIZU	鷲津
WASHIZUKA	鷲塚
WASUKE	和助
WATABE	渡部
WATABIKI	綿引
WATAHIKI	綿引
WATAI	渡井
WATANABE	渡辺
WATANUKI	渡貫
WATANUMA	渡沼
WATARAI	渡井
WATARI	亘
WATARU	亘
WATASE	渡瀬
WATAYA	綿谷
WEI	唯
WEIXIN	維新
WENJI	文吉
WENXIONG	文雄
WENYI	文一
WENZHEN	文珍
WENZHENG	文正
WUYI	五一
XIAN	弦
XIANG	祥
XIANGZHI	祥治
XIANZHI	憲治
XIAOPING	孝平
XIEHE	協和
XIHE	希和
XIN	信
XING	幸
XINHAI	新海
XINWU	新吾
XINYI	心一
XIONG	雄
XIONGYI	雄一
XIPING	喜平
XIU	秀
XIUPING	修平
XIUQUAN	秀全
XIUYI	修一
XUAN	宣
XUN	洵
YABAKEI	耶馬溪
YABANA	矢花
YABASHI	矢橋
YABE	矢部
YABU	籔
YABUCHI	籔内
YABUKI	矢吹
YABUMOTO	籔本
YABUNAKA	籔中
YABUNO	薮野
YABUSAKI	八武崎
YABUSHITA	薮下
YABUTA	薮田
YABUZUKAHON	藪塚本
YACHI	谷内
YACHIDA	谷内田
YACHIKO	八千子
YACHIMATA	八街
YACHIYO	八千代
YADA	八田
YADOTANI	宿谷
YAE	八重
YAEDA	八重田
YAEGASHI	八重樫
YAEKO	八枝子
YAGAI	谷貝
YAGAMI	八神
YAGAWA	矢川
YAGETA	八下田
YAGI	八木
YAGIHARA	八木原
YAGIHASHI	八木橋
YAGIHIRA	柳平
YAGIKATA	柳舘
YAGIMOTO	柳本
YAGINUMA	八木沼
YAGISAWA	八木沢
YAGISHIMA	柳島
YAGISHITA	八木下
YAGITA	八木田
YAGO	矢後
YAGUCHI	矢口
YAHAGI	矢作
YAHASHI	八橋
YAHATA	矢幡
YAHATAHIGASHI	八幡東
YAHATANISHI	八幡西
YAHIRO	八宏
YAICHI	弥一
YAICHIRO	弥一郎
YAITA	矢板
YAIZU	焼津
YAJI	谷治
YAJIMA	矢島
YAKICHI	弥吉
YAKO	八子
YAKURA	矢倉
YAKUSHIJI	薬師寺
YAKUSHIMARU	薬師丸
YAKUWA	八鍬
YAMA	山
YAMABATA	山畑
YAMABAYASHI	山林
YAMABE	山家
YAMACHI	山地
YAMADA	山田
YAMADE	山出
YAMAFUJI	山藤
YAMAGA	山家
YAMAGAMI	山上
YAMAGATA	山形
YAMAGISHI	山岸
YAMAGIWA	山極
YAMAGOSHI	山越
YAMAGUCHI	山口
YAMAHARA	山原
YAMAHATA	山畑
YAMAHIGASHI	山東
YAMAHIRA	山平
YAMAI	山井
YAMAIE	山家
YAMAISHI	山石
YAMAJI	山地
YAMAKADO	山門
YAMAKAGE	山影
YAMAKAWA	山川
YAMAKI	八巻
YAMAKITA	山北
YAMAKOSHI	山腰
YAMAKUNI	山国
YAMAKURA	山倉
YAMAMICHI	山道
YAMAMIYA	山宮
YAMAMORI	山守
YAMAMOTO	山元
YAMAMURA	山村
YAMAMURO	山室
YAMANA	山名
YAMANAKA	山中
YAMANASHI	山梨
YAMANE	山根
YAMANISHI	山西
YAMANO	山野
YAMANOBE	山辺
YAMANOCHI	山之内
YAMANOGUCHI	山之口
YAMANOI	山野井
YAMAO	山尾
YAMAOKA	山岡
YAMASAWA	山沢
YAMASE	山瀬
YAMASHINA	山科
YAMASHIRO	山城
YAMASHITA	山下
YAMATANI	山谷
YAMATE	山手
YAMATO	倭
YAMATOKORIYAMA	大和郡山
YAMATOTAKADA	大和高田
YAMATSURI	矢祭
YAMAUCHI	山内
YAMAURA	山浦
YAMAWAKI	山脇
YAMAYA	山家
YAMAYOSHI	山吉
YAMAZAKI	山崎
YAMAZAWA	山沢
YAMAZOE	山添
YAME	八女
YAMURA	矢村
YAN	研
YANADA	梁田
YANAGA	弥永
YANAGAWA	柳川
YANAGI	柳
YANAGIDA	柳田
YANAGIHARA	柳原
YANAGIHORI	柳堀
YANAGIMACHI	柳町
YANAGIMOTO	柳本
YANAGISAWA	柳沢
YANAGISHITA	柳下
YANAGIYA	柳屋
YANAI	柳井
YANAIZU	柳津
YANAKA	谷中
YANAMI	八並
YANAMOTO	柳本
YANASE	柳瀬
YANASHIMA	梁島
YANATORI	梁取
YANG	楊
YANGPING	洋平
YANO	矢野
YAO	八尾
YAOI	矢追
YAOITA	八百板
YAOKI	八起
YARIMIZU	鑓水
YARITA	鎗田
YASABURO	弥三郎
YASAKA	八坂
YASAKU	矢作
YASATO	八郷
YASHIKI	屋敷
YASHIMA	八島
YASHIO	八潮
YASHIRO	八代
YASO	八十
YASOJIMA	八十島
YASU	夜須
YASUAKI	保明
YASUDA	保田
YASUE	安恵
YASUFUKU	安福
YASUFUMI	康允
YASUGI	八杉
YASUHA	泰葉
YASUHARA	安原
YASUHARU	保春
YASUHEI	保平
YASUHIDE	康秀
YASUHIKO	保彦
YASUHIRO	保宏
YASUHIRU	安蒜
YASUHISA	保久
YASUHITO	康人
YASUI	保井
YASUICHI	保一
YASUIE	康家
YASUIKE	安池
YASUJI	保二
YASUJIMA	安島
YASUJIRO	保次郎
YASUKATSU	康勝
YASUKAWA	保川
YASUKAZU	康一
YASUKE	弥助
YASUKI	保樹
YASUKICHI	安吉
YASUKIYO	寧清
YASUKO	保子
YASUKOCHI	安河内
YASUKUNI	保邦
YASUMA	安間
YASUMASA	保正
YASUMATSU	安松
YASUMI	保実
YASUMICHI	康道
YASUMITSU	保光
YASUMOTO	安元
YASUMURA	安村
YASUMURO	安室
YASUNAGA	安永
YASUNARI	康成
YASUNISHI	安西
YASUNO	安野
YASUNOBU	保伸
YASUNORI	保則
YASUNOSUKE	保之助
YASUO	保夫
YASUOKA	安岡
YASUOMI	泰臣
YASURA	安楽
YASURAOKA	安良岡
YASURO	泰郎
YASUSABURO	保三郎
YASUSHI	也寸志
YASUSUKE	靖介
YASUTADA	靖忠
YASUTAKA	保孝
YASUTAKE	安武
YASUTANE	康允
YASUTANI	保谷
YASUTARO	保太郎
YASUTERU	泰輝
YASUTO	安人
YASUTOMI	安冨
YASUTOMO	康友
YASUTOSHI	保俊
YASUTSUGU	泰次
YASUTSUNA	康綱
YASUYO	安世
YASUYOSHI	保義
YASUYUKI	保之
YASUZABURO	康三郎
YASUZAWA	安沢
YASUZO	保蔵
YASUZUKA	安塚
YATABE	矢田部
YATAGAI	谷田貝
YATAGAWA	谷田川
YATANI	矢谷
YATARO	弥太郎
YATO	矢藤
YATOMI	弥冨
YATSUDA	谷津田
YATSUKA	八塚
YATSUO	八尾
YATSUSHIRO	八代
YAUCHI	箭内
YAWATA	八幡
YAWATAHAMA	八幡浜
YAXI	亜希
YAYOE	八代枝
YAYOI	弥佳
YAYOKO	八代子
YAZAKI	矢崎
YAZAWA	矢沢
YE	葉
YILANG	一郎
YING	瑛
YINGCI	英次
YINGZHI	英志
YO	庸
YOBE	余部
YODA	与田
YODOGAWA	淀川
YOGO	余語
YOGORO	与五郎
YOHEI	与平
YOICHI	与一
YOICHIRO	与一郎
YOITA	与板
YOJI	容治
YOJIRO	洋次郎
YOKA	陽香
YOKAICHI	八日市
YOKAICHIBA	八日市場
YOKICHI	洋吉
YOKIHI	楊貴妃
YOKKAICHI	四日市
YOKO	妖子
YOKOBORI	横堀
YOKOCHI	横内
YOKOE	横江
YOKOGI	横木
YOKOGOSHI	横越
YOKOHAMA	横浜
YOKOHARI	横張
YOKOI	横井
YOKOKAWA	横川
YOKOKURA	横倉
YOKOMAKURA	横枕
YOKOMATSU	横松
YOKOMICHI	横道
YOKOMIZO	横溝
YOKOMORI	横森
YOKOMURA	横村
YOKONO	横野
YOKOSAKA	横坂
YOKOSE	横瀬
YOKOSEKI	横関
YOKOSHIBA	横芝
YOKOSHIMA	横島
YOKOSUKA	横須賀
YOKOTA	横田
YOKOTANI	横谷
YOKOTE	横手
YOKOTSUKA	横塚
YOKOYA	横谷
YOKOYAMA	横山
YOKOZAWA	横沢
YOKOZE	横瀬
YOKOZEKI	横関
YOKURA	四倉
YOMISHI	嘉
YOMO	四方
YOMODA	四方田
YOMOGIDA	蓬田
YONAGA	代永
YONAGO	米子
YONAHA	与那覇
YONAI	米内
YONAMINE	与那嶺
YONE	米
YONEBAYASHI	米林
YONEDA	米田
YONEHARA	米原
YONEI	米井
YONEIMA	米今
YONEJIMA	米島
YONEKAWA	米川
YONEKAZU	米一
YONEKICHI	米吉
YONEKO	米古
YONEKURA	米倉
YONEMITSU	米光
YONEMOCHI	米持
YONEMORI	米森
YONEMOTO	米元
YONEMURA	米村
YONENAGA	米永
YONENO	米野
YONEO	米夫
YONEOKA	米岡
YONESAKU	米作
YONESHIMA	米島
YONETANI	米谷
YONETARO	米太郎
YONETOSHI	米利
YONEYA	米屋
YONEYAMA	米山
YONEZAKI	米崎
YONEZAWA	米沢
YONEZO	米蔵
YONEZU	米津
YONG	勇
YONGGUI	永貴
YONGHUI	永輝
YONGJI	永吉
YONGPING	勇平
YONGSHOU	永寿
YONO	与野
YONOSUKE	要之助
YORI	依
YORIFUMI	従典
YORII	寄居
YORIKAZU	頼一
YORIKO	依子
YORITA	依田
YORITAKA	順敬
YOROZU	万
YOSABURO	与三郎
YOSAKU	与作
YOSHI	美
YOSHIAKI	佳明
YOSHIARA	吉荒
YOSHIBA	吉場
YOSHIBASHI	吉橋
YOSHICHIKA	好近
YOSHIDA	吉田
YOSHIE	佳恵
YOSHIEI	良衛
YOSHIFUMI	佳史
YOSHIFUSA	義房
YOSHIGA	吉賀
YOSHIGAKI	吉垣
YOSHIHARA	吉原
YOSHIHARU	佳美
YOSHIHIDE	佳秀
YOSHIHIKO	令彦
YOSHIHIRA	吉平
YOSHIHIRO	佳宏
YOSHIHISA	佳久
YOSHIHITO	宜仁
YOSHIHO	紀基
YOSHII	吉井
YOSHIICHI	善一
YOSHIIKE	吉池
YOSHIIZUMI	吉泉
YOSHIJI	吉次
YOSHIJIMA	吉島
YOSHIJIRO	吉次郎
YOSHIKA	由佳
YOSHIKANE	義兼
YOSHIKATSU	善勝
YOSHIKAWA	吉川
YOSHIKAZU	佳和
YOSHIKI	佳樹
YOSHIKICHI	芳吉
YOSHIKIYO	吉清
YOSHIKO	代志子
YOSHIKOSHI	吉越
YOSHIKUNI	吉国
YOSHIKURA	吉倉
YOSHIMASA	佳昌
YOSHIMATSU	吉松
YOSHIMI	佳実
YOSHIMICHI	善通
YOSHIMINE	吉峯
YOSHIMITSU	与四光
YOSHIMIZU	吉水
YOSHIMORI	吉森
YOSHIMOTO	吉元
YOSHIMURA	吉村
YOSHINAGA	吉永
YOSHINAKA	吉中
YOSHINAO	由直
YOSHINARI	吉成
YOSHINO	代志乃
YOSHINOBU	儀信
YOSHINORI	佳典
YOSHINOSUKE	由之助
YOSHINUMA	吉沼
YOSHIO	与志夫
YOSHIOKA	吉岡
YOSHIOMI	美臣
YOSHIRO	与四朗
YOSHISADA	義定
YOSHISHI	好史
YOSHISHIGE	喜重
YOSHISUKE	吉亮
YOSHITADA	美忠
YOSHITAKA	与志隆
YOSHITAKE	吉武
YOSHITANI	吉谷
YOSHITARO	吉太郎
YOSHITERU	喜輝
YOSHITO	由人
YOSHITOME	吉留
YOSHITOMI	吉富
YOSHITOMO	勝義
YOSHITOSHI	好利
YOSHITOYO	良豊
YOSHITSUGU	与継
YOSHITSUNE	嘉恒
YOSHIUMI	美臣
YOSHIURA	吉浦
YOSHIWARA	葭原
YOSHIYA	好也
YOSHIYAMA	吉山
YOSHIYASU	善康
YOSHIYUKI	仁敬
YOSHIZAKI	吉崎
YOSHIZAWA	吉沢
YOSHIZO	好三
YOSHIZUMI	吉住
YOSOJI	與三次
YOSUI	陽水
YOSUKE	与助
YOTA	洋太
YOTARO	洋太郎
YOTSUKAIDO	四街道
YOTSUMOTO	四元
YOTSUYA	四谷
YOU	佑
YOUZHI	友志
YOZABURO	洋三郎
YOZO	洋三
YU	佑
YUAN	元
YUANYI	元一
YUASA	湯浅
YUBA	弓場
YUBARI	夕張
YUCHI	湯地
YUDA	湯田
YUE	優恵
YUGAWARA	湯河原
YUGE	弓削
YUGI	柚木
YUGO	勇吾
YUGORO	勇五郎
YUGUCHI	湯口
YUHACHI	勇八
YUHARA	柚原
YUHEI	優平
YUHIKO	雄彦
YUHUI	裕輝
YUI	唯
YUICHI	優一
YUICHIRO	佑一郎
YUIHARU	由春
YUIJI	唯次
YUIKA	結花
YUIKO	由依子
YUITARO	唯太郎
YUJI	佑二
YUJIRO	優二郎
YUKA	優佳
YUKAKO	優佳子
YUKANO	由佳乃
YUKARI	優香里
YUKAWA	湯川
YUKI	優喜
YUKIAKI	幸明
YUKICHI	優吉
YUKIDA	雪田
YUKIE	幸恵
YUKIFUMI	幸文
YUKIHARU	幸明
YUKIHIDE	幸秀
YUKIHIKO	之彦
YUKIHIRO	幸博
YUKIHISA	幸久
YUKIHITO	幸人
YUKIJI	雪路
YUKIKAZU	幸一
YUKIKI	行木
YUKIKO	優季子
YUKIMASA	幸正
YUKIMI	友希美
YUKIMICHI	行利
YUKIMINE	幸峰
YUKIMITSU	幸光
YUKIMORI	幸盛
YUKINAGA	幸長
YUKINAO	幸直
YUKINARI	幸成
YUKINE	幸音
YUKINO	雪乃
YUKINOBU	幸伸
YUKINOJO	雪之丞
YUKINORI	幸典
YUKIO	之夫
YUKIRO	幸郎
YUKISABURO	雪三郎
YUKISHIRO	幸城
YUKISHITA	雪下
YUKISUKE	幸助
YUKITA	行田
YUKITAKA	幸孝
YUKITO	幸人
YUKITOSHI	幸俊
YUKIYA	幸也
YUKIYASU	幸保
YUKIYO	幸与
YUKIYOSHI	幸義
YUKO	佑子
YUKUHASHI	行橋
YUKUO	征男
YUMA	由真
YUME	結女
YUMEKO	夢子
YUMEMAKURA	夢枕
YUMI	佑美
YUMIBA	弓場
YUMIDA	弓田
YUMIE	友美恵
YUMIKA	由美佳
YUMIKO	佑三子
YUMINO	弓乃
YUMOTO	湯本
YUMURA	湯村
YUNA	優奈
YUNBA	弓場
YUNJI	運吉
YUNO	友乃
YUNOMAE	湯前
YUNOSUKE	雄之助
YUNOTSU	温泉津
YUPING	宇平
YURA	由良
YURI	優利
YURIA	友里亜
YURIE	優理恵
YURIHEI	勇利平
YURIKA	優里香
YURIKO	佑里子
YURIO	百合夫
YURIYO	由里代
YURO	雄郎
YUSA	遊佐
YUSABURO	勇三郎
YUSAKU	優作
YUSHI	優志
YUSHICHIRO	祐七郎
YUSHIN	雄伸
YUSHIRO	勇四郎
YUSUKE	佑介
YUTA	優太
YUTAKA	優
YUTAKAYAMA	豊山
YUTANI	油谷
YUTARO	優太朗
YUTO	祐人
YUWA	雄和
YUYA	優也
YUYAMA	湯山
YUZA	弓座
YUZABURO	勇三郎
YUZAWA	湯沢
YUZO	優三
YUZUHARA	譲原
YUZUKI	柚木
YUZUKO	柚子
YUZURU	譲
ZAIBE	財部
ZAITSU	財津
ZAMA	座間
ZANMA	残間
ZAO	蔵王
ZEN'EI	善栄
ZEN'ICHI	善一
ZEN'ICHIRO	善一郎
ZEN'YA	善弥
ZENITANI	銭谷
ZENIYA	銭谷
ZENJI	善二
ZENJIRO	善二郎
ZENKICHI	善吉
ZENNOSUKE	善之助
ZENSAKU	善作
ZENSHI	善史
ZENSHIRO	善四郎
ZENSUKE	善助
ZENTARO	善太郎
ZENTSUJI	善通寺
ZENZABURO	善三郎
ZENZO	善三
ZHANGPING	章平
ZHAOXING	照星
ZHE	哲
ZHEN	真
ZHENG	征
ZHENGGANG	正剛
ZHENJI	貞吉
ZHIHE	志和
ZHIPING	治平
ZHONGLANG	重郎
ZHONGPING	忠平
ZHOU	周
ZHUANG	壮
ZHUN	凖
ZHUO	卓
ZHUOYING	卓英
ZOU	奏
ZUN	遵
ZUSHI	図師
