אבא	abba
אבאבא	ababa
אבאביל	ababil
אבאלון	avalon
אבוגאדרו	avogadro
אבוטארן	hebuterne
אבולי	eboli
אבונייט	ebonite
אבחור	abhur
אבי	abie
אביבי	abebe
אביבים	avivim
אביגדור	avigdor
אביגייל	abigail
אבין	eben
אבל	abel
אבלא	ebla
אבנר	avner
אבסאלום	absalom
אבראהאמז	abrahams
אברהארד	eberhard
אברו	avro
אבריטאניא	evrytania
אבריל	avril
אברקרומבי	abercrombie
אבשלום	avshalom
אגאהווא	aghahowa
אגאסי	agassi
אגוילירא	aguilera
אגוירו	aguero
אגריפא	agrippa
אגרנט	agranat
אדאן	adhan
אדבוקאט	advocaat
אדגאר	edgar
אדוארד	edward
אדוארדו	eduardo
אדוארדז	edwards
אדובונטו	edubuntu
אדוין	edwin
אדולף	adolf
אדוניס	adonis
אדיב	adib
אדיגיא	adygea
אדידס	adidas
אדייר	adair
אדיליاד	adelaide
אדיר	adir
אדלמאן	adelman
אדלסטין	adelstein
אדלר	adler
אדמונטון	edmonton
אדן	adan
אדריאן	adrian
אדריאנא	adriana
אדריאנו	adriano
אהוד	ehud
אהירן	ahern
אוב	aube
אובאי	ubayy
אובלאסט	oblast
אובסידיאן	obsidian
אוברי	aubrey
אוגוגו	ogogo
אוגוסטו	augusto
אוגסברג	augsburg
אוגסט	auguste
אוגסטין	augustin
אודו	audo
אודן	audin
אודנסי	odense
אודרי	audrey
אוהארא	ohara
אוהיו	ohio
אוהרלאו	uhrlau
אוזבקיסטאן	uzbekistan
אוזיל	ozil
אוטאדא	utada
אוטי	oti
אוטמאר	otmar
אויאמא	oyama
אויל	oil
אוין	owen
אויפאלוסי	ujfalusi
אולאפור	olafur
אולגה	olga
אולד	old
אולדהאם	oldham
אולדפילד	oldfield
אוליבייר	olivier
אוליביירא	oliveira
אוליבירו	olivero
אוליבר	oliver
אולימפוס	olympus
אולימפיא	olimpia
אולימפיאד	olympiad
אולימפיאס	olympias
אוליסס	ulises
אולמאן	ullman
אולמו	oulmou
אולמרט	olmert
אולסן	olsson
אום	umm
אומאן	aumann
אומבריא	umbria
אונקין	oncken
אוסאנו	osano
אוסבאלדו	osvaldo
אוסטא	aosta
אוסטין	austin
אוסטר	oster
אוסטראלופיתקס	australopithecus
אוסטראליא	australia
אוסטרובסקי	ostrovsky
אוסטריא	austria
אוסלו	oslo
אוסמנט	osment
אוסקארסדוטיר	oskarsdottir
אופנהימר	oppenheimer
אופק	opec
אופקים	ofakim
אופר	ofer
אוצ'ידא	uchida
אוקאזאקי	okazaki
אוקאמוטו	okamoto
אוקאפור	okafor
אוקו	okko
אוקוונואני	okwunwanne
אוקומא	okuma
אוקטאב	octave
אוקטאביאן	octavian
אוקטאביו	octavio
אוקטאן	octane
אוקטוניון	octonion
אוקילו	okello
אוקלאהומא	oklahoma
אורויל	orwell
אורטיגא	ortega
אוריגון	oregon
אוריול	oryol
אוריליוס	aurelius
אורינוקו	orinoco
אורלאנדוני	orlandoni
אורלוב	orlov
אורליב	orlev
אורלינז	orleans
אורנילא	ornella
אורנים	oranim
אורסון	orson
אושו	osho
אזאד	azad
אזאלי	azali
אזאקי	ezzaki
אזאר	azar
אזארינקא	azarenka
אזד	azd
אזילאל	azilal
אחמד	ahmed
אטאואלפא	atahualpa
אטאטורק	ataturk
אטווד	atwood
אטופיק	atopic
אטיין	etienne
אטיקא	attica
אטלאנטיס	atlantis
אטלטיקו	atletico
אטלס	atlas
אטנא	etna
אטנבורו	attenborough
אטקינסון	atkinson
איאן	ian
איאקוינטא	iaquinta
איב	yves
איבא	eva
איבאנדר	evander
איבאנז	evans
איבגיני	evgeny
איביזא	ibiza
איבינד	eyvind
איביריא	iberia
איבן	ibn
איברא	evra
איבראהים	ibrahim
איברי	ivri
איבריסט	evariste
איברסון	iverson
איג'אקס	ajax
איגאראשי	igarashi
איגור	igor
איגלטון	eagleton
איגליסיאס	iglesias
אידאהו	idaho
אידריס	idris
איהארא	ihara
איוב	ayoob
איון	ion
איוניסקו	ionescu
איוסיף	iosif
איורוספורט	eurosport
איז'א	asia
איזאבל	isabelle
איזהאר	izhar
איזידור	isidore
איזמיר	izmir
איזריל	israel
איזרילז	israels
איטורי	ettore
אייזנר	eisner
אייי	iii
איימאן	ayman
אייסיס	isis
אילאם	eelam
אילהאם	ilham
אילון	ayalon
איליא	ilia
איליאנא	ileana
אילינג	ealing
אילינוי	illinois
אילם	elm
אילן	ilan
אילנה	ilana
אילת	eilat
אימא	emma
אימאמורא	imamura
אימאר	aimar
אימו	emo
אימולא	imola
אימז	eames
אימיריך	emerich
אימליי	imlay
אימרי	imre
אינגליש	english
אינגמאר	ingmar
אינדיא	india
אינדיאן	indian
אינדיאנא	indiana
אינדיק	indyk
אינונו	inonu
אינוס	enos
אינטו	into
אינטרון	intron
אינטרפול	interpol
אינסברוק	innsbruck
אינסולין	insulin
אינקא	inca
איסחאק	ishak
איסטבאן	istvan
איסטנבול	istanbul
איסטקוט	eastcote
איסטרא	istra
איסילקול	isilkul
איסיק	issyk
איסקיסיהיר	eskisehir
איסקרא	iskra
איסר	isser
איפאניי	ifeanyi
איפל	eiffel
איקיא	ikea
איקיבאנא	ikebana
איקידו	aikido
איראקליו	irakleio
אירבאין	irvine
אירביד	irbid
אירהארט	earhart
אירוין	irwin
אירוס	eros
אירופלוט	aeroflot
אירטון	ayrton
אירין	irene
אירינא	irina
אירית	irit
אירן	irne
אירקוטסק	irkutsk
אישיהארא	ishihara
איתמר	itamar
אכאלקאלאקי	akhalkalaki
אכמיטילי	akhmeteli
אלאהראם	alahram
אלאוישס	aloysius
אלאיג'ה	elijah
אלאיספהאני	alisfahani
אלאן	allan
אלאנד	aland
אלאנואר	alanwar
אלאנור	eleanor
אלאנסארי	alansari
אלאסד	alassad
אלאסקא	alaska
אלבאיאטי	albayyati
אלבארו	alvaro
אלבום	album
אלבחרי	albahri
אלבי	albi
אלבייניאן	albanian
אלבין	albin
אלביס	elvis
אלבנא	albanna
אלבעת	albaath
אלברטא	alberta
אלברטו	alberto
אלברטי	alberti
אלג'אבר	aljaber
אלג'בל	aljabal
אלג'לדאקי	aljaldaki
אלגיטאני	elghitani
אלגמל	elgamal
אלדאודי	daoudi
אלדו	aldo
אלה	ela
אלווין	alvin
אלונזו	alonzo
אלוני	aloni
אלזהאימר	alzheimer
אלחמאדי	alhamadi
אלחנן	elhanan
אלטא	alta
אלטאי	altai
אלטו	aalto
אלטון	alton
אלטמאן	altman
אליא	elia
אליאהו	eliahu
אליאנז	allianz
אליאס	elias
אליאסו	illiasu
אליאקסאנדר	aliaksandr
אליגיירי	alighieri
אליגרי	alegre
אליהו	eliyahu
אליזא	eliza
אליזאבת	elisabeth
אליטיס	elytis
אלילא	alela
אלימאן	aleman
אלין	elin
אלינא	alina
אליס	alice
אליסא	elissa
אליסון	allyson
אליסטא	elista
אליסטיר	alistair
אליסיא	alicia
אליפתיריוס	eleftherios
אליק	alec
אליקים	elyakim
אלישיב	elyashiv
אלישע	elisha
אלכאנאט	ilkhanate
אללה	allah
אלמאטי	almaty
אלמג'יד	almajid
אלמהדי	almahdi
אלמודובאר	almodovar
אלמור	elmore
אלמורשיד	almurshid
אלמידא	almeida
אלן	alan
אלנבי	allenby
אלנמרי	alnemri
אלסט	elst
אלסיקילי	alsiqilli
אלסמני	elsamni
אלסנבאטי	elsonbaty
אלסנהורי	elsanhuri
אלסקאן	alaskan
אלעאידי	alaidy
אלפא	alfa
אלפונס	alfons
אלפונסו	alfonso
אלפזארי	alfazari
אלפרזדק	alfarazdaq
אלפרידו	alfredo
אלפרידי	elfriede
אלקטרא	elektra
אלקיין	alkane
אלקנטארא	alcntara
אלקס	alex
אלקסאנדרינא	alexandrina
אלקסיי	aleksei
אלקסנדר	aleksandr
אלקסנדרו	alexandru
אלשאפעי	elshafei
אלשהיד	alshahid
אמאליא	amalia
אמאנואל	emanuele
אמאפא	amapa
אמארטיא	amartya
אמבארק	imbarek
אמבראיר	embraer
אמברוס	ambrose
אמדן	emden
אמונדסן	amundsen
אמוניום	ammonium
אמוניק	amuneke
אמורו	amuro
אמי	emmy
אמידיו	amedeo
אמיון	amioun
אמיטב	amitav
אמיל	emile
אמילי	emily
אמיליו	emilio
אמין	amin
אמירה	amira
אמית	amit
אמל	amal
אמנון	amnon
אמסטרדאם	amsterdam
אמפולי	empoli
אמפיריא	imperia
אמריטסאר	amritsar
אמריקאנא	americana
אמריקן	american
אמרסון	emerson
אן	an
אנא	ana
אנאהאים	anaheim
אנאטול	anatol
אנאטולי	anatoly
אנאנד	anand
אנאסטאסיוס	anastasius
אנאסטייז'ה	anastasia
אנג	ang
אנג'ליס	angeles
אנגושיטיא	ingushetia
אנגיל	anghel
אנגלאנד	england
אנגליא	anglia
אנגקור	angkor
אנדהובן	eindhoven
אנדו	ando
אנדוני	andoni
אנדורא	andorra
אנדיומי	indiumiii
אנדליס	endless
אנדמול	endemol
אנדר	ander
אנדראניק	andranik
אנדרז	anders
אנדרי	andriy
אנדריא	andrea
אנדריאס	andreas
אנדריי	andrey
אנדריס	andres
אנדרסן	andersen
אנו	anno
אנוביס	anubis
אנזו	enzo
אנטאליא	antalya
אנטאנאנאריבו	antananarivo
אנטארקטיקא	antarctica
אנטבה	entebbe
אנטון	anton
אנטוניא	antonia
אנטוניוס	antonius
אנטונין	antonin
אנטונינו	antonino
אנטוניסקו	antonescu
אני	annie
אניו	ennio
אניטא	anita
אנילקא	anelka
אנימאניאקס	animaniacs
אנסילמו	anselmo
אנפילד	enfield
אנקא	anka
אנקרה	ankara
אנרון	enron
אנריק	enric
אנריקו	enrico
אנתוני	anthony
אסאהארא	asahara
אסאטיאני	asatiani
אסאמוא	asamoah
אסד	asad
אסונסיון	asuncion
אסטאדיו	estadio
אסטוניא	estonia
אסטוריאס	asturias
אסטילי	estili
אסטראדא	estrada
אסטריד	astrid
אסיא	assia
אסייר	asier
אסימו	asimo
אסיסי	assisi
אסיק	asik
אסמאעיל	ismail
אסמרא	asmara
אסן	essen
אסנא	esna
אספאראגין	asparagine
אספו	espoo
אספיריטו	espirito
אספראנטו	esperanto
אסקובאר	escobar
אסקולי	ascoli
אסקוריאל	escorial
אסקי	ascii
אסקיל	eskell
אפגאני	afghani
אפגנסיטאן	afghanistan
אפולו	apolo
אפוליא	apulia
אפולינאריס	apollinaris
אפולינייר	apollinaire
אפוסטול	apostol
אפטון	upton
אפיצ'ט	apichet
אפליק	affleck
אפסטין	epstein
אפצ'ירצ'	upchurch
אפרודאיטי	aphrodite
אפרון	efron
אפרים	ephraim
אפריקא	africa
אפריקאנר	afrikaner
אפרת	efrat
אק	ak
אקאדימיה	accademia
אקאייב	akayev
אקאסוסו	acasuso
אקאקי	akaki
אקואדור	ecuador
אקונא	acuna
אקונומיסט	economist
אקוסטא	acosta
אקי	aki
אקיהיטו	akihito
אקיוטיפוליא	acutifolia
אקסון	exxon
אקסטרא	xtra
אקרא	accra
אקרובאט	acrobat
אקרמאן	ackerman
אראבא	arraba
אראי	arae
אראמיד	aramid
אראנא	arana
ארביל	arbel
ארבע	arba
ארגון	arghun
ארדאהאן	ardahan
ארדביל	ardabil
ארדיליס	ardiles
ארדשיר	ardashir
ארהארד	erhard
ארהוס	aarhus
ארון	arun
ארונסון	aaronsohn
ארז	erez
ארזי	arazi
ארטא	arta
ארטו	arto
ארטורו	arturo
ארטים	artem
ארטימיס	artemis
אריאדני	ariadne
אריאל	ariel
אריטומו	aritomo
אריטריא	eritrea
ארייביאן	arabian
ארינד	arend
אריס	eris
אריסטיד	aristide
אריסטיזאבאל	aristizabal
אריקסון	erikson
ארכאנגילסק	arkhangelsk
ארלין	arlen
ארמאנדו	armando
ארמיא	armia
ארמין	armin
ארמיניא	armenia
ארנו	arnaud
ארנוט	arnaut
ארני	arne
ארנסטו	ernesto
ארס	ars
ארסן	arsen
ארצי	artzi
ארקולאנו	ercolano
ארשאבין	arshavin
ארתור	arthur
אש	ash
אשדאון	ashdown
אשדוד	ashdod
אשטאר	ishtar
אשלי	ashley
אשקלון	ashkelon
אשקרופט	ashcroft
אשרף	ashraf
אתוס	athos
אתיופיאן	ethiopian
אתלטיק	athletic
אתרוג	etrog
באבא	baba
באבאיארו	babayaro
באבאקאן	babacan
באבאקר	babacar
באבי	babi
באבילון	babylon
באבנגידא	babangida
באג'יו	baggio
באגאיוקו	bagayoko
באגרי	bagheri
באדו	badou
באדוליו	badoglio
באדילא	badilla
באדר	bader
באהאמאס	bahamas
באהי	bahi
באהיא	bahia
באהר	baher
באהרו	bahro
באוהאוס	bauhaus
באוור	bauer
באזאני	bazzani
באזוקא	bazooka
באט	batt
באטו	batteux
באטומי	batumi
באטורי	bathory
באטיא	bhatia
באטיסטא	battista
באטיסטוטא	batistuta
באטיסטון	battiston
באטיסטי	battisti
באטלר	butler
באי	bai
באיבארס	baibars
באידאצ'ני	baidachny
באיומי	bayoumi
באיזא	baeza
באיזיד	bayezid
באייסטא	ballesta
באיקאל	baikal
באיקי	bikey
באירו	bayrou
באכום	bakhoum
באכמאן	bachmann
באלאבאן	balaban
באלאטון	balaton
באלאק	ballack
באלבו	balbo
באלדור	baldur
באלדי	balde
באלדרי	baldry
באלוטא	ballotta
באלויי	baloyi
באלטא	balta
באלטאסאר	baltasar
באלטימור	baltimore
באלי	bali
באליטש	baljic
באלינט	balint
באליסטיק	ballistic
באלירא	valera
באלמר	balmer
באלנטינא	valentina
באלקאנז	balkans
באמאקו	bamako
באמבאנג	bambang
באמבי	bambi
באמיאן	bamyan
באמיר	bamir
באמלט	bamlett
באמר	bammer
באמרונג	bamrung
באנאטין	bannatyne
באנג'ו	banjo
באנגאלור	bangalore
באנגורא	bangoura
באנדאר	bandar
באנדאראנאיקה	bandaranaike
באנדו	bando
באנדירא	bandeira
באנדיראס	banderas
באנדלר	bandler
באנטוסטאן	bantustan
באנטינג	bunting
באניל	banel
באנקאריל	bancarel
באנקוק	bangkok
באנקס	banks
באנקסי	banksy
באנש	bunche
באסאלא	bassala
באסבי	busby
באסטו	basto
באסטיאן	bastian
באסטן	basten
באסטר	buster
באסי	bassi
באסיל	basile
באסילא	bassila
באסים	bassim
באסינאס	basinas
באסינגר	basinger
באסיסקו	basescu
באסל	basel
באסלר	basler
באסם	bassem
באצ'אן	bachchan
באק	bak
באקאו	bacau
באקאלא	bakala
באקארדי	bacardi
באקארי	bakari
באקו	baku
באקמאסטר	buckmaster
באקר	bucker
באר	bar
באראו	barrau
באראזאיט	barazite
באראכא	baraja
באראם	baram
באראמידזה	baramidze
באראנקוס	barrancos
בארבאדוס	barbados
בארבארוסא	barbarossa
בארבוסא	barbosa
בארבור	barbour
בארבירא	barbera
בארדון	bardon
בארדין	bardeen
בארדם	bardem
בארדסלי	bardsley
בארו	barro
בארוד	baroud
בארוטי	baroti
בארון	barron
בארוניו	baronio
בארוסו	barroso
בארזאלי	barzagli
בארזאני	barzani
בארטולומיו	bartolomeo
בארטולוצ'י	bartolucci
בארטולי	bartoli
בארטון	barton
בארטוש	bartosz
בארטיז	barthez
בארטלט	bartlett
בארטר	bartter
בארי	barry
באריזי	baresi
בארימור	barrymore
באריסון	barison
בארלאך	barlach
בארמוס	barmos
בארנול	barnaul
בארניט	barnet
בארניטא	barnetta
בארקין	barkin
בארקלי	barkley
בארקליי	barclay
בארקר	barker
בארתולומיו	bartolomeu
באשו	basho
באשי	bashi
באשילה	bachelet
בג	bg
בג'אוי	bedjaoui
בגדאד	baghdad
בגדאדי	baghdadi
בגזילא	bugzilla
בד	bad
בדו	badu
בדי	bedi
בהאדורי	bahadori
בהג'א	bahja
בהג'ט	bahjat
בהזאדי	behzadi
בהטאש	behtash
בהיר	bahir
בהקט	behcet
בהראם	bahram
בהראמי	behrami
בואינג	boeing
בואקיה	boakye
בוארק	buarque
בוב	bob
בובאדילא	bobadilla
בובאן	boban
בובו	bobo
בובולינא	bouboulina
בובקא	bubka
בובקר	boubacar
בובר	buber
בוברניק	bubernik
בוג'לבאן	boujelbene
בוגאנדא	buganda
בוגארט	bogart
בוגדאן	bogdan
בוגניט	bugnet
בודאן	budan
בודהא	buddha
בודום	bodom
בודיאניסקי	budyanskiy
בודיקא	boudica
בודמר	bodmer
בודרום	bodrum
בוהארי	buhari
בווא	bois
בוזאו	buzau
בוזאן	buzan
בוזאניטש	bozanic
בוזארה	bouzarah
בוזולג'אק	bozoljac
בוזניאקי	wozniacki
בוזק	buzek
בוחטורי	buhturi
בוחירד	bouhired
בוטא	botta
בוטהאר	boutahar
בוטו	bhutto
בוטון	botton
בוטור	butor
בוטילי	butelle
בוטינאנט	butenandt
בוטינג	boateng
בוטירו	botero
בוטליליס	boutlilisse
בוי	booy
בויאדין	vujadin
בויאנוביטש	vujanovic
בויאצ'ק	vojacek
בויבודינא	vojvodina
בויגיס	buigues
בויוביטש	vujovic
בויט	voight
בויטא	vojta
בויטיטש	vojtech
בויטן	buyten
בויל	boyle
בוינו	bueno
בוינוב	voynov
בוינוס	buenos
בויסון	buisson
בוכארא	bukhara
בוכארסט	bucharest
בוכהולץ	buchholz
בוכנר	buchner
בול	boole
בולא	bola
בולאחרוז	boulahrouz
בולאנד	boland
בולאנדרי	volandri
בולארד	bullard
בולה	bulleh
בולוני	boloni
בולוס	boulus
בולזאנו	bolzano
בולט	bolt
בולטירא	volterra
בוליאן	buljan
בוליטיירי	bollettieri
בולילי	bolelli
בולין	boleyn
בולנט	bulent
בולצמאן	boltzmann
בולקיה	bolkiah
בולר	voller
בום	baume
בומא	bouma
בומיס	bomis
בומניג'ל	boumnijel
בומר	bommer
בון	bonn
בונאנו	bonano
בונארד	bonnard
בונגאני	bongani
בונגארץ	bongartz
בונדארינקו	bondarenko
בונו	bono
בוני	bonnie
בוניט	bonnet
בוניטו	bonetto
בונייר	bonaire
בונין	bunin
בוניסל	bonnissel
בוניק	boniek
בונירא	bonera
בונסאי	bonsai
בונקול	buncol
בונר	bonner
בונראקו	bunraku
בוסאצקי	bosacki
בוסאקא	busacca
בוסטן	boston
בוסיללי	boselli
בוסיניטש	vucinic
בוסיס	bossis
בוסמאן	bosman
בוסניטש	bosnich
בוסקו	bosko
בועב	bouab
בועז	boaz
בוק	boc
בוקא	boka
בוקוביטש	vukojevic
בוראוי	bouraoui
בוראל	boral
בוראנא	borana
בורבאקי	bourbaki
בורגו	borgo
בורגיטי	borgetti
בורגיס	burgess
בורגניטש	burgnich
בורד	burd
בורדה	bordet
בורדון	bordon
בורדיו	bourdieu
בורדינסקי	burdenski
בורדן	borden
בורו	boru
בורובודור	borobudur
בורוטש	boruc
בורונדי	burundi
בורונין	voronin
בורוסיא	borussia
בורוק	buruk
בורט	burt
בורטן	burton
בוריאטיא	buryatia
בוריאני	buriani
בוריטסו	buretsu
בוריילו	borriello
בוריל	burrell
בוריס	boris
בורכיס	borges
בורל	borel
בורלא	burla
בורלאנד	borland
בורמאן	bormann
בורניו	borneo
בורנלי	burnley
בורנסטאין	bornstein
בורסאטש	bursac
בורק	burke
בורקהארט	burckhardt
בורקע	burqa
בורקרט	burkert
בורשארדט	borchardt
בושארדיו	bouchardeau
בושימי	buscemi
בושמן	bushmen
בושעיב	bouchaib
בזלאל	bezalel
בחמדון	bhamdoun
בחניני	bahnini
בחר	bahar
בחראני	bahrani
בחריין	bahrain
בטינו	bettino
בטיר	battir
בטרון	batroun
בי	bea
ביאג'יו	biaggio
ביאטריס	beatrice
ביאטריקס	beatrix
ביאנקא	bianca
ביארן	bjarne
ביארני	bjarni
ביבו	vivo
ביבי	bibi
ביביאנא	bibiana
ביביטו	bebeto
ביג	big
ביג'וטאט	bijotat
ביגוניו	bigogno
ביגירד	bigeard
בידא	beda
בידיטש	vidic
בידל	beadle
ביהאן	behan
ביוט	butte
ביוטיטש	vujicic
ביונסי	beyonce
ביורן	bjorn
ביזוס	bezos
ביזימונגו	bizimungu
ביזלי	beasley
ביזנט	besant
ביחאר	bihar
ביט	bit
ביטא	betta
ביטאט	bitat
ביטאר	bitar
ביטיני	bettini
ביידא	bayda
ביידאס	beidas
בייה	beye
בייטס	bates
בייל	bale
ביילא	biella
ביילינא	bijeljina
בייני	beynie
בייקון	bacon
בייקר	baker
ביל	bill
בילא	bila
בילאדי	bilady
בילאיא	belaya
בילאמי	bellamy
בילבאו	bilbao
בילהארץ	bilharz
בילוזוגלו	belozoglu
בילונג	billong
בילי	billie
ביליזל	belyzel
ביליטי	belletti
ביליטש	bilic
בילייד	belaid
בילל	billel
בילסא	bielsa
בין	bin
בינאגליו	benaglio
בינגו	bingu
בינה	binet
בינהאקר	beenhakker
בינוא	benoit
בינז	bynes
בינטו	bento
בינידטו	benedetto
בינידיקטין	benedictine
ביניטיז	benitez
ביניסון	benenson
ביניש	beinisch
בינקו	benko
ביסאו	bissau
ביסה	bisset
ביסון	bisson
ביסינטי	bixente
ביסמארק	bismarck
ביסמילה	bismillah
ביקיט	beckett
ביקילא	bikila
ביקין	bikin
ביקלאנד	baekeland
ביר	beer
ביראק	birak
בירג	berg
בירגומי	bergomi
בירגוניו	bergougnoux
בירגיוס	bergius
בירגיט	birgit
בירגין	bergen
בירגרין	berggren
בירד	baird
בירדזלי	beardsley
בירדיטש	berdych
בירוסוס	berossus
בירוש	biros
בירות	beirut
בירזוט	bearzot
בירטו	berto
בירטוס	bertos
בירטילסן	bertelsen
בירטלז	birtles
בירי	berry
בירן	byrne
בירנאנקי	bernanke
בירנבאום	birnbaum
בירנד	bernd
בירנולי	bernoulli
בירנז	burns
בירני	berni
בירניני	bernini
בירסק	birsk
בירקלי	berkley
בירקמאן	berkman
בירקשיר	berkshire
בירר	berrer
בירתוד	berthod
בירתולד	berthold
בישה	bisha
ביתיסדא	bethesda
ביתנו	beiteinu
בכטיאר	bakhtiar
בכיט	bakhit
בל	bell
בלאגויה	blagoja
בלאזיי	blazej
בלאזיק	blazek
בלאטר	blatter
בלאל	belal
בלאנט	blunt
בלאנצ'ט	blanchett
בלאנק	blanc
בלאנקא	blanka
בלאנקו	blanco
בלאקסטון	blackstone
בלארוס	belarus
בלאש	balash
בלגראד	belgrade
בלדל	bledel
בלו	belo
בלוגי	bellugi
בלוט	ballut
בלוטגן	bluitgen
בלוטות'	bluetooth
בלוך	bloch
בלום	blum
בלונדו	blondeau
בלוק	blok
בלחאג'	belhadj
בלטעה	baltaah
בליון	bellion
בליז	belize
בליטונג	belitung
בלייק	blake
בליס	bliss
בלירי	belleri
בלמונדו	belmondo
בלמונט	belmont
בלקאס	belqas
בלקאסם	belkacem
בלקולה	belqola
בן	ben
בנאדרת	benaderet
בנאזיר	benazir
בנאיאהו	benayahu
בנג'אמין	benjamin
בנגאזי	benghazi
בנדטנר	bendtner
בנדי	bundy
בנדיקט	benedict
בנז	benz
בנזארטי	benzarti
בנט	bent
בנטלי	bentley
בניטו	benneteau
בניטי	benetti
בנילוקס	benelux
בנימין	binyamin
בנין	benin
בנינגטון	bennington
בניני	benigni
בניס	bennis
בנס	benes
בסאם	bassam
בסון	besson
בסייסו	bseiso
בסימר	bessemer
בסלאן	beslan
בסמה	basma
בסרי	basri
בעבדא	baabda
בעלבק	baalbek
בק	bek
בקאטי	bakkati
בקארי	bacary
בקדאש	bakdash
בקהאם	beckham
בקי	becky
בקנבאור	beckenbauer
בקסי	bksy
בקר	bakar
בקרי	bakri
בראגא	braga
בראגאן	barragan
בראד	brad
בראדברי	bradbury
בראדיסקו	bradesco
בראדלי	bradley
בראהי	brahe
בראהם	brahem
בראהמא	brahma
בראהמאן	brahman
בראון	braun
בראט	bratt
בראטז	bratz
בראידן	bryden
בראיזאט	braizat
בראיטנר	breitner
בראילא	braila
בראין	bryan
בראינט	bryant
בראם	bram
בראמירץ	brammertz
בראנדו	brando
בראנדוארדי	branduardi
בראנדון	brandon
בראנדל	brundle
בראנדנברג	brandenburg
בראנט	brant
בראנסון	branson
בראנץ	brandts
בראנקו	branko
בראק	braque
בראקי	bracci
בראקסטון	braxton
בראשיאלי	bracciali
ברגמאיר	burgmeier
ברגמאן	bergman
ברגסון	bergson
ברגר	berger
ברגרין	berggreen
ברהום	barhom
ברו	bru
ברוד	brod
ברודריק	broderick
ברוז	broz
ברויסארט	broissart
ברויר	breuer
ברוכין	brukhin
ברול	brul
ברולין	brolin
ברומותימול	bromothymol
ברומלי	bromley
ברונו	bruno
ברוני	bruni
ברוניאו	bruneau
ברוניטי	brunetti
ברוניל	brunel
ברונליסקי	brunelleschi
ברונסטין	bronstein
ברונר	brunner
ברוסנאן	brosnan
ברוקי	brockie
ברוקלין	brooklyn
ברוקנר	bruckner
ברוקס	brooks
ברושיטש	brocic
ברזיטש	brzic
ברט	bert
ברטולט	bertolt
ברטי	berti
ברטין	bertin
ברטיני	bertini
ברטראנד	bertrand
ברי	berri
בריאן	briand
בריאנסק	bryansk
בריג'ט	bridget
בריגז	briggs
בריגיט	brigitte
בריגירי	bregerie
בריגם	brigham
ברידג'	bridge
ברידג'ז	bridges
ברידי	brede
בריז	breeze
בריט	brett
בריטאני	brittany
בריטון	breton
בריטיש	british
בריטני	britney
בריטשיט	brechet
בריידי	brady
ברימה	brehme
ברימנר	bremner
ברין	breen
ברינאן	brennan
ברינגאס	bringas
ברינדל	brendell
ברינט	brent
בריניאר	brynjar
בריס	bresse
בריסביין	brisbane
בריסון	brisson
בריסט	brest
בריסטול	bristol
בריק	brik
בריקסטון	brixton
ברישט	brecht
בריاל	braille
ברלינר	berliner
ברלסקוני	berlusconi
ברמאן	berman
ברמדא	barmada
ברמודא	bermuda
ברנאדוט	bernadotte
ברנאדיט	bernadette
ברנאר	bernard
ברנארדו	bernardo
ברנארדינו	bernardino
ברנדאן	brendan
ברנהארד	bernhard
ברנו	brno
ברני	bernie
ברנייז	bernays
ברנסטאין	bernstein
ברנר	brenner
ברסלין	breslin
ברצ'לינו	bercellino
ברצ'ם	barcham
ברקה	barka
בשאר	bashar
בשארי	bsharri
בשיר	bachir
בת	beth
ג'אבי	jabi
ג'אגדיו	jagdeo
ג'אד	judd
ג'אואד	jawad
ג'אואדי	djawadi
ג'אודאט	jawdat
ג'אוואד	javad
ג'אווד	jawed
ג'אורס	jaurs
ג'אידי	jaidi
ג'אלו	jaloo
ג'אלמא	djalma
ג'אמאטי	giamatti
ג'אמובאנדו	jamuovandu
ג'אמל	jamel
ג'אנדופו	jeandupeux
ג'אניוני	giagnoni
ג'אניז	janez
ג'אנין	janine
ג'אניני	giannini
ג'אניס	janis
ג'אנלויג'י	gianluigi
ג'אנלוקא	gianluca
ג'אנסון	jansson
ג'אנסן	janssen
ג'אנקארלו	giancarlo
ג'אנקו	junko
ג'אסט	just
ג'אסטין	justine
ג'אסטן	justin
ג'אסים	jassim
ג'אסינטו	giacinto
ג'אסם	jasem
ג'אפ	jaap
ג'אפקא	djakpa
ג'אקאר	jacquard
ג'אקובי	jacobi
ג'אקובסון	jacobson
ג'אקלין	jacqueline
ג'אקמאן	jackman
ג'אקמוט	jacmot
ג'ארו	jarreau
ג'ארוד	jarrod
ג'ארזיניו	jairzinho
ג'אריד	jared
ג'באר	djebar
ג'בל	jabal
ג'דינא	jedina
ג'האד	jehad
ג'האן	jahan
ג'האנגיר	jahangir
ג'ו	jo
ג'ואד	jaouad
ג'ואו	joao
ג'ואנא	joanna
ג'ואקים	joachim
ג'ואקין	joaquin
ג'ואקינו	gioachino
ג'וב	job
ג'ובאן	jovan
ג'ובאנא	giovanna
ג'ובאני	giovanni
ג'ובינטוד	juventud
ג'וג'י	joji
ג'ודאר	jodar
ג'ודה	judah
ג'ודט	judt
ג'ודי	jody
ג'ודית	judit
ג'והאז	juhasz
ג'והאנסברג	johannesburg
ג'והו	jouhaux
ג'והר	johar
ג'וזיף	jozsef
ג'וזיפי	giuseppe
ג'וזף	joseph
ג'וחפיה	juhfiyah
ג'וחר	dzhokhar
ג'וטשי	jochi
ג'וי	joey
ג'ויס	joyce
ג'ול	joel
ג'ולי	julie
ג'וליא	julia
ג'וליאט	juliette
ג'וליאן	julian
ג'וליאנו	juliano
ג'וליאני	giuliani
ג'וליוס	julius
ג'ולייט	juliet
ג'ומו	jomo
ג'ומיי	jomei
ג'ונאס	jonas
ג'ונביניט	jonbenet
ג'ונבלאט	jumblatt
ג'ונגר	junger
ג'ונז	jones
ג'וני	johnny
ג'ונייד	junayd
ג'ונין	junnin
ג'ונינהו	juninho
ג'ונסון	jonson
ג'ונקויט	jonquet
ג'ונתן	jonathan
ג'וס	jos
ג'וסו	giosue
ג'וסטאין	jostein
ג'וסיפ	josep
ג'וסיפז	josephs
ג'וסלין	jocelyne
ג'וספאן	jospin
ג'וק	jock
ג'ורבאן	jorvan
ג'ורג	jorg
ג'ורג'א	georgia
ג'ורג'ו	giorgio
ג'ורג'י	georgy
ג'ורג'ינז	georgians
ג'ורג'יניו	jorginho
ג'ורג'סקו	georgescu
ג'ורוטא	jurota
ג'ורקאס	giourkas
ג'ושוא	joshua
ג'זירי	jaziri
ג'חש	jahsh
ג'ט	jet
ג'טין	cetin
ג'יא	jia
ג'יאי	jiayi
ג'יאנאקאפולוס	giannakopoulos
ג'יאנג	jiang
ג'יאניס	giannis
ג'יאנקינג	jianqing
ג'יבריל	jibril
ג'יהאד	jihad
ג'יהאי	jihai
ג'יובאני	giovane
ג'יורגוס	giorgos
ג'יטו	jito
ג'יי	jay
ג'יים	jame
ג'יימז	james
ג'יימי	jamie
ג'יימסון	jameson
ג'ייסן	jason
ג'ייקובס	jacobs
ג'ים	jim
ג'ין	gene
ג'ינאס	jenas
ג'ינו	gino
ג'יניו	jinyu
ג'יניי	jenei
ג'לויד	jlloyd
ג'לול	djelloul
ג'מאל	jamal
ג'מיסון	jamieson
ג'נדלי	jandali
ג'נטיאנא	gentiana
ג'נטילי	gentile
ג'נטלסקי	gentileschi
ג'ני	jenni
ג'ניאט	jenyat
ג'נינגז	jennings
ג'ניפר	jennifer
ג'נסן	jensen
ג'נקס	jencks
ג'סיקא	jessica
ג'עפר	gaafar
ג'עפרגולי	jafargholi
ג'ף	geoff
ג'פרי	geoffrey
ג'ק	jack
ג'קי	jackie
ג'ראלד	gerald
ג'ראלדין	geraldine
ג'ראנימו	geronimo
ג'רארד	gerrard
ג'רום	jerome
ג'רי	jerry
ג'ריקו	jericho
ג'רם	jrme
ג'רמאן	german
ג'רמי	jeremie
ג'רמיין	jermain
ג'רקו	jerko
גwאני	gianni
גאבורון	gaborone
גאבי	gaby
גאבידון	gabbidon
גאבן	gavin
גאבר	gaber
גאבראס	gavras
גאבריאלה	gabriela
גאגא	gaga
גאגארין	gagarin
גאגו	gago
גאדיש	gadish
גאודי	gaudi
גאון	gaon
גאזאניגא	gazzaniga
גאזי	ghazi
גאזפרום	gazprom
גאטוסו	gattuso
גאי	guy
גאיגראן	ghayeghran
גאידוסיק	gajdůsek
גאיטאן	gaetan
גאיטאנו	gaetano
גאלא	galla
גאלאנד	galland
גאלאס	gallas
גאלאסיק	galasek
גאלאקוס	galakos
גאלארדו	gallardo
גאלבין	galvin
גאלבריית	galbraith
גאלוואני	galvani
גאלזוורתי	galsworthy
גאלטון	galton
גאלי	galli
גאליאני	galliani
גאליטי	galletti
גאליליי	galilei
גאלימזיאן	galimzyan
גאלינוביטש	galinovic
גאליס	galis
גאליסי	gallice
גאליק	galic
גאמארא	gamarra
גאמבון	gambon
גאמביריני	gamberini
גאמסאכורדיא	gamsakhurdia
גאן	gann
גאנא	ghana
גאנג'אוי	ganjavi
גאנג'ז	ganges
גאנגניהיסו	gangnihessou
גאנדאם	gundam
גאנדולפיני	gandolfini
גאנדי	gandhi
גאניס	ganis
גאנם	ghanem
גאס	gus
גאסאמא	gassama
גאספאר	gaspar
גאספוז	gaspoz
גאסקה	gasquet
גאסקוין	gascoigne
גאסקל	gaskell
גאראדאנוב	garadanow
גאראי	garay
גאראנג	garang
גארבא	garba
גארבארק	garbarek
גארבו	garbo
גארבוט	garbutt
גארגאנו	gargano
גארגו	gargo
גארגולא	gargula
גארד	garde
גארדנר	gardner
גארדר	gaarder
גארזון	garzon
גאריב	gharib
גאריבאלדי	garibaldi
גארינשא	garrincha
גאריסב	gariseb
גאריקס	garics
גארמנדיא	garmendia
גארסיא	garcia
גארפילד	garfield
גאתרי	guthrie
גבריסילאסי	gebrselassie
גד	gad
גדאנסק	gdansk
גו'טלאנד	jutland
גוא	goa
גואדיאנא	guadiana
גואטימאלא	guatemala
גואנגהו	guanghu
גואנטאנאמו	guantanamo
גוארינו	guarino
גובו	govou
גובי	gobbi
גובלז	goebbels
גוג	gogh
גוג'ונסון	guojohnsen
גוגול	gogol
גוגוש	googoosh
גוגינו	gugino
גוגל	google
גוגלילמו	guglielmo
גוגן	gauguin
גוגנהאים	guggenheim
גודא	goda
גודילי	gudelj
גודיסון	goodison
גודיריאן	guderian
גודל	godel
גודפרי	godfrey
גוהורי	gohouri
גוהר	gohar
גוזאן	guzan
גוטבזאדה	ghotbzadeh
גוטו	goto
גוטייריז	gutierrez
גוטלוב	gottlob
גוטליב	gottlieb
גוטמאן	guttmann
גוטנברג	gutenberg
גוטסקוב	gutzkow
גויאם	guillaume
גויאן	goian
גויבוזא	guebuza
גוידו	guido
גויזא	guiza
גוילוט	guillot
גוילירמו	guillermo
גוין	gwen
גוינון	guenon
גויראני	guirane
גוירירו	guerreiro
גוכאן	gokhan
גול	gul
גול'יאן	julien
גולאם	ghulam
גולאנסקי	golanski
גולבורן	golbourne
גולבנקיאן	gulbenkian
גולגי	golgi
גולדא	golda
גולדברג	goldberg
גולדווטר	goldwater
גולדזיהר	goldziher
גולדסטין	goldstein
גולון	goulon
גולמוחמדי	golmohammadi
גולסטאן	golestan
גומאס	goumas
גומיז	gomes
גומע	goma
גונאר	gunnar
גונאריס	gounaris
גונארסון	gunnarsson
גונוהיו	gonnohyoe
גונזאלו	gonzalo
גונזאלז	gonzalez
גוניטשירו	junichiro
גוס	guus
גוסארוב	gusarov
גוסטאב	gustave
גוסטאבו	gustavo
גוסטאף	gustaf
גוסלין	jocelyn
גוסלינג	gosling
גוסן	ghosn
גוסנבאור	gusenbauer
גופמאן	gofman
גופראן	gouffran
גוצ'יני	guccini
גוצאנטי	guzzanti
גוראני	gorani
גורדון	gordon
גורדיאן	gordian
גורינג	goring
גורירו	guerrero
גורליץ	gorlitz
גורן	goren
גורניאק	gorniak
גורקוף	gourcuff
גורקי	gorky
גורשקוב	gorshkov
גוש	ghosh
גושו	gosho
גות	goth
גותאלס	goethals
גי'ולוג'י	geology
גיאן	gyan
גיבון	gibbon
גיבז	gibbs
גיבלי	gibli
גיבן	given
גיבסון	gibson
גיגאקס	gygax
גיד	gide
גידיון	gideon
גידימינאס	gediminas
גידיס	geddes
גיולא	gyula
גיוניא	ghionea
גיורא	giora
גיורגי	giorgi
גיורגיוס	georgios
גיזה	giza
גיזינגא	gizenga
גיטא	gita
גיטוליו	getulio
גיטי	guity
גייטס	gates
גייטסהיד	gateshead
גייל	gail
גיילן	galen
גיל	gil
גילא	gila
גילברט	gilbert
גילברטו	gilberto
גילדאס	gildas
גילו	gillo
גילון	gillon
גילז	geels
גילי	gili
גיליספי	gillespie
גילסון	gelson
גילסנקירשן	gelsenkirchen
גילרז	gillars
גילרמאן	gillerman
גימאר	guimard
גימי	gimme
גימיי	gemmei
גימלסטוב	gimelstob
גין	gein
גינא	geena
גינאדי	gennady
גינגיטש	đinđic
גינגיני	genghini
גינולא	ginola
גיניס	guinness
גינסבורג	ginzburg
גינריך	genrikh
גינשו	gensho
גיסקארד	guiscard
גיצ'י	giichi
גיקאס	gekas
גיראלדו	giraldo
גירוקאסטר	gjirokaster
גירט	geert
גירטרוד	gertrude
גירי	geri
גיריץ	gerets
גירמאניום	germanium
גירנו	gernot
גירנזי	guernsey
גירשוין	gershwin
גיש	gish
גלאל	galal
גלאם	glam
גלובר	glover
גלוטאמין	glutamine
גלוטוב	glotov
גליזר	glazer
גלין	glynn
גלינדא	glenda
גליסון	gleeson
גליסין	glycine
גליק	gleick
גלן	glen
גלעאד	gilad
גמיל	gamil
גמליאל	gamliel
גמר	gamar
גנאם	ghannam
גנאקו	gnako
גנארו	gennaro
גנוצ'י	ghannouchi
גנזורי	ganzouri
גנים	ganim
גסאן	ghassan
גסטאפו	gestapo
געגע	geagea
גפן	geffen
גקזי	geczi
גר	ger
גראבא	grava
גראבאר	grabar
גראהאם	graham
גראזיא	grazia
גראם	graeme
גראמשי	gramsci
גראנאדו	granado
גראנד	grand
גראנדס	grandes
גראנט	grant
גראניט	granite
גראנקביסט	granqvist
גראנר	graner
גראס	grass
גראסי	grassi
גראף	graf
גראפשאפ	graafschap
גרד	gerd
גרהארד	gerhard
גרהארט	gerhart
גרוב	grove
גרומיקו	gromyko
גרונביין	grunbein
גרונדיג	grundig
גרונקיאר	gronkjar
גרוס	gross
גרוסו	grosso
גרוסמאן	grossman
גרופיוס	gropius
גרטי	gerty
גריבאוסקאיטי	grybauskaite
גריבז	greaves
גריגויר	gregoire
גריגור	gregor
גריגוריו	gregorio
גריגירא	grygera
גריזים	gerizim
גריזלוב	gryzlov
גריטא	greta
גריי	gray
גרייב	ghraib
גרייבז	graves
גריינג'ר	grainger
גרייס	grace
גרילא	grella
גרילון	grillon
גרימאלדי	grimaldi
גרימונפון	grimonpon
גרימסון	grimsson
גרין	gren
גרינאדא	grenada
גרינבירג	greenberg
גרינגראס	greengrass
גרינובל	grenoble
גרינווד	greenwood
גרינט	grint
גריניט	grenet
גרינספאן	greenspan
גרינפיס	greenpeace
גריקטינג	grichting
גריר	grier
גרישאם	grisham
גרנביל	grenville
גרנדונא	grondona
גרש	geresh
גתה	goethe
דאבו	dabo
דאבור	davor
דאבידקא	davidka
דאביסון	davison
דאגאנו	dagano
דאגסטאן	dagestan
דאגר	dagher
דאדא	dada
דאדו	dado
דאהומי	dahomey
דאו	dao
דאואלא	davala
דאודורו	deodoro
דאוה	dawa
דאווידינקו	davydenko
דאוויניו	davinio
דאויד	dawid
דאונינג	downing
דאטי	dati
דאטסאקורן	datsakorn
דאי	dai
דאיאן	dianne
דאיוו	daewoo
דאיזנהופר	deisenhofer
דאימיו	daimyo
דאינילי	dainelli
דאיסוק	daisuke
דאיסלר	deisler
דאיר	dyer
דאירו	dayro
דאל	dahl
דאלאס	dallas
דאלגליש	dalglish
דאלטון	dalton
דאליא	dalia
דאלנט	dalnet
דאם	damme
דאמאנאקיס	damanakis
דאמאס	damas
דאמיאן	damien
דאמיאנוביטש	damjanovic
דאן	dunn
דאנא	danna
דאנגדא	dangda
דאנון	danon
דאנטה	dante
דאני	dany
דאניא	dania
דאניאל	danyel
דאנייל	danijel
דאניילז	daniels
דאניילסן	danielsen
דאנילו	danilo
דאנינוס	daninos
דאנסטאפל	dunstaple
דאנקירק	dunkirk
דאנר	danner
דאנשוור	daneshvar
דאסאייב	dasayev
דאסולט	dassault
דאסטין	dustin
דאף	duff
דאפו	dafoe
דאפי	duffy
דאקוטא	dakota
דאר	dar
דאראבונט	darabont
דארבי	darby
דארדין	dardenne
דארה	dara
דאריו	dario
דאריוס	darius
דאריל	durrell
דארמיאן	darmian
דארסי	darcy
דארסיס	darcis
דארקו	darko
דבאג	debbagh
דבאס	debbas
דבורה	dvora
דבורז'אק	dvorak
דבי	debye
דביד	davide
דבלין	dublin
דג'בו	djvu
דג'וקוביטש	djokovic
דג'ורו	djourou
דג'ורקאייף	djorkaeff
דג'יאן	djian
דג'יטי	djite
דגורביל	deguerville
דגן	dagan
דגניה	degania
דהאם	daham
דהאן	dahan
דהב	dahab
דואדא	daouda
דואו	duo
דואיט	dwight
דואין	dwyane
דוב	dov
דובאל	duvall
דובאלייה	duvalier
דובסון	dobson
דוג	dogg
דוגארי	dugarry
דוגלאס	douglas
דוגריי	dougray
דודאייב	dudayev
דודאמיל	dudamel
דודה	daudet
דודו	dudu
דודומא	dodoma
דודי	dodi
דודיק	dodik
דודקא	dudka
דוהאמל	duhamel
דוהאן	dohan
דוזי	dozy
דוטרי	daughtry
דוטש	deutsche
דויין	dwayne
דויל	doyle
דויסבורג	duisburg
דויקוביטש	dujkovic
דוירטי	doherty
דוכובני	duchovny
דוכי	dokhi
דולבי	dolby
דולביקו	dulbecco
דולוריס	dolores
דולי	dooley
דוליטל	dolittle
דוליים	dulaim
דולינסקי	dolinsky
דולמאטוב	dolmatov
דולמאנז	dolmans
דולסי	dulce
דולצ'ה	dolce
דום	doom
דומאק	domagk
דומורו	domoraud
דומיטיאן	domitian
דומיטרו	dumitru
דומינגו	domingo
דומיניק	dominic
דומיניקא	dominika
דומיניקו	domenico
דומנא	domna
דומנגיני	domenghini
דון	don
דונא	donna
דונאדוני	donadoni
דונאדיל	donadel
דונאטו	donato
דונאטילו	donatello
דונאי	dunai
דונאלד	donald
דונג	dong
דונובאן	donovan
דונטסק	donetsk
דוניזיטי	donizetti
דוניץ	donitz
דונם	dunam
דונסקוי	donskoy
דונר	donner
דוסאן	dusan
דוסבורג	doesburg
דוסטויבסקי	dostoyevsky
דוסינא	dossena
דוסן	dawson
דופאס	dupas
דופונט	dupont
דופלר	doppler
דופרי	dupre
דוצ'ב	dotchev
דוקאליון	deucalion
דוקירטי	docherty
דוקס	dockx
דורא	dora
דוראן	duran
דוראנט	durant
דוראסו	dhorasoo
דורבאן	durban
דורג'י	dorji
דורדיביטש	đorđevic
דורו	douro
דורון	doron
דורותי	dorothy
דורטמונד	dortmund
דורי	dory
דוריא	doria
דוריאן	dorian
דוריגו	dorigo
דוריטש	đuric
דורייד	duraid
דורין	dorin
דורינל	dorinel
דוריס	doris
דורפנר	dorfner
דושאנבה	dushanbe
דושיר	duscher
דותן	dotan
דזאג'יטש	dzajic
דזודזואשבילי	dzodzuashvili
דזורינדא	dzurinda
דזיקו	dzeko
דזירי	dziri
די	d
דיאב	dyab
דיאבי	diaby
דיאבייט	diabate
דיאבלו	diablo
דיאו	diao
דיאוארא	diawara
דיאז	diaz
דיאטא	diatta
דיאמאנטינו	diamantino
דיאמוטין	diamoutene
דיאן	diane
דיאנא	deanna
דיאס	dias
דיאקיטי	diakite
דיארא	diarra
דיארבקר	diyarbakr
דיבאילדר	devilder
דיבאל	devall
דיבואר	devouard
דיבינדרא	devendra
דיביריטש	deveric
דיג'אן	dejan
דיגא	degas
דיגן	degen
דידאט	deedat
דידאלוס	daedalus
דידרו	diderot
דידריק	diderik
דיואלי	diwali
דיוגו	diogo
דיודון	dieudonne
דיומאנסי	diomansy
דיון	dion
דיוניסיוס	dionysius
דיוף	diouf
דיופ	diop
דיור	dior
דיורביל	diourbel
דיזירה	desiree
דיזני	disney
דיטרויט	detroit
דיי	dey
דייבידסן	davidson
דייביז	davies
דייגו	diego
דייוויד	david
דייוידז	davids
דייטון	dayton
דייל	dale
דיילי	daley
דיימלר	daimler
דיין	dane
דיכטר	dichter
דיל	del
דילא	della
דילאס	dellas
דילון	dillon
דילי	dili
דילידא	deledda
דיליטש	delic
דילייטא	dileita
דילייני	delaney
דילמוטי	delmotte
דילסון	delson
דים	deem
דימבא	demba
דימונה	dimona
דימושאקי	dimoschaki
דימיאנינקו	demyanenko
דימיטאר	dimitar
דימיטריו	demetrio
דימיטריס	dimitris
דימיס	demis
דימיצ'לאס	demichelis
דימיריל	demirel
דימיתיל	dimethyl
דינא	deena
דינארא	dinara
דינו	dino
דינוס	dinos
דינזל	denzel
דיני	dini
דיניסוב	denisov
דינק	dink
דינקליג'	dinklage
דיסא	dissa
דיסאו	dessau
דיסאיי	desailly
דיסמאס	dismas
דיסמונד	desmond
דיסקברי	discovery
דיפי	diffie
דיפלאס	deplace
דיק	dick
דיקא	dica
דיקאן	decane
דיקוב	dickov
דיקס	dix
דיקסון	dixon
דיקסיט	dixit
דיר	deir
דיראק	dirac
דירבורן	dearborn
דירבינט	derbent
דירבישאיר	derbyshire
דיריפאסקא	deripaska
דירמוט	dermot
דירק	dirk
דלאדייה	daladier
דלאוור	delaware
דלאילה	delilah
דלאל	dalal
דלביקיו	delvecchio
דלברוק	delbruck
דלגאדו	delgado
דלהי	delhi
דלוהי	dlouhy
דלוז	deleuze
דלימכאנוב	delimkhanov
דלפינו	delfino
דמבלדור	dumbledore
דמידוב	demidov
דמיטרי	dmitri
דמיטרייב	dmitriev
דמיר	damir
דמפסי	dempsey
דן	dan
דנבאר	dunbar
דנבר	denver
דנדאני	dindane
דנהולם	denholm
דניז	deniz
דניזלי	denizli
דניס	denis
דנמארק	denmark
דנשואי	denshawai
דסאי	desai
דסי	desi
דעיבס	daibes
דפנא	dafna
דקטור	dr.
דקיוס	decius
דקל	dekel
דקלים	dekalim
דקלן	declan
דראגאן	dragan
דראגוטינובטש	dragutinovic
דראגונייר	dragonair
דראגוסלאב	dragoslav
דראגילא	dragila
דראגניא	dragnea
דראזין	drazen
דראידן	dryden
דראמאן	dramane
דראקו	draco
דרבי	derby
דרדיוק	derdiyok
דרו	drew
דרוגבא	drogba
דרוויטי	drovetti
דרוז	druze
דרויש	darwish
דרומונד	drummond
דרופסי	dropsy
דרוקר	drucker
דרורי	drewry
דרי	dre
דרידא	derrida
דריוטון	drioton
דריטאר	dretar
דרייק	drake
דרימוורקס	dreamworks
דרינטה	drenthe
דרסדן	dresden
דרעא	daraa
דרק	derek
דרקוביטש	durkovic
האבאנא	havana
האבילאנד	havilland
האבר	haber
האגי	hagi
האגל	huggel
האגן	hagen
האדוק	haddock
האדזיאבדיטש	hadziabdic
האדי	hadi
האדלסטון	huddlestone
האהניל	haehnel
האו	hao
האואי	hawaii
האוארד	havard
האוולז	howells
האויר	hauer
האוסאוי	hawsawi
האוסמאן	hausmann
האופטמאן	hauptmann
האזבינדז	husbands
האט	hat
האטא	hata
האטאפורן	hatthaporn
האטויאמא	hatoyama
האטורי	hattori
האטסומי	hatsumi
האי	hai
האיאבוסא	hayabusa
האיאו	hayao
האיאטו	hayato
האיאמי	hayami
האיאשי	hayashi
האיבין	haibin
האיג'רוגראפי	hydrography
האיד	hyde
האידגר	heidegger
האידונג	haidong
האידוק	hajduk
האידי	heidi
האידלברג	heidelberg
האידן	haydn
האיז	hayez
האילי	haile
האימאנוט	haymanot
האימור	highmore
האין	heintje
האינאן	hainan
האינה	heine
האינז	hines
האיקל	haykel
האירדאל	heyerdahl
האירודין	hairuddin
האישל	heichel
האיתם	haitham
האלברסטאם	halberstam
האלדור	halldor
האלו	halo
האלונין	halonen
האלי	halley
האליוול	halliwell
האמאגוצ'י	hamaguchi
האמאן	hamann
האמאסאקי	hamasaki
האמבולט	humboldt
האמונד	hammond
האמיט	hammett
האמילטון	hamilton
האמינו	haminu
האמל	hammill
האמפטון	hampton
האמפטי	humpty
האמפסטיד	hampstead
האמר	hamer
האמרפיסט	hammerfest
האנגילאנד	hangeland
האנדל	handel
האנדלר	handler
האנדקה	handke
האנוי	hanoi
האנזו	hanzo
האנטשובא	hantuchova
האני	hanni
האניבאל	hannibal
האניגאן	hannigan
האניס	hannes
האניסקו	hanescu
האנסארד	hansard
האנסון	hansson
האנסי	hansi
האנסן	hansen
האנק	hank
האנקי	hanke
האנקס	hanks
האס	hass
האסיק	hasek
האסיקורא	hasekura
האסלר	haßler
האסנקליבר	hasenclever
האפל	happel
האצ'ילינסא	hachilensa
האצ'יסון	hutchison
האקאן	hakan
האקוהו	hakuho
האקיט	hackett
האקינן	hakkinen
האקיקאר	hakikar
האקסלי	huxley
הארא	hara
האראדא	harada
האראלד	harald
הארבי	harvey
הארבין	harbin
הארד	hard
הארדאויי	hardaway
הארדי	hardy
הארולד	harold
הארון	harun
הארוקי	haruki
הארט	hart
הארטמאן	hartman
הארטמוט	hartmut
הארטניט	hartnett
הארטפילד	hartfield
הארי	harry
האריאנא	haryana
האריווד	harewood
האריס	harris
האריסון	harrison
הארל	harrell
הארלאן	harlan
הארלסון	harrelson
הארסאני	harsanyi
הארפו	harpo
הארפר	harper
הארץ	haaretz
הארקוס	harkus
האשים	hashim
האשימוטו	hashimoto
האתאיראטאנאקול	hathairattanakool
הדיגר	hediger
הדמאן	hedman
הדר	hadar
הואינא	huayna
הואסקא	huesca
הוארד	huard
הוארטא	huerta
הוארי	houari
הוב	huub
הובארד	hubbard
הובארט	hobart
הובז	hobbes
הוביי	hubei
הובר	huber
הוג'ו	hojo
הוגאן	hogan
הוגינס	huygens
הודיא	hoodia
הודל	hoddle
הודנה	hudna
הודסון	hudson
הוזומי	hozumi
הוטון	houghton
הוטשינסון	hutchinson
הוי	hui
הויט	hoyte
הוכל	huchel
הול	hall
הולאגו	hulagu
הולאנד	holland
הולגוין	holguin
הולדין	holden
הולדרלין	holderlin
הולודומור	holodomor
הולזנבאין	holzenbein
הולט	holt
הולי	holly
הולידאי	holiday
הולייה	houllier
הוליין	hollein
הוליס	hollis
הוליפילד	holyfield
הולירית	hollerith
הולמאן	holman
הולמבוי	holmboe
הולמז	holmes
הולסט	holst
הולסטין	holstein
הומבירטו	humberto
הומילט	hummelt
הונדרטוואסר	hundertwasser
הוניס	hoeneß
הוניקר	honecker
הונקה	hunke
הונשו	honshu
הוס	hus
הוסאי	houssay
הוסיטש	hosic
הוסין	hocine
הוסקינס	hoskins
הוסרל	husserl
הופ	hope
הופירט	huppert
הופקינס	hopkins
הופשטאדטר	hofstadter
הוצ'ו	hochu
הוק	hawke
הוקו	hoko
הוקוסאי	hokusai
הוראסיו	horacio
הורוביץ	horowitz
הורויץ	horwitz
הוריוצ'י	horiuchi
הוריזונטי	horizonte
הוריישיו	horatio
הורילהו	heurelho
הוריסון	horison
הוריקאוא	horikawa
הורן	horne
הורנא	horna
הורסט	hurst
הושי	hoshi
הושיאר	hoshyar
הזאזי	hazazi
היאם	hayam
היאמא	hiyama
היאנג	hyang
היביסאיד	heaviside
היבירט	hebert
היברט	hibbert
היגז	higgs
היגל	heigl
הידאלגו	hidalgo
הידאקא	hidaka
הידי	headey
הידינק	hiddink
הידיקוטי	hidegkuti
הידיקי	hideki
הידן	hiden
היה	haya
היוברט	hubert
היוגו	hugo
היוז	hughes
היוטון	hughton
היום	hume
היוסטן	houston
היורי	hyori
היט	het
היטון	heaton
היטושי	hitoshi
היטלר	hitler
היטמאן	hitman
היטסלפירגר	hitzlsperger
היטפילד	hetfield
היי	hay
הייג	haig
היידן	haden
הייהאצ'ירו	heihachiro
הייור	heioar
הייז	hayes
הייזבירט	haysbert
הייזנבירג	heisenberg
היילי	hayley
היילנס	heylens
היינז	heinz
הייני	haney
היינימאן	heynemann
הייס	heyse
הייסטינגס	hastings
הייסרר	heisserer
הייקו	heiko
היירו	hierro
הילארי	hilary
הילג	helge
הילגא	helga
הילגוסון	helguson
הילגירא	helguera
הילד	held
הילדי	hilde
הילדיטש	hilditch
הילדר	helder
הילה	hila
הילט	helt
הילטון	hilton
הילי	healey
היליבויק	hellebuyck
היליגין	heyligen
הילינגדון	hillingdon
היליניק	hellenic
הילל	hillel
הילמוט	hellmut
הילנגר	hellinger
הילסברג	hejlsberg
הילפמאן	helpman
הים	hyam
הימא	hima
הימאטוקריט	hematocrit
הימלר	himmler
הינאן	heenan
הינד	hind
הינדלי	hindley
הינדרי	hendrie
הינו	hino
הינז	henze
הינטרמאיר	hintermaier
היני	heaney
הינינג	henning
הינצה	heintze
הינקל	hinkel
הינקס	heynckes
הינר	heiner
הינריך	heinrich
היסאטו	hisato
היסה	hesse
היסילינק	hesselink
היספאניולא	hispaniola
היספירידיס	hesperides
היפוליט	hippolyte
היפיא	hyypia
היפיסטוס	hephaestus
היצ'קוק	hitchcock
היצפילד	hitzfeld
היקארו	hikaru
היקובא	hecuba
היקטור	hector
היקמאן	hickman
היקרסבירגר	hickersberger
היראנו	hirano
היראנומא	hiranuma
היראקאוא	hirakawa
היראקליון	heraklion
היראקליטס	heraclitus
היראקליס	heracles
הירבה	herve
הירבוי	hrvoje
הירדא	herda
הירו	hiro
הירואקי	hiroaki
הירובומי	hirobumi
הירודוטוס	herodotus
הירודיאס	herodias
הירוהאשי	hirohashi
הירוהיטו	hirohito
הירוטא	hirota
הירויוקי	hiroyuki
הירונימוס	hieronymus
הירופומי	hirofumi
הירוקי	hiroki
הירושי	hiroshi
הירושיגה	hiroshige
הירושימא	hiroshima
הירטפורד	hertford
הירמאן	hermann
הירנאן	hernan
הירניטש	hernych
הירצבירג	herzberg
הירצברגר	hertzberger
הירקיוליז	hercules
הירש	hirsch
הירשיל	herschel
הירשפילד	hirschfeld
הישאם	hicham
הלאל	helal
הלוי	halevy
הליב	hleb
הליל	halil
הלמאן	helman
הלמהולץ	helmholtz
הלמוט	helmut
הלן	helen
הלנא	helena
הלסינקי	helsinki
הלק	hulk
המינגווי	hemingway
המסה	hamsa
המפרי	humphrey
הנא	hana
הנאנו	hananu
הנגבי	hanegbi
הנדל	hendel
הנדרי	hendry
הנדריק	hendrik
הנדרסון	henderson
הני	hanny
הנידי	henedi
הניה	haniyeh
הנרי	henry
הנרייט	henriette
הנריק	henryk
הנריקה	henrique
הנריקסן	henriksen
הס	hess
הסטיא	hestia
הסטר	hester
הראוי	hrawi
הראל	harel
הראקליוס	heraclius
הרארי	harari
הרבאטי	hrbaty
הרבן	herbin
הרברט	herbert
הרובש	hrubesch
הרודנא	hrodna
הריסטו	hristo
הריסטוב	hristov
הריתיק	hrithik
הרמאן	herman
הרמון	hermon
הרנאנדיז	hernandez
הרנדל	hurndall
הרץ	hertz
הרצוג	herzog
הרצל	herzl
הרצליה	herzliya
הש	heche
השאם	hesham
השרון	hasharon
הاירובסקי	heyrovsky
ואגדי	wagdi
ואגיז	vagiz
ואגנר	wagner
ואדא	wada
ואדוז	vaduz
ואדים	vadim
ואדיסואב	wladyslaw
ואדל	waddle
ואוא	vava
ואוטרוט	vautrot
ואורזניאק	wawrzyniak
ואורינקא	wawrinka
ואז	vaz
ואזאן	wazzan
ואט	watt
ואטארו	wataru
ואטו	watteau
ואטסון	watson
ואטרוס	watros
ואי	vai
ואיזמאן	wiseman
ואילד	wilde
ואילדר	wilder
ואילז	wiles
ואילי	wiley
ואינהאוס	winehouse
ואיקינג	viking
ואל	val
ואלאזא	walaza
ואלאך	wallach
ואלאס	wallace
ואלדאנו	valdano
ואלדאס	valdas
ואלדהאים	waldheim
ואלדו	waldo
ואלדז	valdes
ואלדיז	valdez
ואלדייר	valdeir
ואלדיס	valdis
ואלדיראמא	valderrama
ואלדמאר	waldemar
ואלון	valon
ואלט	walt
ואלטון	walton
ואלטרז	walters
ואלי	valli
ואליטא	valletta
ואלינטיא	valentia
ואליס	wallis
ואליסא	walesa
ואלירון	valern
ואלירי	valeriy
ואליריו	valerio
ואלנטי	valente
ואלנטין	valentine
ואלנטינו	valentino
ואלנס	valens
ואלנסיא	valencia
ואלצר	walzer
ואלק	valke
ואלקירי	valkyrie
ואלקר	walker
ואלש	walsh
ואנאהימר	vanaheimr
ואנג	wang
ואנגא	vanga
ואנגארי	wangari
ואנגיליס	vangelis
ואנדרלי	vanderlei
ואנהאנין	vanhanen
ואנוני	vanoni
ואנטא	vantaa
ואניס	ouanes
ואניסא	vanessa
ואנס	vance
ואנקובר	vancouver
ואסאראס	vassaras
ואסארי	vasari
ואסארלי	vasarely
ואסיג'	waseige
ואסיו	wassiou
ואסיל	vasyl
ואסילוסקי	wasilewski
ואסילי	wassily
ואסיליס	vasilis
ואסקו	vasco
ואסרמאן	wasserman
ואצלאב	vaclav
ואקאטסוקי	wakatsuki
ואקאמוטו	wakamoto
ואקים	wakim
ואקסמאן	waksman
ואראיו	varallo
וארגא	varga
וארגאס	vargas
וארט	vaart
וארטאן	vartan
ואריז	juarez
וארלאם	varlam
וארנהאגן	varnhagen
וארנוק	warnock
וארסו	warsaw
וארק	wark
ואתיק	wathiq
וד	oued
ודיע	wadie
ודל	weddell
וואלרי	valery
ווגטס	vogts
ווגנר	wegener
ווד	wood
וודביל	woodville
וודגייט	woodgate
וודוארד	woodward
וודז	woods
וודי	woody
וודלי	woodley
וודרו	woodrow
ווהרר	wohrer
ווטריך	wuthrich
ווטרס	wouters
וויסיטש	wojciech
וויסלאב	vojislav
וויצק	wojcik
וול	wole
וולבו	volvo
וולדמורט	voldemort
וולודימיר	volodymyr
וולץ	volz
וומי	wome
וונג	wong
וונגלוס	venglos
וונדרליש	wunderlich
וונלאנתן	vonlanthen
ווס	woese
ווסאם	wesam
ווקוטיטש	vukotic
ווקסיביטש	vukcevic
וורד	ward
וורדזוורת	wordsworth
וורדי	verdi
וורדיקרז	voordeckers
וורילון	vorilhon
וורם	worm
וזירי	vaziri
וזניאק	wozniak
וחיד	vahid
ויא	weah
ויאזמא	vyazma
ויאלי	viale
ויאן	weian
ויאנא	viana
ויאני	viani
ויבינג	weaving
ויבר	weaver
ויג'יי	vijay
ויגור	uyghur
וידאל	vidal
וידוקא	viduka
וידיניטש	vidinic
ויהורסט	wieghorst
ויואלדי	vivaldi
ויויאן	vivien
ויולא	viola
ויולו	violeau
ויזיק	vizek
ויטאלי	vitali
ויטאקר	whitaker
ויטגינשטאין	wittgenstein
ויטור	vitor
ויטוריו	vittorio
ויטיג	wittig
ויטיר	wheater
ויטל	whittle
ויטלאסיל	vytlacil
ויטמאן	wittmann
ויטני	whitney
ויטרוביוס	vitruvius
ויי	wei
וייד	wade
וייט	viet
וייל	vale
ויינא	vienna
וייסגלאס	weissglass
וייסיר	veissire
וייקארט	weikart
ויירא	vieira
ויירון	veyron
ויירי	vieri
וילא	villa
וילאזקיז	velazquez
וילאן	whelan
וילאנד	wiland
וילאסקיז	velasquez
וילארד	willard
וילאריאל	villarreal
וילדרז	wilders
וילהלם	wilhelm
וילהמסון	wilhelmsson
וילוין	welwyn
וילטון	wilton
וילטורד	wiltord
וילי	willy
ויליגאס	villegas
ויליו	viljo
ויליט	villette
וילם	willem
וילמר	wilmer
וילנאי	vilnai
וילנדר	wilander
וילנס	wellens
וילסון	wilson
וילקזק	wilczek
וילקנסן	wilkinson
וילקשיר	wilkshire
וילש	welsh
וילשיר	wilshere
וים	wim
וימיטש	vemic
וימר	wimmer
וין	win
וינאלדא	wynalda
וינגאדא	vingada
וינגר	wenger
וינדהוק	windhoek
וינוגראד	winograd
וינותאי	winothai
וינטורי	venturi
וינטמיליא	ventimiglia
וינטר	venter
וינטרא	vyntra
וינס	vince
וינסון	vinson
וינסטון	winstone
וינסטיקירז	wijnstekers
וינסינט	vincente
וינסלו	winslow
וינק	vink
וינר	weiner
ויסוצקי	vysotsky
ויסטולא	vistula
ויסטרמאן	westermann
ויסי	vesey
ויסיטור	visitor
ויסייר	veissiere
ויסל	wiesel
ויסלאוא	wislawa
ויסלי	vesely
ויסליטש	vicelich
ויסם	wissem
ויסנטה	vicente
ויסניסקי	wisnieski
ויסקונסן	wisconsin
ויץ	weitz
ויצ'יני	vicini
ויצמן	weizman
ויקטור	viktor
ויקטוריאנו	victoriano
ויקי	wiki
ויקצ'יו	vecchio
וירא	vera
ויראיודא	wirajuda
וירג'יני	virginie
וירג'יניא	virginia
וירגיל	virgil
וירהיין	verheyen
וירון	veron
וירונא	verona
וירילוג	verilog
וירכויאנסק	verkhoyansk
וירן	verne
וירץ	wiertz
וירקירק	verkerk
וישנבסקי	vyshnevskyi
וישנו	vishnu
וישניבא	vishneva
ולאדו	vlado
ולאדיטש	vladic
ולאדימיר	vladimir
ולאדיקא	vladica
ולאדיקאבקאז	vladikavkaz
ולאזקיז	velzquez
ולאסטימיל	vlastimil
ולאסיטש	vlasic
ולהא	velha
ולהאוזן	wellhausen
ולוסו	veloso
ולטאבא	vltava
ולטר	welter
וליגן	vliegen
ולימיר	velimir
וליקו	veliko
ולצ'ק	vlcek
ולקאן	volkan
ונדי	wendy
ונזוילא	venezuela
ונטוורת	wentworth
וניזילוס	venizelos
וניטו	veneto
וניס	venice
וסטוק	vostok
וסטינגהאוס	westinghouse
וסטמורלאנד	westmoreland
וסטנרא	westenra
וסילין	veselin
וסלנדר	wislander
וסנין	vesnin
וענונו	vanunu
ור	wehr
וראק	warraq
ורד	vered
ורדי	verde
ורוניקאז	veronicas
וריזאס	vryzas
ורלן	verlaine
ורמונט	vermont
ורמיילן	vermaelen
ורמילהינו	vermelhinho
ורמיר	vermeer
ורמס	vermes
ורנון	vernon
ורסינגיטוריקס	vercingetorix
ורקואטירין	vercauteren
ורקוטר	vercoutre
ורתינגטן	worthington
ז'או	zhao
ז'אנג	zhang
ז'באניא	zhvania
ז'ו	zhu
ז'ול	jules
ז'י	zhi
ז'יי	zhiyi
ז'יניו	zhenyu
ז'ירקוב	zhirkov
ז'נג	zheng
ז'ק	jacques
ז'קוב	zhekov
זאבאליטא	zabaleta
זאבין	zaven
זאגאלו	zagallo
זאהוביטש	zahovic
זאהורסקי	zahorski
זאהי	zahi
זאהיר	zahir
זאור	zaur
זאט	zat
זאיאטי	zayatte
זאידיה	zaidiyyah
זאידן	zaidan
זאיטסיב	zaytsev
זאייטש	zajec
זאימוגלו	zaimoglu
זאינאדפור	zanidpour
זאירי	zairi
זאכאראיא	zachariah
זאכארוב	zakharov
זאלאייטא	zalayeta
זאמבו	zambo
זאמביזי	zambezi
זאמוראנו	zamorano
זאן	zan
זאנא	zana
זאנג	zang
זאנגויל	zangwill
זאנדי	zandi
זאנטיק	zanetic
זאניטי	zanetti
זאפ	zapp
זאפאטא	zapata
זאפאטיר	zapater
זאפאטירו	zapatero
זאפור	zafour
זאק	zach
זאקארי	zachary
זאקואני	zakuani
זאקיר	zakir
זאקירוני	zaccheroni
זאקר	zucker
זאקרמאן	zuckermann
זאראט	zarate
זארמאך	szarmach
זארקו	zarko
זבאניטש	zbanic
זבארטנוטס	zvartnots
זבונאריבא	zvonareva
זבי	zvi
זביאד	zviad
זביהליק	svehlik
זביריב	zverev
זגארטא	zgharta
זגלול	zaghloul
זדיניק	zdenek
זהבי	zahavi
זהוק	zhuk
זואי	zoe
זוביידי	zubeidi
זובין	zubin
זוביר	zoubeir
זוברבוהלר	zuberbuhler
זוברין	zubrin
זוהיר	zuhair
זוהר	zuhr
זוואיר	zweyer
זוזימו	zozimo
זוי	zoi
זויטרמיר	zoetermeer
זויריב	xuereb
זולא	zola
זולאקו	zewlakow
זולטאן	zoltan
זוליק	zoellick
זומא	zuma
זונג	zong
זוננשאין	sonnenschein
זוס	zuse
זועבי	zuabi
זוקורא	zokora
זוקירו	zucchero
זוראב	zurab
זוראוסקי	zurawski
זוראן	zoran
זורו	zorro
זורין	zorin
זורר	zurer
זטקין	zetkin
זיאנב	zainab
זיאני	ziani
זיב	zib
זיבאלייביטש	zivaljevic
זיבארי	zebari
זיביטש	zebec
זיגה	ziege
זיגיד	szeged
זיגלר	ziegler
זידאן	zidane
זיו	zeev
זיזי	zeezee
זיזקא	zizka
זיטון	zeitoun
זיטליץ	zetlitz
זיטקא	zitka
זיי	ziyi
זיידאן	zeidan
זיידון	zaydun
זיל	zell
זילאיא	zelaya
זילאנד	zealand
זילין	zelin
זילינקא	zelenka
זיליקו	zeljko
זילע	zeila
זימין	zemin
זימר	zimmer
זימרמאן	zimmerman
זינאוי	zenawi
זינגן	zengin
זינו	zino
זינטא	zinta
זינסטרום	zennstrom
זינקו	zenko
זיקו	zico
זיריאב	ziryab
זיריאנוב	zyryanov
זירסיז	xerces
זכרון	zichron
זלווגר	zellweger
זלמאן	zalman
זמרק	zamrak
זנאטה	zenata
זנזיבאר	zanzibar
זקארדו	zaccardo
זקי	zeki
זקרמאן	zukerman
זרהוני	zerhouni
זרואל	zeroual
זרואלי	zerouali
זריק	zreiq
זרמאט	zermatt
זרניאטנסקי	czerniatynski
זרקא	zerka
חאבייר	javier
חאג'	hadj
חאג'י	hadji
חאדר	khader
חאואס	hawass
חאוי	hawi
חאזם	hazem
חאטם	hatem
חאיק	hayek
חאיראט	khairat
חאלד	khalid
חאם	ham
חאמאד	hamad
חאמד	hamed
חאמטאי	khamtai
חאן	khan
חאנאקין	khanaqin
חאנון	hanoun
חאפז	hafiz
חאקים	hakim
חאראן	haran
חארב	harb
חאריסטיאס	charisteas
חארית	harith
חאשוגי	khashoggi
חאשורי	khashuri
חביב	habib
חביבי	habibi
חברון	hebron
חברי	habre
חבש	habash
חג'אוי	hadjaoui
חג'רי	hajeri
חדיד	hadid
חדית	hadith
חדשיטי	hadchiti
חואן	juan
חואנא	juana
חואנדי	juande
חובייל	hubail
חובייקה	hobeika
חודאדאד	khodadad
חוואטמה	hawatmeh
חולוד	khouloud
חולון	holon
חומידאן	homaidan
חומס	khums
חוסיינוב	khusainov
חוסייני	husseini
חוסין	hossein
חוסני	hosny
חופי	hofi
חוראני	hourani
חורדאו	jordao
חורוס	horus
חורטסילאבא	khurtsilava
חורי	khoury
חורין	khoren
חורמחב	horemheb
חטא	hatta
חטחור	hathor
חטיבי	khatibi
חיאטו	hayatou
חיאם	khayyam
חיג'אזי	hijazi
חיד	hidd
חידיאטולין	khidiyatullin
חידר	haider
חיטין	hittin
חיים	chaim
חיירי	khairy
חילו	hilu
חימנז	jimenez
חיסוס	jesus
חיפה	haifa
חיקמט	hikmet
חירות	herut
חירסון	kherson
חלו	helou
חלומי	halloumi
חלוץ	halutz
חלילהודזיטש	halilhodzic
חלילו	khalilou
חלילילו	kalililo
חלימי	halimi
חליפה	khalifah
חליקאן	khallikan
חלף	khalaf
חמאדי	hammadi
חמאס	hamas
חמד	hemed
חמדאני	hamdani
חמדי	hamdy
חמוש	hamouche
חמיד	hameed
חמידה	hmede
חמידו	hamidou
חמיט	hamit
חמיס	khamees
חמרוש	hamrouche
חנא	hanna
חנאוי	hanaoui
חנאן	hanan
חנאניא	hanania
חנבל	hanbal
חנדל	handal
חנון	hanoune
חניף	hanif
חסין	hsien
חסן	hasan
חסני	hasni
חפיד	hafid
חקי	haqqi
חקמט	hikmat
חראם	haraam
חרושצ'ב	khrushchev
חרירי	hariri
חרמיש	hermesh
חרקת	harakat
חשמט	heshmat
ט	t
טאבארז	tabarez
טאבאריס	tavares
טאבוקי	tabucchi
טאבורדא	taborda
טאג'ורא	tajura
טאג'יקסטאן	tajikistan
טאגא	taga
טאגו	tagoe
טאגור	tagore
טאדיטש	tadic
טאדיי	taddei
טאהא	taha
טאהיטי	tahiti
טאהיר	tahir
טאו	tao
טאוט	taut
טאונו	tauno
טאזמייניא	tasmania
טאטום	tatum
טאטי	tati
טאטיאנא	tatyana
טאטלין	tatlin
טאטסוקיצ'י	tatsukichi
טאטשיקי	tachiki
טאי	thai
טאיביריאס	tiberius
טאיגר	tiger
טאיטוס	titus
טאילאנד	thailand
טאילינול	tylenol
טאילר	tyler
טאים	taim
טאימאנוב	taimanov
טאימוראז	teimuraz
טאיסון	tyson
טאיסיר	taisir
טאישו	taisho
טאל	tal
טאלבלו	talebloo
טאלי	talley
טאליבאן	taliban
טאלין	tallinn
טאמאגניני	tamagnini
טאמאדא	tamada
טאמבורא	tamboura
טאמבלין	tamblyn
טאמוקסיפין	tamoxifen
טאמפא	tampa
טאמר	tamer
טאמרא	tamra
טאנאסוואן	tanasuwan
טאנאקא	tanaka
טאנג'ה	tange
טאנדון	tandon
טאנזאן	tanzan
טאניא	tanya
טאניזאקי	tanizaki
טאניט	tanit
טאננבאום	tannenbaum
טאנקיאן	tankian
טאנקרידו	tancredo
טאסו	tasso
טאסוטי	tassotti
טאסוס	tassos
טאפט	taft
טאפטס	tufts
טאפר	tafer
טאקאגאקי	takagaki
טאקאגי	takagi
טאקאהאטא	takahata
טאקאהארא	takahara
טאקאהאשי	takahashi
טאקאהירו	takahiro
טאקאיא	takaya
טאקאיוקי	takayuki
טאקאיושי	takayoshi
טאקאנו	takano
טאקאנוהאנא	takanohana
טאקאנורי	takanori
טאקויא	takuya
טאקומי	takumi
טאקוני	tacconi
טאקיו	takeo
טאקיס	takis
טאקישי	takeshi
טארא	tara
טאראבט	taarabt
טאראוא	tarawa
טאראנטו	taranto
טאראנטינו	tarantino
טאראק	tarak
טארדילי	tardelli
טארו	taro
טארטארוס	tartarus
טארטו	tartu
טארי	tare
טאריא	tarja
טארין	tarin
טאריק	tariq
טארליב	tarlev
טארק	tarek
טארקאן	tarkan
טארשיזיו	tarcisio
טאשירו	tashiro
טביליסי	tbilisi
טביר	tver
טברי	tabari
טד	ted
טדאיג'י	tddaiji
טדי	teddy
טדיוס	tadeus
טדמור	tadmor
טהראן	tehran
טואל	twal
טואפסי	tuapse
טוב	tov
טובא	tuva
טובאיאס	tobias
טובאלו	tuvalu
טובי	tobey
טוביטא	tobita
טובין	tobin
טובמאן	tubman
טוג'אן	toujan
טוג'ו	tojo
טוגאי	tugay
טוגאשי	togashi
טוגו	togo
טוד	todd
טודור	todor
טודורוב	todorov
טודיק	tudyk
טודנהופר	todenhofer
טוהיר	tohir
טוויל	tawil
טוז	tuz
טוזיא	tauziat
טוטאל	total
טוטו	toto
טוטורו	totoro
טוטי	totti
טויודא	toyoda
טויוטומי	toyotomi
טויין	twain
טויני	tueni
טולאלאן	toulalan
טולאמור	tullamore
טולוז	toulouse
טולון	toulon
טולידו	toledo
טוליו	tullio
טולסטוי	tolstoy
טומאסי	tomasi
טומארט	tumart
טומו	tomou
טומוט	tommot
טומויוקי	tomoyuki
טומוקאזו	tomokazu
טומוקו	tomoko
טומי	tommy
טומיי	tomei
טומסון	thomson
טומסלאב	tomislav
טומר	tumer
טונג	tong
טונו	tonu
טונטון	tonton
טוני	tony
טוניגאוא	tonegawa
טוניטו	tonetto
טוניס	tunis
טוניסיה	tunisia
טונסי	tounsi
טונקיי	tuncay
טוסון	tusun
טוסיטש	tosic
טוסקאני	tuscany
טופאל	topal
טופאק	tupac
טופולאניק	topolanek
טופי	topi
טופיק	toufic
טופלר	toffler
טופר	topher
טוצ'י	tucci
טוקאן	touqan
טוקאנטינז	tocantins
טוקאר	tukar
טוקוגאוא	tokugawa
טוקיו	tokyo
טוקילאו	tokelau
טוקימונה	tokimune
טוראם	thuram
טוראן	turan
טוראנדוט	turandot
טוראני	tourani
טורבו	turbo
טורבין	torben
טורבינסקי	torbinski
טורגוט	turgut
טורה	toure
טורו	toru
טורונטו	toronto
טורונין	turunen
טורוסידיס	torosidis
טורטולא	tortola
טורטוסא	tortosa
טורי	torre
טוריאמא	toriyama
טוריו	theuriau
טוריומי	toriumi
טורינג	turing
טוריס	torres
טורלו	turlough
טורנהאם	turnham
טורסנוב	tursunov
טורפין	turpin
טורקו	turku
טורקואטו	torquato
טורקי	turki
טורקיש	turkish
טורקמאני	turkmani
טורקמנסיטאן	turkmenistan
טוש	tosh
טושאק	toshack
טושיהידה	toshihide
טושיהיקו	toshihiko
טושיו	toshio
טושיוקי	toshiyuki
טושימיטשי	toshimichi
טושירו	toshiro
טזו	tzu
טזוניס	tzonis
טזניט	tiznit
טחוטמוס	thutmose
טחיה	taheyya
טטסו	tetsu
טיאגו	tiago
טיבולי	tivoli
טיבור	tibor
טיבט	tibet
טיבי	tibi
טיביז	tevez
טיבירטון	tiverton
טיג'אני	tijani
טיגאנא	tigana
טיגוסיגאלפא	tegucigalpa
טיודור	teodor
טיוטיהואקאן	teotihuacan
טיומין	tyumen
טיומקין	tiomkin
טיופילו	teofilo
טיורל	theorell
טיזוקא	tezuka
טיטאנו	titano
טיטוב	titov
טיטיקאקא	titicaca
טייב	tayeb
טיילור	taylor
טיימוריאן	teymourian
טיימפו	tiempo
טיירי	thierry
טיכו	tycho
טילדא	tilda
טילימאן	telemann
טילר	theiler
טים	tim
טימבקטו	timbuktu
טימברלייק	timberlake
טימוטו	temotu
טימור	timur
טימורים	timorim
טימושוק	tymoschuk
טימושינקו	timoshenko
טימותי	timothee
טימי	timmy
טימישוארא	timisoara
טימלין	timlin
טינא	tina
טינאן	tynan
טינאנט	tennant
טינג'י	tenji
טינגיז	tengiz
טינדילו	tendillo
טינוריו	tenorio
טיניאן	tinian
טינסינג	tenzing
טינקו	tenco
טיסדייל	tisdale
טיסיליוס	tiselius
טיקו	tico
טיקופיא	tikopia
טיקליאנו	ticleanu
טיקס	tex
טיראוצ'י	terauchi
טיראנא	tirana
טיראסומא	terasoma
טיראסיל	teerasil
טיראספול	tiraspol
טיראתפ	teerathep
טירול	tyrol
טירזאנידיס	terzanidis
טירטלטאוב	turteltaub
טירי	terry
טירינס	terrence
טיריסינא	teresina
טירמי	terme
טירנאניטש	tirnanic
טירני	tierney
טירסן	tiersen
טישו	tessho
טלאל	talal
טלי	tali
טלעט	talaat
טלפאח	talfah
טמבל	tambal
טמבלנד	timbaland
טמים	temime
טמסמאני	temsamani
טמפלהוף	tempelhof
טנג	teng
טנגאניקא	tanganyika
טנזאניא	tanzania
טנטא	tanta
טנריף	tenerife
טסאבט	tsabet
טסאריב	tsarev
טסובוי	tsuboi
טסוטומו	tsutomu
טסונאיושי	tsunayoshi
טסירקבא	tserkva
טסכינבאלי	tskhinvali
טסעדיט	tassadit
טפילו	tefilo
טצ'אנגאי	tchangai
טקסים	taksim
טקפיריה	takfiri
טראבזון	trabzon
טראביאן	travian
טראביס	travis
טראבלסי	trabelsi
טראברז	travers
טראוי	traoui
טראורי	traore
טראיאן	traian
טראיאנוס	traianos
טראנה	taraneh
טראנסאט	transat
טראנסילוואניא	transylvania
טראנסניסטריא	transnistria
טראנסקיי	transkei
טראפאטוני	trapattoni
טראפאני	trapani
טראפורד	trafford
טראש	trasch
טרוטא	trotta
טרוטסקי	trotsky
טרוי	troy
טרויסי	troisi
טרולז	troels
טרולי	trulli
טרומאן	truman
טרונדהאים	trondheim
טרוסט	troost
טרוסיה	troussier
טרוסירו	trossero
טרוקווסקי	trochowski
טרושקן	troshkin
טרזאן	tarzan
טרטוס	tartus
טרטליאן	tertullian
טריבור	trevor
טריביטש	trivic
טריביסו	treviso
טריג	treg
טריג'ו	trejo
טריגבי	trygve
טריזיגה	trezeguet
טרייל	traill
טרימורטי	trimurti
טרינטון	trenton
טרינטינו	trentino
טריסור	tresor
טריסט	trieste
טריסטאן	tristan
טריסטראם	tristram
טריף	tarif
טריפולי	tripoli
טריפל	triple
טריק	trek
טריר	trier
טרנאבא	trnava
טרנבול	turnbull
טרנופיל	ternopil
טרשקובא	tereshkova
טשאטו	tchato
טשארוויט	charvet
טשומוגו	tchomogo
טשילר	chyler
יאג'ימא	yajima
יאגוצ'י	yaguchi
יאגור	yagur
יאגי	yaghi
יאד	yade
יאהאב	yahav
יאהיל	yahel
יאו	yao
יאונדי	yaounde
יאוקון	yaokun
יאכור	yakhour
יאמאגוצ'י	yamaguchi
יאמאגישי	yamagishi
יאמאדאייב	yamadayev
יאמאוקא	yamaoka
יאמאמוטו	yamamoto
יאמאשיטא	yamashita
יאמבא	yamba
יאמוסוקרו	yamoussoukro
יאנא	jana
יאנאגיסאוא	yanagisawa
יאנג	yang
יאנדל	jandl
יאנו	yano
יאנוביטש	janovic
יאנוש	janos
יאניק	yannick
יאנסינס	janssens
יאנקו	janko
יאנקולובסקי	jankulovski
יאסו	yasuo
יאסוהיטו	yasuhito
יאסוהירו	yasuhiro
יאסויוקי	yasuyuki
יאסונארי	yasunari
יאסמוטו	yasumoto
יאסמילא	jasmila
יאסמין	yasmin
יאסנורי	yasunori
יאסף	yacef
יאספרז	jaspers
יאפא	yafa
יאפינג	yaping
יאקובו	yakubu
יאקובליב	yakovlev
יאקוט	yaqut
יאקוטסק	yakutsk
יאקושימא	yakushima
יאקושין	yakushin
יאקין	yakin
יאר	yar
יארדלי	yardley
יארומיר	jaromir
יארוסלאב	jaroslav
יארוסלו	jaroslaw
יארטסיב	yartsev
יארי	yari
יארנו	jarno
יאשין	yashin
יבגני	yevgeny
יבון	yvon
יבריוז'יקין	yevriuzhikin
ידיד	yedid
ידין	yadin
יהוד	yehud
יהודא	yehuda
יהלום	yahalom
יואן	yoann
יובא	yuba
יובו	yobo
יוג'י	yuji
יוג'ין	eugene
יוגא	youga
יוגוסלאביא	yugoslavia
יוגיין	ugyen
יוגלינא	euglena
יוהאן	johan
יוהאנס	johannes
יוהאנסון	johansson
יוהנא	johanna
יוזו	yuzo
יוטאקא	yutaka
יוטה	utah
יוטירפי	euterpe
יוי	yui
יול	yul
יולאנד	yolande
יוליא	yulia
יוליאנטו	yulianto
יוליהראטש	ulihrach
יוליו	julio
יום	yom
יומיקו	yumiko
יון	yun
יונאי	yonai
יונאיטד	united
יונאן	yunnan
יונג	young
יונגבלויד	jongbloed
יונגהאנז	junghans
יונוס	yunus
יוניליבר	unilever
יוניסקו	unesco
יוניקס	unix
יונס	younis
יונתן	yonatan
יוסא	yosa
יוסו	juuso
יוסוף	yousuf
יוסוקה	yosuke
יוסטאס	ustase
יוסטינוב	ustinov
יוסי	yossi
יוסף	yousef
יוסרא	youssra
יופ	jupp
יוקארי	yukari
יוקו	yoko
יוקוהאמא	yokohama
יוקון	yukon
יוקיא	yukiya
יוקיו	yukio
יוקיצ'י	yukichi
יוקיקו	yukiko
יוקליד	euclid
יורגנסן	jorgensen
יורדאניסקו	iordanescu
יורדי	jordi
יורופא	europa
יורי	youri
יוריאקו	yuryaku
יוריטומו	yoritomo
יוריס	joris
יוריפידיז	euripides
יוריקא	jurica
יורן	jorn
יורק	yorke
יורקמיק	jurkemik
יורקשיר	yorkshire
יושיהירו	yoshihiro
יושיטו	yoshito
יושימוטו	yoshimoto
יושינאקא	yoshinaka
יושינו	yoshino
יושירו	yoshiro
יושקא	joschka
יזיד	yazid
יזיק	jezek
יחיא	yahya
ייאגר	yeager
ייב	dave
ייבוא	yeboah
ייבון	yvonne
יירזי	jerzy
ילוסטון	yellowstone
ילטסין	yeltsin
ילינא	yelena
יליניק	jelinek
ילצ'ין	yelchin
ימאני	yamani
ימין	yemin
ינאי	yanai
ינס	jens
יספר	jesper
יעקב	yakov
יעקוב	yacoub
יפראח	yfrah
יצהר	yitzhar
יקאטרינברג	yekaterinburg
יקסיל	yksel
ירון	yaron
ירושלמי	yerushalmi
יריבאן	yerevan
ירקוביטש	jerkovic
ירקוני	yarkoni
ישארי	jashari
ישעיהו	yeshayahu
יתום	yatom
כאיאשי	khayachi
כהן	cohen
כהנא	kahana
כיסופים	kissufim
כנען	kanaan
כפר	kfar
כרמי	karmi
לא	la
לאבא	lava
לאבאקי	labaki
לאבואזייה	lavoisier
לאבון	labone
לאבי	lavie
לאביל	laville
לאבין	lavigne
לאבר	laver
לאברוב	lavrov
לאגוס	lagos
לאגרקביסט	lagerkvist
לאד	ladd
לאדא	lada
לאדברוק	ladbroke
לאדוביסקי	ladovsky
לאדיסלאב	ladislav
לאהור	lahore
לאודרופ	laudrup
לאומי	leumi
לאורו	lauro
לאורי	lowry
לאורידסן	lauridsen
לאורסן	laursen
לאזארו	lazaro
לאזארוני	lazaroni
לאזארוס	lazaros
לאזיו	lazio
לאטביא	latvia
לאטו	lato
לאטונג'י	latoundji
לאטוף	latuff
לאטימר	latimer
לאטינא	latina
לאי	lai
לאיבלי	lively
לאיבנץ	leibniz
לאיוטא	liotta
לאיונינג	liaoning
לאיונל	lionel
לאינוס	linus
לאם	lahm
לאמא	lama
לאמאין	lamine
לאמארטין	lamartine
לאמארי	lamari
לאמבורגיני	lamborghini
לאמבורד	lambourde
לאמבירט	lambert
לאמבריכטס	lambrichts
לאמו	lamu
לאמונט	lamont
לאמי	lamy
לאמיא	lamia
לאמנס	lammens
לאמפארד	lampard
לאמפורוס	lampros
לאמפורט	lamport
לאנא	lana
לאנאנרק	lanark
לאנגטון	langton
לאנגר	langer
לאנדאו	landau
לאנדרו	landreau
לאנדרי	landry
לאנטוס	lantos
לאני	lunney
לאניזי	lanese
לאנס	lance
לאנסאנא	lansana
לאנסינג	lansing
לאנסלוט	lancelot
לאנקסטר	lancaster
לאנקשיר	lancashire
לאסאל	lassalle
לאסזלו	laszlo
לאסט	last
לאסילס	lascelles
לאסינא	lassina
לאסלאנד	laslandes
לאסקר	lasker
לאפוינטי	lafuente
לאפטהאוס	lofthouse
לאפטר	laughter
לאפיטרא	lapetra
לאפלאס	laplace
לאץ	lutz
לאקארן	lacarne
לאקויסטא	lacuesta
לאקומב	lacombe
לאקור	lacour
לאקי	lucky
לאקיס	lakis
לאקסנס	laxness
לאקשמי	lakshmi
לארא	lara
לארטר	larter
לארי	larry
לאריא	laryea
לאריג'אני	larijani
לאריונדא	larrionda
לארנקא	larnaca
לארסון	larsson
לארסן	larsen
לארשה	larcher
לאשלי	lashley
לאתאן	lathan
לב	lev
לבאנאן	lebanon
לבוב	lvov
לביא	lavi
לבייב	leviev
לבינג'ר	levinger
לבלאנק	leblanc
לבן	lavan
לג'נד	legend
לגונה	laguna
לוא	loa
לואיז	louise
לואל	lowell
לואנדא	luanda
לואק	loic
לוב	love
לובומיר	ľubomir
לובונט	lobont
לובוס	ľubos
לוביטש	lubitsch
לוביל	lovell
לובין	leuven
לובלייס	lovelace
לובלין	lublin
לובריטש	lovric
לוגאנו	lugano
לוגופיט	logofet
לוגי	logie
לודביג	ludwig
לודביק	ludvik
לודו	ludo
לודוביק	ludovic
לודוביקו	ludovico
לודזא	ludza
לודמילא	lyudmila
לוהאנסק	luhansk
לוהר	lohr
לווינסון	levinson
לוזאטו	luzzatto
לוזאן	lausanne
לוט	lotte
לוטא	lota
לוטון	lawton
לוטפי	lutfi
לוטשר	loetscher
לוי	levy
לויג'י	luigi
לויד	lloyd
לויז	luiz
לויזיאנא	louisiana
לויינדולא	luyindula
לוין	levine
לוינסקי	lewinsky
לויס	luis
לויסאו	luisao
לויצקי	levitsky
לוך	loch
לולא	lola
לולי	lule
לוליא	lulea
לוליטא	lolita
לומביני	lumbini
לומברוסו	lombroso
לונדין	lundin
לונדן	london
לוסאקא	lusaka
לוסי	lucy
לוסיא	lucia
לוסיאן	lucien
לוסיאנו	luciano
לוסיוס	lucius
לוסיל	lucille
לוסיליו	lucilio
לוסימי	lossemy
לוסינהוף	lussenhoff
לופאטילי	lupatelli
לופוליאנסקי	lupolianski
לופז	lopez
לופיסקו	lupescu
לופר	lauper
לוק	luke
לוקא	luka
לוקארילי	lucarelli
לוקארנו	locarno
לוקאשינקו	lukashenko
לוקהיד	lockheed
לוקו	loko
לוקויל	lukoil
לוקזאק	luczak
לוקין	luccin
לוקליר	locklear
לוקס	luyckx
לוקסמבורג	luxemburg
לורדאן	lordan
לורדי	lordi
לורז	lurz
לורי	lori
לורימר	lorimer
לורין	loren
לורינזו	lorenzo
לורינט	laurent
לורן	lauren
לורנא	lorna
לורנס	laurens
לורקא	lorca
לושאן	lushan
לותאר	lothar
לותייר	lothair
לותר	luther
לזיון	lezion
לחאם	lahham
לחזאמי	lahzami
לטרייר	leterrier
לי	lee
ליא	lea
ליאם	liam
ליאן	liane
ליאנדרו	leandro
ליאקוב	liakhov
ליבאנדובסקי	lewandowski
ליבאר	libar
ליבאתינוס	livathinos
ליבורנו	livorno
ליבי	libby
ליביד	lebed
ליביו	liviu
ליבינגסטון	livingstone
ליבסקינד	libeskind
ליבצ'נקו	levchenko
ליבר	libre
ליברון	lebron
ליברט	lebert
ליברמאן	liebermann
ליגבינסקי	legwinski
ליגוריא	liguria
לידהולם	liedholm
לידוקאין	lidocaine
לידיא	lydia
לידיס	lidice
לידיסמא	ledesma
לידלי	ledley
לידרברג	lederberg
ליהמאן	lehmann
ליואי	levi
ליובינקו	ljubinko
ליוביסא	ljubisa
ליוביסיטש	ljubicic
ליובליאנא	ljubljana
ליוויו	livio
ליוויראני	liverani
ליון	leone
ליונארדו	leonardo
ליונה	lyonnais
ליונהארד	leonhard
ליונור	leonor
ליונידס	leonidas
ליונל	leonel
ליופארדי	leopardi
ליופולד	leopold
ליז	liz
ליזא	liza
ליזאראזו	lizarazu
ליטא	lita
ליטבארסקי	littbarski
ליטבינוב	litvinov
ליטבינינקו	litvinenko
ליטו	leto
ליי	lei
לייגל	laigle
ליידי	lady
לייטון	layton
לייליי	leilei
ליין	layne
ליכוד	likud
ליכטסטיינר	lichtsteiner
ליליאן	lilian
לילינטאל	lilienthal
לימאן	liman
לימאסול	limassol
לימוטשיא	lemmouchia
לימור	limor
לין	lynn
לינאריס	linares
לינבוי	linvoy
לינג	ling
לינד	lindh
לינדא	linda
לינדבאי	lendvai
לינדי	lynndie
לינדל	lendl
לינדלוף	lindelof
לינדסיי	lindsay
לינדרות	linderoth
לינה	lena
לינוקס	linux
לינז	linz
ליני	linney
לינינגראד	leningrad
ליניקר	lineker
לינסטרא	lenstra
לינץ'	lynch
ליסאנדרו	lisandro
ליסט	list
ליסיג	lessig
ליסינג	lessing
ליסיצקי	lissitzky
ליסלי	leslie
ליסנר	lesnar
ליסקוט	lescott
ליף	leif
ליפאין	lepine
ליפומא	lipoma
ליפטין	leptin
ליפיליר	lepiller
ליפמאן	lipmann
ליפסטדאט	lipstadt
ליפשיץ	lipchitz
ליצמאן	litzman
ליקא	licka
ליקו	leko
ליקונא	lecuona
ליקנז	leekens
ליר	lear
לירד	laird
לירו	leroux
לירונד	lerond
לירטיוס	laertius
ליתואיניה	lithuania
לך	lech
לם	lem
למאסון	lemasson
למיאגרי	lamyaghri
לן	len
לנב	lenev
לנגה	lengeh
לנגלן	lenglen
לנון	lennon
לני	lenny
לס	les
לסניאק	lesniak
לערוי	laroui
לפיד	lapid
לרבי	lerby
לרדורף	lerdorf
לרמנטוב	lermontov
מאברוס	mavros
מאג'וריל	majorelle
מאג'יסטר	magister
מאג'יק	magic
מאגאלהאיז	magalhaes
מאגאת	magath
מאגדיבורג	magdeburg
מאגואיר	maguire
מאגומידוב	magomedov
מאגי	maggie
מאגלאן	magellan
מאגנו	magno
מאגנוס	magnus
מאגנין	magnin
מאגרב	maghreb
מאדאלינא	maddalena
מאדהיא	madhya
מאדונא	madonna
מאדונו	madono
מאדיסן	madison
מאדירא	madeira
מאדירנו	maderno
מאדלונג	madelung
מאדלין	madeleine
מאדסן	madsen
מאדרוצו	madruzzo
מאהאליא	mahalia
מאהאראשטרא	maharashtra
מאהיאדי	mahyadi
מאהלר	mahler
מאהר	maher
מאהש	mahesh
מאו	mao
מאוס	mauss
מאורו	mauro
מאזארין	mazarin
מאזאריק	masaryk
מאזוז	mazuz
מאזוט	mazut
מאזויקי	mazowiecki
מאזינהו	mazinho
מאזיק	maziq
מאט	matt
מאטאדי	matadi
מאטאו	matteo
מאטאוס	matthaus
מאטביינקו	matviyenko
מאטובינוביטש	matovinovic
מאטוס	matus
מאטיאס	matthias
מאטיו	mathieu
מאטיובסקי	matejovsky
מאטיוט	mateut
מאטילדא	matilda
מאטילדי	matilde
מאטיס	matisse
מאטלין	matlin
מאטס	mats
מאטסוזאוא	matsuzawa
מאטסומוטו	matsumoto
מאטסוקא	matsuoka
מאטסוקאטא	matsukata
מאטסושיטא	matsushita
מאטסקאזי	matsukaze
מאטראי	matrai
מאטרלינק	maeterlinck
מאיא	maaya
מאיאקובסקי	mayakovsky
מאיגא	maiga
מאידא	maeda
מאיול	maillol
מאיומי	mayumi
מאיורקא	majorca
מאילארט	maillart
מאילו	milo
מאילז	miles
מאילי	miley
מאימון	maimon
מאיסטרוביטש	majstorovic
מאיספייס	myspace
מאיק	mike
מאיקי	mikey
מאיקל	michael
מאיקלאנג'ילו	michelangelo
מאיקלז	michaels
מאיקרוסופט	microsoft
מאירא	myra
מאלאגא	malaga
מאלאטיסטא	malatesta
מאלאקוטי	malakouti
מאלבראנק	malbranque
מאלדאיבז	maldives
מאלדונאדו	maldonado
מאלדיני	maldini
מאלדירא	maldera
מאלו	malot
מאלודא	malouda
מאלון	malone
מאלטא	malta
מאלטיז	maltese
מאלי	mali
מאליא	mallya
מאליבאי	malivai
מאליביטש	malevich
מאלייז'א	malaysia
מאלין	malin
מאליסה	malisse
מאלמו	malmo
מאלק	malek
מאלקו	malko
מאלקולם	malcolm
מאלקין	malkin
מאמאדו	mamadou
מאמאדי	mamady
מאמו	mamo
מאמורו	mamoru
מאמט	mamet
מאמי	mami
מאמידאלי	mammedaly
מאמיקו	mamiko
מאנאגוא	managua
מאנגה	manga
מאנגנאל	mangnall
מאנדא	manda
מאנדאלא	mandala
מאנדאנדא	mandanda
מאנדולא	mandola
מאנדי	mandy
מאנדל	mundell
מאנה	manet
מאנהאטן	manhattan
מאנהאים	mannheim
מאנו	manu
מאנואלא	manuela
מאנויל	manuel
מאנוליטי	manolete
מאנזוני	manzoni
מאנטל	mantell
מאניטובא	manitoba
מאניירו	maneiro
מאנין	mannin
מאנינג	manning
מאניפיקאט	magnificat
מאנמוהאן	manmohan
מאנסארי	mansare
מאנסון	manson
מאנספילד	mansfield
מאנפרד	manfred
מאנפרידוניא	manfredonia
מאנשיני	mancini
מאסא	massa
מאסאהירו	masahiro
מאסאוע	massawa
מאסאיא	masaya
מאסאיושי	masayoshi
מאסאמאסו	massamasso
מאסאמי	masami
מאסאצ'ו	masaccio
מאסאקאזו	masakazu
מאסאקו	masako
מאסאקי	masaaki
מאסארו	masaru
מאסאשי	masashi
מאסודא	masuda
מאסטריכט	maastricht
מאסי	massi
מאסיאס	macias
מאסיג'	maciej
מאסיו	maceio
מאסילילא	masilela
מאסימו	massimo
מאסינגא	masinga
מאסלאצ'נקו	maslachenko
מאסלו	maslow
מאסליונקן	maslyonkin
מאסני	masny
מאסקאוא	maskawa
מאסקיראנו	mascherano
מאצ'אלא	macala
מאצולא	mazzola
מאק	mack
מאקאו	macau
מאקאסא	makasa
מאקאסאר	makassar
מאקאפא	macapa
מאקארתר	macarthur
מאקבראיד	macbride
מאקגינס	mcguinness
מאקגראו	mcgraw
מאקדאול	macdowell
מאקדונאלד	macdonald
מאקדירמיד	macdiarmid
מאקובי	maccoby
מאקוטו	makoto
מאקון	makoun
מאקונאהי	mcconaughey
מאקונין	makonnen
מאקורמיק	mccormick
מאקי	maki
מאקיללי	makelele
מאקינוא	makinwa
מאקינון	mackinnon
מאקלארין	mclaren
מאקליין	maclaine
מאקמאנאמאן	mcmanaman
מאקמילאן	mcmillan
מאקנאב	mcnab
מאקס	max
מאקסויל	maxwell
מאקסי	maxi
מאקסים	maksim
מאקסימיליאן	maximilian
מאקסמליאן	maximilien
מאקספילד	maxfield
מאקפאדין	macfadyen
מאקקוין	mcqueen
מאקקינא	mckenna
מאר	mahr
מאראנהאו	maranhao
מאראתון	marathon
מארבורי	marbury
מארגרט	margarete
מארגריט	margaret
מארגריטא	margherita
מארדי	mardy
מארוא	marois
מארוין	marvin
מארולאנדא	marulanda
מארון	maroun
מארוק	maroc
מארזל	marzel
מארטא	marta
מארטוב	martov
מארטי	marti
מארטילי	martelli
מארטין	martien
מארטינא	martina
מארטינז	martins
מארטינילי	martinelli
מארטצ'לו	marcelo
מארי	marie
מאריא	maria
מאריאן	marianne
מאריאנא	mariana
מאריאנו	mariano
מאריאס	marias
מאריו	mario
מאריוט	mariot
מאריון	marion
מאריוס	mariusz
מאריופול	mariupol
מארילאנד	maryland
מארילין	marilyn
מארין	marin
מארינא	marina
מארינו	marino
מאריניטי	marinetti
מארינר	mariner
מאריס	maris
מאריסא	marisa
מאריקא	marica
מארלון	marlon
מארלי	marley
מארמאריס	marmaris
מארסדן	marsden
מארסיא	marcia
מארסיאנו	marciano
מארסיל	marcell
מארסל	marcel
מארצ'ינא	marchena
מארצ'לו	marcello
מארק	mark
מארקו	marko
מארקוב	markov
מארקומאני	marcomanni
מארקוני	marconi
מארקיאן	marcian
מארקיז	marquez
מארקיטא	marketa
מארקיטו	marchetto
מארקיס	marques
מארקס	marks
מארשאל	marshall
מארתא	martha
מאשיגו	mashego
מאשין	machine
מאתיו	matthew
מאתיסן	mathijsen
מבאבאן	mbabane
מבאמבא	mbamba
מבו	mbo
מבויאן	mbuyane
מבומא	mboma
מביא	mbia
מבידא	mbida
מברוק	mabrouk
מג'אלבי	mjallby
מג'ד	majed
מג'די	majdi
מג'וס	majus
מג'לי	majalli
מגא	mega
מגדי	magdi
מגוג	magog
מגיד	magid
מגן	magen
מגני	meghni
מדאם	madame
מדוור	medawar
מדלידלי	mdledle
מדני	madani
מדריד	madrid
מדרסה	madrasah
מהאבהאראטא	mahabharata
מהדאוויקיא	mahdavikia
מהדי	mahdi
מהלונגו	mhlongo
מהראן	mehran
מהרדאד	mehrdad
מהרי	mehri
מואז'ן	maozhen
מואי	mwai
מואנזא	mwanza
מוארווארי	mwaruwari
מובארק	mubarek
מובוטו	mobutu
מובי	moby
מוביוס	mobius
מובעלי	mobali
מוג'יטש	mujic
מוגאבי	mugabe
מוגיהיטו	mugihito
מוגרבי	mughrabi
מוד	maud
מודאר	mudar
מודג'י	moggi
מודו	modou
מודי	modi
מודיליאני	modigliani
מודינגאי	mudingayi
מודיסטי	modeste
מודיסי	modise
מודר	moder
מודריטש	modric
מודריק	mudrik
מוהאג'ראני	mohajerani
מוהרן	muhren
מוזאמביק	mozambique
מוזיניטש	muzinic
מוזלי	moseley
מוחארם	muharram
מוחטאר	mokhtar
מוחייסן	mohaisen
מוחסן	mohsen
מוטאל	mutal
מוטאקי	mottaki
מוטארילי	mutarelli
מוטו	mutu
מוטויאמא	motoyama
מוטי	motti
מוטיו	mutiu
מוטינהו	moutinho
מוטעב	moteab
מוטראם	mottram
מוטראן	motran
מויא	moya
מויזאן	moizan
מויני	mweene
מויניט	mouynet
מויסיו	moisiu
מויר	muir
מולאן	mulan
מולבי	molby
מולדובא	moldova
מולדובאן	moldovan
מולוד	mouloud
מולטאטולי	multatuli
מולטקה	moltke
מוליגאן	mulligan
מולימאן	mollemann
מולינא	molina
מוליס	mullis
מולנאר	molnar
מולר	muller
מומבאי	mumbai
מומבאסא	mombasa
מומוני	moumouni
מומטאז	mumtaz
מומנז	mommens
מומסילו	momcilo
מומסן	mommsen
מונא	mona
מונאגאן	monaghan
מונאקו	monaco
מונארון	munaron
מונג	monge
מונגי	mongi
מונד	monde
מונדריאן	mondrian
מונונוק	mononoke
מונזינגר	munzinger
מונטאלי	montale
מונטאנא	montana
מונטגומרי	montgomery
מונטי	monty
מונטיאן	muntyan
מונטיבידיו	montevideo
מונטיבירדי	monteverdi
מונטיז	montez
מונטינו	munteanu
מונטיניגרו	montenegro
מונטירו	monteiro
מונטירוסו	monterroso
מונטיריי	monterrey
מונטמארטר	montmartre
מוניב	moeneeb
מוניו	moneo
מוניז	moniz
מוניר	mounier
מונסטר	munster
מונסף	monsef
מונפארנאס	montparnasse
מונפילייה	montpellier
מונפיס	monfils
מונרו	munro
מונרוביא	monrovia
מונתסר	muntasser
מוס	moss
מוסאדק	mosaddeq
מוסאמפא	musampa
מוסאעד	musaed
מוסו	musso
מוסוליני	mussolini
מוסטאקי	moustaki
מוסטגאנמי	mosteghanemi
מוסטובוי	mostovoi
מוסטפא	mustafa
מוסימיטש	musemic
מוסיסילי	mosisili
מוסלים	muslim
מוסלין	muslin
מוסלם	moslem
מוסקאט	muscat
מוסקוסו	moscoso
מועאת	mouath
מועואד	moawad
מועין	muin
מועמר	muammar
מוצ'יזוקי	mochizuki
מוקדאד	mokdad
מוקוינא	mokoena
מוקטיזומא	moctezuma
מוקייזי	mukasey
מור	moore
מורא	maura
מוראביא	moravia
מוראבצ'יק	moravcik
מוראט	murat
מוראטי	moratti
מוראיאמא	murayama
מוראליס	morales
מוראן	moran
מוראנדי	morandi
מוראנו	murano
מוראקאמי	murakami
מורארו	moraru
מורג'יין	morjane
מורגן	morgan
מורגנסטירן	morgenstern
מורגנר	morgner
מורדוק	murdoch
מורדור	mordor
מורדכי	mordechai
מורו	moro
מורוזוב	morozov
מורוי	mauroy
מורטאלא	murtala
מורטן	morton
מורי	mori
מוריאל	muriel
מוריאק	mauriac
מוריהיי	morihei
מוריהירו	morihiro
מוריזיו	maurizio
מוריטא	morita
מוריטי	moretti
מוריטייניא	mauritania
מוריל	morell
מורין	morin
מורינהו	mourinho
מורינו	moreno
מוריני	morini
מוריסון	morrison
מוריסיט	morissette
מוריסמו	mauresmo
מוריקאוא	morikawa
מוריקוני	morricone
מורירי	moriri
מורישימא	morishima
מורל	morrell
מורלי	morley
מורן	muren
מורס	morse
מורפי	morphy
מורקוט	murcutt
מורר	maurer
מושארף	musharraf
מושב	moshav
מושיו	moshoeu
מזהר	mazhar
מזלום	mazloum
מחל	mahal
מחמד	mehmed
מחמדו	mahamadou
מחמוד	mahmud
מחמודי	mahmudi
מחמט	mehmet
מחפוד	mahfoud
מחפוז	mahfouz
מחרוס	mahrous
מחתופי	mahdoufi
מט	mt
מטאוע	mattawa
מטר	matar
מטרופוליטאנא	metropolitana
מי	mee
מיא	mia
מיאזאוא	miyazawa
מיאזאקי	miyazaki
מיאטא	miyata
מיאנו	miyano
מיאנמאר	myanmar
מיאצא	meazza
מיאקי	miyake
מיבו	mevo
מיג	meg
מיגאבאיט	megabyte
מיגאלודון	megalodon
מיגוילי	migueli
מיגל	miguel
מיגליורי	migliore
מיגלית	megalith
מיגרון	migron
מידאן	medan
מידאני	meidani
מידבידיב	medvedev
מידורי	midori
מידוריקאוא	midorikawa
מידזוגורנו	mezzogiorno
מידילין	medellin
מידלר	midler
מידנדורף	middendorf
מיהאי	mihai
מיהאיל	mihail
מיהאילוביטש	mihajlovic
מיהאלי	mihaly
מיהובי	mihoubi
מיו	miyu
מיוג'ן	myojin
מיודראג	miodrag
מיוניך	munich
מיוקי	miyuki
מיורא	miura
מיזונו	mizuno
מיזוקי	mizuki
מיזוראם	mizoram
מיזורי	missouri
מיזושימא	mizushima
מיזי	mezey
מיטאני	mitanni
מיטגוד	metgod
מיטומו	mettomo
מיטוראי	mitoraj
מיטיטש	mitic
מיטילין	mytilene
מיטן	metin
מיטניק	mitnick
מיטסו	mitsuo
מיטסואקי	mitsuaki
מיטסומאסא	mitsumasa
מיטסומוני	mitsumune
מיטסקי	mitsuki
מיטריבילי	metreveli
מיטש	mitch
מיטשירו	michiru
מיטשל	mitchel
מיי	mey
מייבאך	maybach
מייג'י	meiji
מייגו'ר	major
מיילט	maillet
מיין	mein
מיינוב	minobe
מיינז	mainz
מייניו	meynieu
מיכאיל	mikheil
מיכאליטשינקו	mykhaylychenko
מיכאליק	michalik
מיכיל	micheľ
מיל	mil
מילא	milla
מילאד	milad
מילאדינוביטש	miladinovic
מילאן	milan
מילאנו	milano
מילאני	melanie
מילאניזיא	melanesia
מילארד	millard
מילבא	milva
מילבורן	milburn
מילביל	melville
מילג'ונא	miljoona
מילדריד	mildred
מילו	melo
מילוד	miloud
מילוטין	milutin
מילורא	melora
מילוראד	milorad
מילוש	milosz
מילט	milt
מילטון	milton
מילי	mili
מיליאן	miljan
מיליבאנד	miliband
מיליגאן	milligan
מיליטו	milito
מיליטון	meliton
מיליס	meles
מיליצ'יפ	millichip
מילנקו	milenko
מילנר	milner
מילסום	milsom
מילפומיני	melpomene
מילפורד	milford
מילקא	milka
מילר	meller
מימונה	mimouna
מימוני	mimouni
מימירנג	memering
מין	minh
מינא	mina
מינאואנד	minavand
מינאמבריס	minambres
מינאמוטו	minamoto
מינאמי	minami
מינאסה	menasse
מינג	ming
מינגי	mingyi
מינגיו	mingyu
מינדיז	mendez
מינדיס	mendes
מינו	meeno
מינונגו	minoungou
מינור	minor
מינורו	minoru
מינורקא	minorca
מינטאל	mental
מינטוף	mintoff
מינינדיז	menendez
מיניסוטא	minnesota
מיניקס	minix
מינסאה	mensah
מינסק	minsk
מינץ	mintz
מינרבא	minerva
מיסאוי	missaoui
מיסוט	mesut
מיסטר	mr.
מיסטראל	mistral
מיסיסוגא	mississauga
מיסיסיפי	mississippi
מיסכי	meskhi
מיסן	meissen
מיסקיטו	miskito
מיסקינא	myskina
מיצ'יאר	meciar
מיצ'יהירו	michihiro
מיק	mick
מיקא	mika
מיקאטי	mikati
מיקאיל	mikael
מיקאל	michal
מיקאליס	michalis
מיקה	micah
מיקו	micoud
מיקויאן	mikoyan
מיקולאיב	mykolaiv
מיקולאס	mikulas
מיקונוס	mykonos
מיקי	micky
מיקיו	mikio
מיקיס	mikis
מיקל	mikkel
מיקלוס	miklos
מיקרומטר	micrometre
מיראלם	miralem
מיראן	miran
מיראנדא	miranda
מירבו	mirbeau
מירבין	mervyn
מירדאל	myrdal
מירוסלאב	miroslav
מירטון	merton
מירטסאקר	mertesacker
מירי	miri
מיריאם	myriam
מירידא	merida
מיריו	meyrieu
מיריל	meryl
מירילס	meireles
מיריק	mirek
מירל	mirel
מירני	mirnyi
מירסאד	mirsad
מירסאדקי	mirsadeghi
מירסיא	mircea
מירסין	mersenne
מירפי	murphy
מירקאטור	mercator
מירקו	mirko
מירקוסור	mercosur
מירקורי	mercury
מירקיור	mercure
מירקל	merkel
מישא	mischa
מישיגאן	michigan
מישימא	mishima
מישל	michel
מישליט	michelet
מיתיין	methane
מכאללה	mkhalele
מכבי	maccabi
מל	mel
מלאדיאן	mlađan
מלאדיטש	mladic
מלאדיניטש	mladinic
מלאל	malal
מלביל	melvil
מלבירג	mellberg
מלווין	melvin
מלולי	mellouli
מלחו	melho
מלחם	melhem
מליסיא	melissa
מלכיאל	malchiel
מלמד	melamed
מלקיור	melchior
ממדוח	mamdouh
ממפיס	memphis
מן	mann
מנאג'ד	mnajed
מנאמה	manama
מנאף	manaf
מנארי	mnari
מנגומיני	mngomeni
מנדוזא	mendoza
מנדונקא	mendonca
מנדי	mendy
מנדיז	mndez
מנדיריס	menderes
מנדלייב	mendeleev
מנדלסון	mendelsohn
מנחם	menachem
מניקילי	menichelli
מנסור	mansour
מנסורי	mansouri
מנעם	menem
מנק	munk
מנשביק	menshevik
מנשה	menashe
מסא	mesa
מסאלי	messali
מסטיסלאב	mstislav
מסי	messi
מסייה	messier
מסינא	messina
מסכאדוב	maskhadov
מסעד	massad
מסרוב	mesrob
מעדנצ'י	madanchi
מעלום	malloum
מעלוף	maalouf
מעמרי	mammeri
מעריב	maariv
מפאי	mapai
מפומאלאנגא	mpumalanga
מפילא	mphela
מצגר	metzger
מצה	matza
מצודת	metzudat
מצלדר	metzelder
מצפה	mitzpe
מקאוי	mekawy
מקאי	makaay
מקאיל	mickael
מקאלאני	mccallany
מקאן	mccann
מקארטני	mccartney
מקאריוס	makarios
מקארתי	mccarthy
מקביל	mcbeal
מקגריגור	mcgregor
מקגריידי	mcgrady
מקדאניאל	mcdaniel
מקדוניל	mcdonnell
מקדורמאנד	mcdormand
מקדיסי	makdisi
מקדירמוט	mcdermott
מקויסט	mccoist
מקורות	mekorot
מקימסון	mckimson
מקלובה	maqluba
מקלין	mclean
מקליר	mcclair
מקמאהון	mcmahon
מקניל	mcneil
מקנר	mechner
מקסטיי	mcstay
מקסים	maxim
מקסימוס	maximus
מקסיקו	mexico
מקפאדין	mcfadden
מקראקין	mccracken
מקרם	makram
מר	mer
מראקשי	marrakchi
מרדוק	murdock
מרה	mara
מרווחין	marwahin
מרזוק	marzouk
מרי	mary
מריאם	merieme
מרים	meriem
מרכז	merkaz
מרסידס	mercedes
משה	moshe
משהד	mashhad
משהור	mashhur
משהראוי	masharawi
משולם	meshulam
משיר	meshir
משעל	mashal
משעלאני	machaalani
משרביה	mashrabiya
נאבאטאמי	nabatame
נאבאס	navas
נאבאר	navarre
נאבארו	navarro
נאבי	nabih
נאבין	naveen
נאג'י	naji
נאגאי	nagai
נאגאנו	nagano
נאגי	nagi
נאדא	nada
נאדאל	nadal
נאדיא	nadia
נאהואטל	nahuatl
נאהיאן	nahyan
נאוטאקי	naotake
נאומאן	naumann
נאוסב	nauseb
נאוקו	naoko
נאוקי	naoki
נאור	naor
נאזים	nazim
נאזיק	nazik
נאזלי	nazli
נאזם	nazem
נאט	nat
נאטאלי	natale
נאטאליא	natalia
נאטאנז	natanz
נאטאסא	natasa
נאטאפורן	nattaporn
נאטאשא	natacha
נאטו	nato
נאטסומה	natsume
נאי	nighy
נאיג'יריא	nigeria
נאיהום	naihoum
נאיט	knight
נאיטון	knighton
נאיטינגייל	nightingale
נאיטלי	knightley
נאין	nein
נאיק	naik
נאיקסט	nyquist
נאירובי	nairobi
נאכבאר	nachbar
נאלבאנדיאן	nalbandian
נאמבארין	nambaryn
נאמבו	nambu
נאמדי	nnamdi
נאמי	namie
נאמיקאוא	namikawa
נאן	nan
נאנא	nana
נאנאמי	nanami
נאנבודו	nanbudo
נאנדור	nandor
נאנטס	nantes
נאני	nani
נאנינגא	nanninga
נאנסי	nancy
נאנסן	nansen
נאסא	nasa
נאסדאק	nasdaq
נאסים	naseem
נאסיף	nasief
נאסיר	nasir
נאסראדין	nasreddin
נאפי	nafi
נאפליון	napoleon
נאפלס	naples
נאציז	nazis
נאקא	naka
נאקאהארא	nakahara
נאקאו	nakao
נאקאי	nakai
נאקאיאמא	nakayama
נאקאמאצו	nakamatsu
נאקאמורא	nakamura
נאקאסונה	nakasone
נאקשוואני	nakshawani
נארא	nara
נאראזאקי	narazaki
נארי	narey
נאריטא	narita
נארימאן	narriman
נארימן	narimene
נארמר	narmer
נאשיד	nasheed
נאשיזאוא	nishizawa
נאשף	nashef
נאתאניאל	nathaniel
נבאהט	nebahat
נביל	nabeel
נג'אח	najah
נג'יב	najib
נגיב	naguib
נגרילא	negrila
נדא	neda
נדאדאי	ndadaye
נדאו	ndao
נדב	nadav
נדביד	nedved
נדים	nadim
נדיקומאנא	ndikumana
נדיר	nadir
נדלובו	ndlovu
נהריה	nahariya
נו	nou
נואדיבו	nouadhibou
נואה	noah
נואל	nawel
נואנירי	nwaneri
נובאק	novak
נובאר	nubar
נובארטיס	novartis
נובו	neveu
נובוטנא	novotna
נובויוקי	nobuyuki
נובונאגא	nobunaga
נובוסוקה	nobusuke
נובורו	noboru
נוביטסקי	nowitzki
נוביל	neuville
נובין	novin
נובל	nouvel
נוברי	nobre
נוג'ימא	nojima
נוגלי	nogly
נוד	knud
נודיא	nodia
נודלמאן	nudelman
נוה	naveh
נוהייר	nohair
נוואס	nuwas
נוויל	neville
נוזאוא	nozawa
נוזארה	nouzaret
נוזומו	nozomu
נוזומי	nozomi
נוטו	noto
נוטינג	notting
נוטינגהאם	nottingham
נוי	noe
נוימאן	neumann
נולאסקו	nolasco
נולבירטו	nolberto
נום	gnome
נומא	numa
נומאן	numan
נומביטי	nomvethe
נומידיא	numidia
נונאבוט	nunavut
נונדא	nonda
נוני	nonie
נוניז	nunez
נוסבאום	nussbaum
נוסטרא	nostra
נוסטראדאמוס	nostradamus
נוסימבאום	nussimbaum
נוסרטי	nosrati
נוצ'ירינו	nocerino
נוקיא	nokia
נוקס	knox
נור	noor
נורגיי	norgay
נורדאל	nordahl
נורדין	nordin
נורדיסק	nordisk
נורדסטרום	nordstrom
נורהאליזה	nurhaliza
נורודום	norodom
נורוז	nowruz
נורט	norte
נורטן	norton
נורי	nori
נוריאקי	noriaki
נוריהירו	norihiro
נוריזאן	norizan
נורייגא	noriega
נורינא	noreena
נורינבירג	nurenberg
נוריקו	noriko
נורמאן	norman
נורמאנדי	normandy
נורסולטאן	nursultan
נורפולק	norfolk
נורתאם	northam
נותר	noether
נזאמי	nezami
נזאר	nazar
נזיף	nazif
נחום	nahum
נחל	nahal
נחלה	nahla
נחמן	nahman
נחנאח	nahnah
נטפים	netafim
ניאמי	niamey
ניאנג	niang
ניאנדורו	nyandoro
ניארקו	nyarko
ניאתי	nyathi
ניבאדא	nevada
ניביס	neves
ניגאם	nigam
ניגאקי	niigaki
נידאל	nidal
נידום	nedum
ניהאט	nihat
ניהודא	nehoda
ניו	new
ניוטאון	newtown
ניוטן	newton
ניומאן	newman
ניוסטד	newsted
ניוקליטא	nicolita
ניות	neot
ניז	knez
ניזאם	nizam
ניזיביטש	knezevic
ניטא	nita
ניטו	netto
ניטרא	nitra
ניי	ney
ניידין	nadine
ניידר	nader
ניילסון	naelson
ניימינין	nieminen
נייסמית	naysmith
ניירא	neira
נייתן	nathan
נייתנסון	nathanson
ניל	neill
נילאסי	nyilasi
נילו	nelo
נילטון	nilton
נילי	nili
נילס	nils
נילסן	nielsen
נימאן	neeman
נימאניא	nemanja
נימבא	nimba
נימולר	niemoller
נימיטש	nemec
נימיץ	nimitz
נימר	nimar
נינא	nina
נינאד	nenad
נינו	nino
נינומיא	ninomiya
ניני	nene
ניס	nice
ניסא	nisa
ניסאן	nisan
ניסון	neeson
ניסטלרוי	nistelrooy
ניסיפור	nicephore
ניסנית	nisanit
ניסקינז	neeskens
ניסר	nisr
ניעמאן	neaman
ניפון	nippon
ניפטון	neptune
ניפלהאים	niflheim
ניפס	niepce
ניק	nick
ניקאנור	nicanor
ניקו	niko
ניקול	nicole
ניקולא	nikola
ניקולאו	nikolaou
ניקולאוס	nikolaos
ניקולאייב	nikolaev
ניקולאס	nicholas
ניקולה	nicolet
ניקולו	nicolo
ניקולוס	nicolaus
ניקוליטש	nikolic
ניקוליי	niculae
ניקוס	nikos
ניקופולידיס	nikopolidis
ניקי	nikki
ניקיטא	nikita
ניקילבק	nickelback
ניקלאס	niklas
ניקסון	nixon
ניר	nir
נירו	nero
נירודא	neruda
נירי	nery
ניריו	nereo
נירירי	nyerere
נישימורא	nishimura
נישיקאוא	nishikawa
נישיקורי	nishikori
נלסן	nelsen
נמו	nemo
נמיירי	nimeiry
נסאר	nassar
נסטא	nesta
נסטור	nestor
נסטוריוס	nestorius
נסטרוב	nesterov
נסיב	nasib
נסים	nissim
נסיר	naseer
נסירוב	nasyrow
נסר	nasr
נסראללה	nasrallah
נסרי	nasri
נעים	naeim
נעמי	naomi
נפאע	nafa
נפטי	nafti
נפרטיטי	nefertiti
נפתלי	naphtali
נצר	netzer
נקאש	nakache
נקונאם	nekounam
נרמין	nermin
נרנסט	nernst
נתיב	nativ
נתיבות	netivot
נوניהו	netanyahu
סאבא	saba
סאבאו	sabau
סאבאט	sabat
סאבאטו	sabato
סאבאטיני	sabatini
סאבאי	szavay
סאבאן	saban
סאבו	savo
סאבור	sabur
סאביו	savio
סאביולא	saviola
סאבילייטש	saveljic
סאבין	sabin
סאביצ'ביטש	savicevic
סאברוסא	sabrosa
סאברינא	sabrina
סאגיסו	sagisu
סאדא	sada
סאדאבי	saadavi
סאדאקו	sadako
סאדאת	sadat
סאדגי	sadeghi
סאדוק	sadok
סאדיק	sadiq
סאדלר	sadler
סאדק	sadeq
סאהא	saha
סאהאשי	sahashi
סאהין	sahin
סאו	sao
סאואשירו	sawashiro
סאווא	sawa
סאוט	sawt
סאויריס	sawiris
סאומיל	saumel
סאורא	saura
סאותאנד	southend
סאותהאמפטון	southampton
סאחל	sahel
סאטו	satu
סאטורו	satoru
סאטושי	satoshi
סאטרדיי	saturday
סאי	si
סאיאקא	sayaka
סאיאקו	sayako
סאיביט	saivet
סאיגא	saiga
סאידו	saidou
סאידורניקו	sidorenko
סאיוואו	saiwaeo
סאיז	saez
סאיזמור	sizemore
סאיטו	saito
סאימון	simon
סאינאי	sinai
סאינקו	saenko
סאיף	saif
סאיפאן	saipan
סאיפי	saifi
סאיפרוס	cyprus
סאלאזאר	salazar
סאלאמאנקא	salamanca
סאלאמפסי	salampessy
סאלאנדרא	salandra
סאלאס	salas
סאלאר	salar
סאלבא	salva
סאלבאדור	salvadore
סאלבאטורי	salvatore
סאלבוטאמול	salbutamol
סאלביאטי	salviati
סאלדאנא	saldana
סאלוך	salloukh
סאלומא	salomaa
סאלומון	salomon
סאלזבורג	salzburg
סאלי	sally
סאליבן	sullivan
סאליף	salif
סאלכארד	salekhard
סאלמין	salmeen
סאלפורד	salford
סאלפיגידיס	salpigidis
סאלצמאן	salzman
סאם	sam
סאמאנתא	samantha
סאמאסי	samassi
סאמאראס	samaras
סאמבא	samba
סאמבורא	sambora
סאמואל	samuel
סאמוסא	samosa
סאמטרידיא	samtredia
סאמי	samy
סאמיטייר	samitier
סאמנר	sumner
סאמסון	samsun
סאמפי	sampi
סאמפראס	sampras
סאמר	samer
סאמרבי	summerbee
סאמרז	summers
סאנא	sanaa
סאנאדר	sanader
סאנג'ו	sanjo
סאנגויני	sangweni
סאנדובאל	sandoval
סאנדור	sandor
סאנדי	sandy
סאנדל	sundell
סאנדלר	sandler
סאנדרא	sandra
סאנדרו	sandro
סאנדרז	sanders
סאנדרי	sandri
סאנדרילי	sandrelli
סאנו	sanou
סאנוגו	sanogo
סאנטא	santa
סאנטאמאריא	santamaria
סאנטאמארינא	santamarina
סאנטאנא	santana
סאנטאנג'לו	santangelo
סאנטו	santo
סאנטומי	sanetomi
סאנטון	santon
סאנטוס	santos
סאנטורו	santoro
סאנטוריני	santorini
סאנטי	santi
סאנטיני	santini
סאני	sani
סאניא	sagna
סאניול	sagnol
סאניי	sanae
סאנלי	sanli
סאנסום	sansom
סאנקארא	sankara
סאנשו	sancho
סאנשיז	sanchez
סאסארי	sassari
סאסון	sassoon
סאסי	sassi
סאפי	safy
סאפיט	safet
סאפין	safin
סאפינה	safina
סאפראניק	safranek
סאצוקי	satsuki
סאקא	saca
סאקאגוצ'י	sakaguchi
סאקאמוטו	sakamoto
סאקאשבילי	saakashvili
סאקוראי	sakurai
סאקי	sacchi
סאקימוטו	sakimoto
סאקסאן	seksan
סאקסוני	saxony
סאקסטון	saxton
סאקר	saqr
סאקראמנטו	sacramento
סאר	sarr
סאראטוב	saratov
סאראיוט	sarayoot
סאראנדון	sarandon
סארה	sarah
סארוט	sarraute
סארוכאן	sarukhan
סארטון	sarton
סארטר	sartre
סארי	saree
סאריגי	sarriegi
סאריונאנדיא	sarrionandia
סאריטא	saretta
סארס	sars
סארסגארד	sarsgaard
סארק	sark
סארקוזי	sarkozy
סארקיס	sarkis
סב	seb
סבאח	sabbah
סבארו	sbarro
סביאטוסלאב	sviatoslav
סביטוסלאב	svetoslav
סביטלאנא	svetlana
סבירקוס	sverkos
סגא	sega
סגב	segev
סגוויי	segway
סדאם	saddam
סדיק	sedik
סדיר	sadir
סדקי	sedki
סו	so
סואגארט	swaggart
סואזילאנד	swaziland
סואן	suwan
סואריז	suarez
סובאג'	sauvage
סובארו	subaru
סובארי	suvari
סובורוב	suvorov
סוביט	subait
סוברין	suvrijn
סוג'ורנר	sojourner
סוגיטא	sugita
סודאן	sudan
סודברי	sudbury
סודוקו	sudoku
סודי	soddy
סודיום	sodium
סודרבירג	soderberg
סודרלינג	soderling
סוהארטו	suharto
סוון	sven
סוזא	souza
סוזאן	susan
סוזוקי	suzuki
סוחה	suha
סוטומאיור	sotomayor
סוטון	sutton
סוטי	sutee
סוטיריוס	sotirios
סוטיריס	sotiris
סוטנר	suttner
סויאח	souayah
סויד	sweid
סויוז	soyuz
סויטו	soweto
סוייד	suweid
סוייזי	swayze
סוייל	swaile
סוינדן	swindin
סוינטון	swinton
סוינסון	svensson
סוינקא	soyinka
סויצ'ירו	soichiro
סויצרלאנד	switzerland
סוכא	sukha
סוכו	sokho
סוכוי	sukhoi
סול	saul
סולאנא	solana
סולארי	solari
סולדאדו	soldado
סולו	solow
סולודקין	solodkin
סולומון	solomon
סולומין	solomin
סולחי	solhi
סולטאן	sultan
סוליימאן	suleyman
סוליימאנו	souleymanou
סוליימן	sulaiman
סולים	sulim
סולימאן	suliman
סולימוסי	solymosi
סולירי	soleri
סולק	salk
סולר	soler
סום	som
סומאליה	somalia
סומביילא	soumbeila
סומטר	sumter
סומטרה	sumatra
סומיל	sommeil
סומך	somekh
סומר	sumer
סומרהאלדר	somerhalder
סונג	song
סונדרגארד	sondergaard
סונו	sonu
סוני	sonny
סוניא	sonia
סוניל	sunil
סונקו	sonko
סוסאק	susak
סוסומו	susumu
סוסיטש	susic
סוסילו	susilo
סוסיקי	soseki
סוסמות	sussmuth
סוסקיטש	soskic
סוסקינד	suskind
סועאד	souad
סופוס	sophus
סופוקליז	sophocles
סופיא	sophia
סופיאן	sofyan
סוצ'ופאריק	suchoparek
סוק	souk
סוקולוב	sokolov
סוקור	sukur
סוקס	sox
סוקר	sucre
סוקראטס	socrates
סוקריסטוב	sukristov
סוקרלוס	sucralose
סור	sur
סוראיא	soraia
סורבון	sorbonne
סורבייר	suurbier
סורגוט	surgut
סורוס	soros
סורטיס	surtees
סוריאק	surjak
סורין	sorin
סורינאם	suriname
סורינסן	sorensen
סורנטינו	sorrentino
סושי	sushi
סזוק	szoke
סזינטמיהאלי	szentmihalyi
סחאב	sahab
סחנון	sahnoun
סחר	sahar
סחראוי	sahraoui
סטאבאנג'ר	stavanger
סטאבס	stubbs
סטאד	stade
סטאטן	staten
סטאילאיטס	stylites
סטאין	stein
סטאל	stahl
סטאלון	stallone
סטאלטירי	stalteri
סטאם	stam
סטאמאיל	stamile
סטאמבאכר	stambachr
סטאן	stan
סטאנדפיסט	standfest
סטאנטון	stanton
סטאניסלאב	stanislav
סטאניסלו	stanislaw
סטאנישב	stanishev
סטאנלי	stanley
סטאנמור	stanmore
סטאנסילאס	stanislas
סטאנפורד	stanford
סטאנקוביטש	stankovic
סטאנקיו	stancioiu
סטאר	starr
סטאראסי	starace
סטארבאקס	starbucks
סטארי	stari
סטאתאם	statham
סטו	stowe
סטודנט	student
סטויקוביטש	stojkovic
סטויקיטא	stoichita
סטולטנברג	stoltenberg
סטולץ	stoltz
סטונטון	staunton
סטופאר	stupar
סטופארד	stoppard
סטוקהולם	stockholm
סטוקס	stokes
סטוקר	stoker
סטור	stoor
סטורארי	storari
סטורט	sturt
סטוריג'	sturridge
סטיב	steve
סטיבי	stevie
סטיבינארד	stievenard
סטיבן	steven
סטיבנס	stevens
סטיבנסון	stevenson
סטיד	steed
סטיוארט	stewart
סטיטש	stech
סטייט	state
סטיינבק	steinbeck
סטייניץ	steinitz
סטייסי	stacy
סטייפלטון	stapleton
סטייר	steyr
סטיל	still
סטיליאן	stiliyan
סטיליוס	stelios
סטילמאטש	stelmach
סטילר	stiller
סטינדארדו	stendardo
סטיף	stif
סטיפ	stipe
סטיפאן	stjepan
סטיפאנו	stefano
סטיפאניא	stefania
סטיפטר	stifter
סטיפניי	stepney
סטיפנס	stephens
סטיפנסן	stephenson
סטיפקא	stefka
סטיקלנבירג	stekelenburg
סטירלינג	stirling
סטירן	stern
סטיاנר	steiner
סטפאנסון	stefanson
סטראבינסקי	stravinsky
סטראוס	strauss
סטראטפורד	stratford
סטראנזל	stranzl
סטראסיר	strasser
סטראק	strack
סטראקובס	starkovs
סטרו	straw
סטרונטיום	strontium
סטרוסטרופ	stroustrup
סטרוסנר	stroessner
סטריטמאטר	strittmatter
סטרייט	strait
סטרילר	streller
סטריסמאן	stresemann
סטרלסון	sturluson
סטשון	schon
סי	sie
סיאול	seoul
סיאטל	seattle
סיאמסול	syamsul
סיאנא	sienna
סיאנפויגוס	cienfuegos
סיבאסטיאנו	sebastiano
סיבוסיסו	sibusiso
סיבורי	sivori
סיביו	sibiu
סיביל	sybille
סיביליא	siviglia
סיבירו	severo
סיבירוס	severus
סיבירינו	severino
סיגולין	segolene
סיגורורדוטיר	siguroardottir
סיגפריד	siegfried
סיגריד	sigrid
סיד	cid
סידארוס	sedarous
סידהום	sidhom
סידויל	sidwell
סידונודי	sedonoude
סידורף	seedorf
סידי	sidi
סידיבי	sidibe
סידיג	siddig
סידיו	sejdiu
סידנא	sedna
סידני	sidney
סידקי	sidqi
סידריק	cedric
סיהאוונג	seehawong
סיהאנוק	sihanouk
סיונקו	sionko
סיוראן	cioran
סיזאן	cezanne
סיזאר	cesar
סיזין	sezen
סיזיפוס	sisyphus
סיזיר	cesaire
סיזר	cesare
סיטי	siti
סיטיגרופ	citigroup
סיטינג	sitting
סיטסובון	setsubun
סיטרואן	citroen
סיטשב	sychev
סייאבונגא	siyabonga
סייג'י	seiji
סייגו	seigo
סייד	syed
סיידאת	seidath
סיילם	salem
סיינט	saint
סייצ'ירו	seiichiro
סיל	seale
סילא	sela
סילאידזיטש	silajdzic
סילאסי	selassie
סילבא	silva
סילביא	sylvia
סילביו	silviu
סילביט	sylvite
סילביין	sylvain
סילביסטר	silvestre
סילבסטר	silvester
סילברסטאין	silverstein
סילברסטון	silverstone
סילדראירס	seeldrayers
סילואן	silwan
סילויי	selway
סילין	selene
סילינא	selena
סיליקון	silicone
סיליש	seles
סילסו	celso
סילסטין	celestine
סילקווד	silkwood
סילקירק	selkirk
סילר	seeler
סימא	sima
סימאו	simao
סימאן	seaman
סימאס	simas
סימאק	semak
סימבי	simbi
סימון	simone
סימונוב	simonov
סימוניטא	simonetta
סימוניטש	simunic
סימוקונדא	simukonda
סימיאן	simeon
סימיוני	simeone
סימיטש	simic
סימין	simin
סימפירופול	simferopol
סימפל	simple
סימפסון	simpson
סימפסונז	simpsons
סימשוב	semshov
סין	sinn
סינאמואנג	senamuang
סינאק	senac
סינג	singh
סינג'ורו	senjuro
סינגמאן	syngman
סיניבאלדי	sinibaldi
סיניט	sennett
סינסינאטי	cincinnati
סינקלייר	sinclair
סינתיא	cynthia
סיסגנון	sessegnon
סיסומאגא	sesumaga
סיסוקו	sissoko
סיסטו	sisto
סיסטיין	cysteine
סיסי	sese
סיסיליא	cecilia
סיסינהו	cicinho
סיסלי	sisley
סיף	seif
סיפאנדון	siphandon
סיפוס	sipos
סיפירט	seifert
סיקו	seko
סיקולאראק	sekularac
סיקורסקי	sikorsky
סיקטיבקאר	syktyvkar
סיקס	six
סירא	serra
סיראו	serao
סירביטוס	servetus
סירבר	server
סירג'	serge
סירגיי	sergei
סירגינהו	serginho
סירוטונין	serotonin
סירוס	sirous
סירז'	serzh
סירט	siirt
סירטיטש	sertic
סיריל	cyril
סיריליק	cyrillic
סירין	serine
סירינא	serena
סירינגיטי	serengeti
סירנאן	cernan
סירף	cerf
סירפראיס	surprise
סירקן	sirkin
סית	seth
סלאבא	slava
סלאבין	slaven
סלאבקו	slavko
סלאבקוב	slavkov
סלאווניא	slavonia
סלאח	salah
סלאם	salam
סלאמה	salameh
סלבאדור	salvador
סלהב	salhab
סלובאק	slovak
סלובאקיא	slovakia
סלוביניא	slovenia
סלויטר	sluiter
סלון	sloan
סלזיוס	celsius
סלטיקס	celtics
סלטן	selten
סליבו	sljivo
סלים	selim
סלימאן	sulayman
סלימאני	selemani
סלימי	sellimi
סלמא	selma
סלמאן	salman
סלפיט	salfit
סמאחה	samaha
סמאיסר	smicer
סמאש	smush
סמאשנובא	smashnova
סמבוסק	sambusac
סמוט	smoot
סמולאריק	smolarek
סמולי	smalley
סמולינסק	smolensk
סמולניקוב	smolnikov
סמיח	semih
סמיטנא	smetana
סמיטס	smits
סמיליאניטש	smiljanic
סמילינג	semmeling
סמיר	samir
סמירטין	smertin
סמרקנד	samarkand
סן	sen
סנאידר	snyder
סנדהיל	sendhil
סנה	sneh
סנוע	sanu
סנופ	snoop
סנורי	snorri
סנט	cent
סנטורק	senturk
סנטיאגו	santiago
סני	ceni
סניורה	siniora
סניר	snir
ססטו	sesto
ססטיק	sestic
סעב	saab
סעד	saad
סעדאן	saadane
סעדי	saadi
סעוד	saud
סעודי	saudi
סעיד	said
סערי	saari
ספ	sepp
ספאיק	spike
ספאיקר	spycher
ספאלאנזאני	spallanzani
ספאליטי	spalletti
ספאם	spam
ספאניק	spanic
ספאניש	spanish
ספאפא	safafa
ספאר	sfar
ספארל	sperl
ספוטניק	sputnik
ספורזא	sforza
ספיגל	spiegel
ספיד	speed
ספיטסנאז	spetsnaz
ספייסי	spacey
ספייסק	spacek
ספין	spen
ספינא	spina
ספינוזא	spinoza
ספיצר	spitzer
ספירו	spiro
ספירוס	spiros
ספירופולוס	spiropoulos
ספירז	speirs
ספירידון	spyridon
ספנסר	spencer
ספקטור	spector
ספר	sefer
ספרא	safra
ספרים	sprem
ספרינגר	springer
ספריס	seferis
ספרן	safran
סקאטמאן	scatman
סקאילז	skiles
סקאלא	scala
סקאלוני	scaloni
סקאליא	scalia
סקאלסקי	skalski
סקאנדינאביא	scandinavia
סקאסל	skacel
סקארלאטי	scarlatti
סקארליט	scarlett
סקארמיטא	skarmeta
סקארפא	scarpa
סקובלאר	skoblar
סקוט	scott
סקוטי	scotty
סקוטלאנד	scotland
סקוילאצ'י	squillaci
סקולז	scholes
סקולי	sculli
סקופיי	skopje
סקופילד	scofield
סקורזיני	skorzeny
סקורסיזי	scorsese
סקטיוי	sektioui
סקי	seki
סקיפו	scifo
סקיריט	skerritt
סקסטון	sexton
סר	sar
סראפין	serafin
סרבאנטס	cervantes
סרביא	serbia
סרג'יו	sergio
סרגון	sargon
סרגיי	serhiy
סרגסיאן	sargsyan
סרדיניא	sardinia
סרוויט	servet
סרור	srur
סרחאן	sarhan
סרטאווי	sartawi
סרי	seri
סריטי	sriti
סרינאגאר	srinagar
סרנא	srna
סרסור	sarsur
סרפנטינאיט	serpentinite
סרפסקא	srpska
סתרידא	sethrida
ע'גמי	ajami
ע'גרם	ajram
עאד	ade
עאדל	adel
עאטף	atef
עאלם	alaam
עאמי	ami
עאמל	amel
עאמר	amer
עאסי	asi
עאסם	assem
עאפיה	afia
עארף	aref
עאשור	ashour
עבאדי	ebadi
עבאן	abane
עבאס	abbass
עבאסי	abbassi
עבדאללה	abdallah
עבדאן	abadan
עבדו	abdoh
עבדוה	abduh
עבדולאי	abdoulaye
עבוד	abboud
עבידי	abedi
עבייד	ebeid
עבعד	abud
עג'ב	ajab
עגב	agab
עגילי	aghily
עגם	agam
עגנון	agnon
עדאנא	adana
עדואן	adwan
עדי	adi
עדנאן	adnan
עובדיה	ovadia
עובייד	obeid
עוג'יילי	ojeili
עודאי	oday
עוזייר	uzeyir
עוטייף	otaif
עומארי	omari
עוסייראן	osseiran
עוסמאן	osman
עוראבי	orabi
עורוה	urwah
עותמאן	uthman
עזאם	azzam
עזוז	azouz
עזיז	aziz
עזיזו	azizou
עזיזי	azizi
עזמי	azmi
עזר	ezer
עזרא	ezra
עטאר	atar
עטיה	atiyah
עטרות	atarot
עיאן	ayan
עיאש	ayyash
עידו	eido
עידי	idi
עיון	ayoun
עיסאטי	aissati
עיסאם	isam
עיסמט	ismet
עיראק	iraq
עיראקי	iraqi
עלא	alla
עלאל	allal
עלאם	allam
עלודי	alloudi
עלוי	eloui
עלוני	allouni
עלי	ali
עליא	alia
עליוי	alioui
עלייב	aliyev
עליקולוב	aliqulov
עמאד	emad
עמאן	amman
עמאר	amar
עמארו	umaru
עמו	ammo
עמוס	amos
עמור	amor
עמנואל	emanuel
עמק	emek
עמר	amr
עמרי	omri
עמרם	amram
ען	anne
ענאבטא	anabta
ענאבי	annabi
ענאן	annan
ענטר	antar
עסאף	asaf
עסקר	askar
עפלק	aflaq
עפרה	ofra
עקאד	akkad
עקבה	aqaba
עקל	akl
עקרור	akrour
ערא	ara
עראר	arar
ערביד	arbid
ערוץ	arutz
עריף	arief
עריקאט	erekat
ערפאת	arafat
ערקטינגי	aractingi
עשראוי	ashrawi
פאגאני	pagani
פאגאניני	paganini
פאד	pad
פאדי	fadi
פאדיגא	fadiga
פאדל	fadel
פאהרודן	fahrudin
פאו	phau
פאוזיני	pausini
פאולא	paola
פאולו	paolo
פאולוס	paulus
פאולי	paoli
פאולינו	paulino
פאונד	pound
פאוסטו	fausto
פאז	paz
פאזדאן	pazdan
פאזלאגיטש	fazlagic
פאזרול	fazrul
פאט	pat
פאטאגוניא	patagonia
פאטאיא	pattaya
פאטו	pato
פאטון	fatton
פאטוקא	patocka
פאטי	patti
פאטיח	fatih
פאטיל	patil
פאטימה	fatima
פאטינסון	pattinson
פאטיסון	pattison
פאטירסון	patterson
פאטמיר	fatmir
פאטפאט	fatfat
פאטריס	patrice
פאטריסיו	patricio
פאטריק	patrik
פאטרישא	patricia
פאטרסון	paterson
פאיאד	fayyad
פאיד	fayed
פאיול	fayol
פאיוס	pious
פאיז	fayez
פאיטינג	fighting
פאילו	filo
פאילוט	paillot
פאינגולד	feingold
פאיסל	faisal
פאיפס	pipes
פאיר	fire
פאירוז	fairuz
פאיתון	python
פאלא	falla
פאלאדיו	palladio
פאלאדינו	palladino
פאלאו	palau
פאלאטינייט	palatinate
פאלאניוק	palahniuk
פאלאסיו	palacio
פאלוטאי	palotai
פאלופ	palop
פאלטרמאיר	faltermeyer
פאליטא	paletta
פאלין	palin
פאלינטיל	falintil
פאליסטר	pallister
פאליקיר	palikir
פאלם	palme
פאלמא	palma
פאלמאס	palmas
פאלמינטרי	palminteri
פאלמירו	palmiro
פאלקו	falco
פאלקינמאיר	falkenmayer
פאלרמו	palermo
פאם	pam
פאמארוט	pamarot
פאמונגקאס	pamungkas
פאמיליא	familia
פאמפלונא	pamplona
פאמקי	famke
פאנא	pana
פאנאגוליאס	panagoulias
פאנאדול	panadol
פאנאנדיטיגוירי	panandetiguiri
פאנגז'ו	fangzhuo
פאנדורא	pandora
פאנוס	fanous
פאנטא	fanta
פאנטאנאל	pantanal
פאנטיליטש	pantelic
פאנטיני	fanteni
פאני	fanny
פאניאני	pagnani
פאניול	pagnol
פאנינג	fanning
פאנינקא	panenka
פאניראי	paneriai
פאנקסיקס	pancsics
פאנריט	phanrit
פאסאנסקי	pasanski
פאסארילא	passarella
פאסדאר	pasdar
פאסו	faso
פאסטאן	pastan
פאסטור	pasteur
פאסטראנא	pastrana
פאסטרנאק	pasternak
פאסי	passy
פאסקאל	pascale
פאסקו	pasco
פאסקואל	pascual
פאסקואלי	pasquale
פאסקואליטי	pasqualetti
פאפא	papa
פאפאדופולוס	papadopoulos
פאפאס	papas
פאפה	pappe
פאפוליאס	papoulias
פאפון	papon
פאפוס	paphos
פאפי	pape
פאפיטי	papetti
פאפין	papin
פאפלאגוניא	paphlagonia
פאצ'קו	pacheco
פאצאצוגלו	patsatzoglou
פאקונדו	facundo
פאקי	packie
פאקיטא	paqueta
פאקיטו	pakito
פאקיסטאן	pakistan
פאקסטן	paxton
פאר	par
פאראג	farag
פאראגואי	paraguay
פאראדאי	faraday
פאראדיסו	paradiso
פאראמו	paramo
פאראמור	paramor
פאראנא	parana
פאראסיטאמול	paracetamol
פארגיון	fargeon
פארדו	pardo
פארו	paro
פארח	farah
פארטיזאן	partizan
פאריאטי	parietti
פאריטו	pareto
פאריל	farrell
פאריס	faris
פארירא	parreira
פאריש	parrish
פארמא	parma
פארני	fahrni
פארס	fares
פארסונס	parsons
פארפاיט	parfait
פארק	park
פארקאש	farkash
פארקור	parkour
פארקינסון	parkinson
פארקס	parks
פארקר	parker
פארתינון	parthenon
פאשא	pasha
פגאסוס	pegasus
פגי	peggy
פדרו	pedro
פדריקי	federici
פדרר	federer
פהד	fahad
פהימה	fahima
פהמי	fahmy
פו	foo
פואד	fouad
פואטייה	poitier
פואנקארה	poincare
פואסון	poisson
פוארטא	puerta
פוארטו	puerto
פוג	fogh
פוג'וט	fojut
פוג'יא	foggia
פוגאטיץ	pogatetz
פוד	fode
פודגוריקא	podgorica
פודולסקי	podolski
פודיסטא	podesta
פוהאמי	fouhami
פוזנאן	poznan
פוט	pot
פוטאטו	potato
פוטאן	puttan
פוטומאק	potomac
פוטון	futon
פוטוקארי	potocari
פוטושופ	photoshop
פוטי	poti
פוטין	putin
פוטנאם	putnam
פוטסדאם	potsdam
פוטשיטינו	pochettino
פויטינגר	peutinger
פוין	fouine
פוירוט	poirot
פול	poul
פולאט	polat
פולאנסקי	polanski
פולאנצאס	poulantzas
פולארד	pollard
פולגאר	polgar
פולו	polo
פולטון	fulton
פולי	polley
פוליאנא	pollyanna
פוליהימניא	polyhymnia
פוליזי	puglisi
פוליטיקל	political
פוליין	polyene
פולין	pauline
פוליניזיא	polynesia
פולינס	polleunis
פוליצר	pulitzer
פוליקליטוס	polykleitos
פולנד	poland
פולסון	paulson
פולסן	poulsen
פולק	faulk
פולקי	fulci
פולקנר	faulkner
פולר	fuller
פום	poom
פומיהיקו	fumihiko
פומימארו	fumimaro
פומפון	pompon
פומפידו	pompidou
פומפיו	pompeu
פומפיי	pompeii
פומפיליוס	pompilius
פונדא	fonda
פונזי	ponzi
פונזיו	ponzio
פונטאנא	fontana
פונטופידאן	pontoppidan
פוניני	fognini
פונסיקא	fonseca
פונסלה	poncelet
פונקה	funke
פוסאקו	fusako
פוסטי	fuste
פוסטיגא	postiga
פוסטינו	faustino
פוסי	fossey
פוסידון	poseidon
פוסלי	fuseli
פוסן	poussin
פוסקאס	puskas
פופא	popa
פופאקיס	poupakis
פופיולאר	popular
פופיסקו	popescu
פופר	popper
פוקאהונטאס	pocahontas
פוקאטילו	pocatello
פוקו	foucault
פוקי	foeke
פוקס	fuchs
פורד	ford
פורוש	porush
פורט	fort
פורטאליזא	fortaleza
פורטאס	portas
פורטוגסי	portoghesi
פורטוין	fortuyn
פורטונו	fortuno
פורטוני	fortuny
פורטלאנד	portland
פורטר	porter
פורטרפילד	porterfield
פורטשן	fortune
פורייר	fourier
פוריסון	faurisson
פוריסט	forest
פוריצ'לי	puricelli
פורלאן	forlan
פורמוזא	formosa
פורנייר	fournier
פורסאית	forsyth
פורסטר	forster
פורסל	pourcel
פורסמאן	forssmann
פורסקאל	forsskal
פורפיראר	pourpirar
פורפיריא	porphyria
פורש	porsche
פושקין	pushkin
פזה	fazah
פטוח	fattouh
פטיס	pettis
פטיראנודון	pteranodon
פטראס	petras
פטרוס	petrus
פטרופוליס	petropolis
פטריטש	petric
פיא	peya
פיאטי	piatti
פיאטרא	piatra
פיאנו	piano
פיאניטש	pjanic
פיאנס	fiennes
פיאסקו	fiasco
פיאף	piaf
פיאר	pierre
פיגארו	figaro
פיגו	figo
פיגוי	peguy
פיגירוא	figueroa
פיגמאליון	pygmalion
פידור	fedor
פידיריקו	federico
פידל	fidel
פידלר	fiedler
פידרוס	pedros
פידריטי	pedretti
פידרסן	pedersen
פיהן	fehn
פיודור	feodor
פיוט	piot
פיוטר	piotr
פיולא	piola
פיולין	pioline
פיונא	fiona
פיונגיאנג	pyongyang
פיונטיק	piontek
פיורי	fiore
פיוריא	peoria
פיזא	pisa
פיזארו	pizarro
פיזו	fizeau
פיזשיק	piszczek
פיטאן	petain
פיטאר	petar
פיטורקא	piturca
פיטי	petty
פיטיט	petit
פיטיסטי	pitesti
פיטס	pitts
פיטר	petter
פיטרא	petra
פיטרו	petru
פיטרוניו	petronio
פיטרוסיאן	petrosian
פיטרי	petre
פיטרסון	peterson
פייג'	page
פייגלז	pagels
פייגלין	feiglin
פייגן	fagan
פייזלי	paisley
פייטון	peyton
פייטרו	pietro
פייל	paille
פיילר	feiler
פיינורד	feyenoord
פיינטון	painton
פיינציל	paintsil
פיינשטיין	feinstein
פיירו	piero
פיירינו	pierino
פיירלויג'י	pierluigi
פיית	faith
פיל	phil
פילאדלפיא	philadelphia
פילאיו	feliu
פילגוי	pilguy
פילד	field
פילדינג	fielding
פילוסי	pelosi
פילטון	pelton
פילי	pelle
פיליון	fillion
פילימון	phillimon
פיליני	fellini
פיליסיאנו	feliciano
פיליפ	philip
פיליפו	filippo
פיליפוסיס	philippoussis
פיליפי	felipe
פיליפינז	philippines
פיליפס	phillips
פילם	film
פילפס	phelps
פים	pim
פין	finn
פינאילקיטונוריא	phenylketonuria
פינאן	finnan
פינאנט	pennant
פינאר	pienaar
פינג	peng
פינגר	finger
פינדי	fendi
פינוקיו	pinocchio
פינושה	pinochet
פינטר	pinter
פיני	finney
פינידי	finidi
פינינפארינא	pininfarina
פיניקס	phoenix
פינלאנד	finland
פינקילקרוט	finkielkraut
פינשר	fincher
פיסוא	pessoa
פיסטויא	pistoia
פיסטון	fiston
פיסין	pisin
פיסינו	piceno
פיסיקילא	fisichella
פיסק	fisk
פיסקאטור	piscator
פיפא	fifa
פיפי	fifi
פיצג'ראלד	fitzgerald
פיקאדילי	piccadilly
פיקאלסטו	pykalisto
פיקאסו	picasso
פיקו	fico
פיקולי	piccoli
פיקיון	piquionne
פיקיט	pickett
פיקסוטו	peixoto
פיר	per
פיראוס	piraeus
פיראנדילו	pirandello
פיראס	firas
פירארא	ferrara
פירארי	ferrary
פירהאם	perham
פירו	pero
פירוגיה	peruggia
פירון	peron
פירוסיטש	perusic
פירוסיני	perusini
פירוץ	perutz
פירוצ'יו	ferruccio
פירוצי	peruzzi
פירוקסיקאם	piroxicam
פירי	peary
פיריז	pires
פירייה	ferrier
פיריירא	pereira
פירין	perrin
פירינו	perrineau
פירל	ferrell
פירמאני	firmani
פירמי	fermi
פירנאנדיז	fernandes
פירס	pierce
פירסון	persson
פירסי	percy
פירסיפוני	persephone
פישטנר	fichtner
פישלר	fischler
פישמאן	fichman
פישר	fischer
פכנר	fechner
פלאג'	fallaj
פלאהירטי	flaherty
פלאוץ	plautz
פלאטא	plata
פלאטג'יס	plaatjies
פלאטיני	platini
פלאטקו	platko
פלאישר	fleischer
פלאמיון	flamion
פלאמיני	flamini
פלאנדרז	flanders
פלאנוס	planus
פלאנינק	planinc
פלאנק	planck
פלאנקיט	plunkett
פלאס	plus
פלאסידו	placido
פלאסיל	plasil
פלאסנטי	placente
פלדמאן	feldman
פלוה	flohe
פלוטארך	plutarch
פלוטו	pluto
פלוטז	ploetz
פלויד	floyd
פלויסטי	ploiesti
פלוס	peluce
פלוסקאל	pluskal
פלוריאן	florian
פלוריאנו	floriano
פלוריאנופוליס	florianopolis
פלורידא	florida
פלורין	florin
פלורינט	florent
פלוריס	flores
פלורנטין	florentin
פלורנטינו	florentino
פלורנס	florence
פליטיקוסא	pletikosa
פליטר	flitter
פליימן	plamen
פלימינג	flemming
פלין	flynn
פליסיס	plessis
פליסירז	plessers
פן	penn
פנאק	pennac
פנג	feng
פנחס	pinchas
פנטיקוסט	pentecost
פנינה	pnina
פנלון	fenelon
פנלופי	penelope
פפאנקוטש	pfannkuch
פפה	pepe
פפין	pepin
פפיסטר	pfister
פפלוגלר	pflugler
פפסי	pepsi
פקראדוני	pakradouni
פקרמאן	pekerman
פראדו	prado
פראדיש	pradesh
פראהאני	farahani
פראטי	prati
פראימוס	primus
פראיס	price
פראן	fran
פראנדילי	prandelli
פראנז	franz
פראנטיסק	frantisek
פראניו	franjo
פראניטש	pranjic
פראנס	frans
פראנסילודו	francileudo
פראנסיסקו	francisco
פראנסיסקולי	francescoli
פראנסמאן	fransman
פראנססקא	francesca
פראנק	frank
פראנקי	franky
פראנקלין	franklyn
פראנקפורט	frankfurt
פראנשיני	francini
פראנשיסקו	francesco
פראס	feras
פראסקו	frasco
פראשא	prussia
פרגוסון	ferguson
פרדוס	ferdoos
פרדינאנד	ferdinand
פרדינאנדו	ferdinando
פרוגיריא	progeria
פרודו	frodo
פרודי	prodi
פרודיוס	prudius
פרודל	prodl
פרוטוקול	protocol
פרויאס	proyas
פרוידפילדט	frojdfeldt
פרוכזאד	farrokhzad
פרולאקטין	prolactin
פרולין	proline
פרום	fromm
פרומיתיום	promethium
פרונטירא	frontera
פרונייה	prunier
פרוסט	proust
פרופוליס	propolis
פרופיין	propane
פרוצו	pruzzo
פרוקסימא	proxima
פרחאט	ferhat
פרחי	farhi
פריגה	frege
פריד	fareed
פרידג'וף	fridtjof
פרידה	frida
פרידון	feridun
פרידיריק	frederick
פרידל	friedel
פרידמאן	friedman
פרידריק	fredrik
פרידריקס	fredericks
פרידריקסון	fredriksson
פריון	prion
פריז	friz
פריטוריא	pretoria
פריטי	preity
פריי	frei
פרייזר	fraser
פרייטו	prieto
פרייר	freire
פרילינג	freleng
פרימאן	freeman
פרימורסקו	primorsko
פרימסל	premysl
פרינגז	frings
פרינטש	french
פרינס	prince
פריסטון	preston
פריסטינא	pristina
פריסירן	preseren
פריסק	frisk
פריסקוט	prescott
פריסקוס	priscus
פריץ	fritz
פריק	frick
פרלמאן	perelman
פרמאן	firman
פרנאנד	fernand
פרנאנדיז	fernandez
פרנסוא	francois
פרנסיסקן	franciscan
פרס	peres
פרסו	prso
פרעון	feraoun
פרץ	peretz
פרק	perec
פרשאד	farshad
צ'אבאלאלא	tshabalala
צ'אביז	chavez
צ'אדויק	chadwick
צ'או	chao
צ'אטוין	chatwin
צ'אילדז	childs
צ'אימאן	chaiman
צ'איקאמדי	chaikamdee
צ'אלאנא	chalana
צ'אלמי	chalme
צ'אלקיאס	chalkias
צ'אמאנגא	chamanga
צ'אמוט	chamot
צ'אן	chan
צ'אנג	chang
צ'אנדלר	chandler
צ'אנדרא	chandra
צ'אנדריקא	chandrika
צ'אנו	ciano
צ'אנוב	chanov
צ'אנינג	channing
צ'אנל	chanel
צ'אפורין	chafurin
צ'אק	chuck
צ'אראלאמבוס	charalambos
צ'ארלז	charles
צ'ארלטון	charlton
צ'ארפיניט	charpenet
צ'ובאניטש	chovanec
צ'וטוס	choutos
צ'ויקוב	chuikov
צ'וכילי	chokheli
צ'ולאפא	chulapa
צ'ומסקי	chomsky
צ'ורדא	chorda
צ'טרי	chhetri
צ'יבא	chiba
צ'יבאדזה	chivadze
צ'יבו	chivu
צ'ידל	cheadle
צ'יוא	chiwa
צ'יונה	chiune
צ'יטו	chitou
צ'יימברלין	chamberlain
צ'ייס	chace
צ'יירו	cheyrou
צ'ילדיריק	childeric
צ'ימאבו	cimabue
צ'ימבונדא	chimbonda
צ'ינגי	chingy
צ'ינטו	chintu
צ'יסלאב	czeslaw
צ'יקאו	chikao
צ'יקליס	chiklis
צ'ירו	ciro
צ'ישולם	chisholm
צ'כוב	chekhov
צ'לבי	chalabi
צ'לנטאנו	celentano
צ'מניץ	chemnitz
צ'ן	chen
צ'נגיז	chinghiz
צ'נן	chenene
צ'סטר	chester
צ'פיטה	chepita
צ'ק	cech
צ'רי	cherry
צבאיג	zweig
צבי	zevi
צביטאן	tzvetan
צוג'י	tsuji
צוכארט	zuchardt
צונינאגא	tsunenaga
צוקמאיר	zuckmayer
צור	tzur
צורוואס	tzorvas
ציוליס	tziolis
צימבאלאר	tsymbalar
ציפו	tsepo
ציפי	tzipi
צלאן	celan
צריפין	tzrifin
ק.	c.
קאב	kav
קאבאליירי	cavalieri
קאבאנאס	cabanas
קאבוט	cabot
קאבול	kabul
קאבונגו	kabongo
קאבוקי	kabuki
קאבידס	kaviedes
קאביזל	caviezel
קאביל	cavell
קאבילא	kabila
קאבל	cabel
קאבריטא	cabrita
קאברילו	cabrillo
קאבריני	cabrini
קאברירא	cabrera
קאג'י	kaji
קאג'יורא	kajiura
קאגאן	kagan
קאגו	kago
קאדאר	kadar
קאדהירין	cadherin
קאדילאק	cadillac
קאדים	kadhim
קאדישא	kadisha
קאדליץ	kadlec
קאדר	kader
קאהאנא	kahane
קאהיל	cahill
קאהל	kehl
קאהן	kahn
קאהנמאן	kahneman
קאו	cao
קאואי	kawai
קאואקאמי	kawakami
קאוונאגי	cavenaghi
קאוזיו	causio
קאונטי	county
קאוקג'י	kavakci
קאורי	kaori
קאזאז	kazaz
קאזאכסטאן	kazakhstan
קאזאן	kazan
קאזאנצאקיס	kazantzakis
קאזוהיקו	kazuhiko
קאזויא	kazuya
קאזויושי	kazuyoshi
קאזוקי	kazuki
קאזורלא	cazorla
קאזימיר	kazimir
קאזימירו	casimiro
קאזינגא	kazenga
קאטאלאני	catalani
קאטאלוניא	catalonia
קאטאלינא	catalina
קאטאניטש	katanec
קאטאקאנא	katakana
קאטב	kateb
קאטויסא	katowice
קאטון	catton
קאטונגו	katongo
קאטזר	katzer
קאטי	cutty
קאטיפ	katip
קאטירינא	caterina
קאטליגו	katlego
קאטסו	katsu
קאטסוראניס	katsouranis
קאטסינא	katsina
קאטרינא	kateryna
קאטרמול	cattermole
קאטשינסקי	kaczynski
קאטשר	kutcher
קאיא	kaia
קאיאווא	kajava
קאיאפאס	kaiafas
קאיומי	kayumi
קאיזן	kaizen
קאיזרסלאוטרן	kaiserslautern
קאיטאנו	cayetano
קאיטיסוק	kiatisuk
קאיטל	keitel
קאייבוט	caillebotte
קאיל	kyle
קאימבי	kaimbi
קאיסון	kaysone
קאיפו	kaifu
קאיפנג	kaifeng
קאירו	cairo
קאישו	kaishu
קאכיטי	kakheti
קאל	cal
קאלא	kalla
קאלאבאן	kalabane
קאלאבריא	calabria
קאלאבריטא	kalavryta
קאלאגאן	callaghan
קאלאטראבא	calatrava
קאלאנגא	kalanga
קאלאס	callas
קאלאף	kalaf
קאלגארי	calgary
קאלדירא	caldera
קאלדר	calder
קאלה	calais
קאלוייב	kaloyev
קאלוין	calvin
קאלום	calum
קאלון	kallon
קאלוסט	calouste
קאלושא	kalusha
קאלזאדא	calzada
קאלי	khali
קאליארי	cagliari
קאליגולא	caligula
קאליכא	calleja
קאלימירו	calimero
קאליניטש	kalinic
קאלינינגראד	kaliningrad
קאליף	califf
קאליקסיקו	calexico
קאלמאן	kalman
קאלמיקיא	kalmykia
קאלסטרום	kallstrom
קאלפאט	kalfat
קאלץ	kaltz
קאלקוטא	calcutta
קאמאטארו	camataru
קאמאמוטו	kamamoto
קאמארא	camara
קאמבונדי	kambonde
קאמבי	camby
קאמביאסו	cambiasso
קאמדן	camden
קאמו	camus
קאמיא	kamiya
קאמיי	kamei
קאמיל	camille
קאמילא	camilla
קאמילו	camillo
קאמיקאוא	kamikawa
קאמירון	cameron
קאמל	kamil
קאמן	kamen
קאמפו	campo
קאמפוס	campos
קאמפוש	kampusch
קאמפף	kampf
קאנאבארו	cannavaro
קאנבירא	canberra
קאנדיא	kandia
קאנדיד	candide
קאנדינסקי	kandinsky
קאנו	kano
קאנוטי	kanoute
קאנון	cannon
קאנט	kant
קאנטארו	kantaro
קאנטונא	cantona
קאנטור	cantor
קאניגיא	caniggia
קאניטי	canetti
קאנייה	kanye
קאנינג	canning
קאניפי	kanepi
קאנירא	caneira
קאנסאס	kansas
קאנסו	qanso
קאנפורי	kanfory
קאנצ'לסקיס	kanchelskis
קאנתר	kanther
קאס	cass
קאסאביטז	cassavetes
קאסאבלאנקא	casablanca
קאסאט	cassatt
קאסאנדרא	cassandra
קאסאנובא	casanova
קאסאס	casas
קאסארין	casarin
קאסדאן	kasdan
קאסדי	kasdi
קאסונדי	kasonde
קאסטאנו	castano
קאסטוניר	castonier
קאסטילו	castillo
קאסטרו	castro
קאסיאן	cassian
קאסיאנוב	kasyanov
קאסיאס	casillas
קאסידי	cassidy
קאסילי	caselli
קאסים	qasim
קאסין	cassin
קאסיריס	caceres
קאספאר	kaspar
קאספר	casper
קאפא	capa
קאפאדוקיא	cappadocia
קאפה	capet
קאפו	kapo
קאפוא	capua
קאפונ	capone
קאפי	kafi
קאפיטסא	kapitsa
קאפיי	kappei
קאפילו	capello
קאפיקי	capecchi
קאפלינסקי	kaplinsky
קאפסיס	kapsis
קאפקא	kafka
קאפקום	capcom
קאפר	kafr
קאפרי	capri
קאצ'אלין	kachalin
קאצורא	katsura
קאקו	kaku
קאקויי	kakuei
קאקונג'י	kakonje
קאקורו	kakuro
קאקיהארא	kakihara
קאראבאלהו	carvalho
קאראבויה	karaboue
קאראגאנדא	karaganda
קאראגוניס	karagounis
קאראגר	carragher
קאראדיטש	karadzic
קאראדינז	karadeniz
קאראזון	karazon
קאראטירא	carretera
קאראם	karam
קאראמנליס	karamanlis
קאראן	karan
קאראסקו	carrasco
קאראקאס	caracas
קאראקלא	caracalla
קארארא	carrara
קארבאכאל	carbajal
קארגוס	kargus
קארגיל	cargill
קארדו	cardo
קארדוזו	cardozo
קארדוסו	cardoso
קארדוצ'י	carducci
קארדילי	cardilli
קארדינוסא	cardenosa
קארדינל	cardinal
קארדק	kardec
קארה	carre
קארו	karo
קארובי	karroubi
קארוה	qaruh
קארול	carroll
קארולא	carola
קארולאין	caroline
קארולאינא	karolina
קארולוס	karolos
קארולי	karoly
קארטאגינא	cartagena
קארטייה	cartier
קארטיס	curtis
קארטירון	carteron
קארטמאן	cartman
קארטר	carter
קארטראיט	cartwright
קאריאר	carrier
קאריוקא	kariokka
קאריל	carrel
קארימבו	karembeu
קארין	karin
קאריני	carini
קאריס	charis
קאריק	carrick
קארירו	carrero
קארל	carl
קארלא	carla
קארלאיל	carlyle
קארלו	carlo
קארלובי	karlovy
קארלוס	carlos
קארלוף	karloff
קארלטון	carlton
קארלי	carly
קארלס	carles
קארלסון	karlsson
קארלסרוה	karlsruhe
קארמאנולא	carmagnola
קארמן	carmen
קארן	karen
קארנאטאקא	karnataka
קארנגי	carnegie
קארני	carney
קארניגליא	carniglia
קארניי	karnei
קארסלי	carsley
קארפינסקי	karpinski
קארפינקו	karpenko
קארפן	karpin
קארקאר	karkar
קארר	karrer
קאתארין	katharine
קאתלין	kathleen
קאתמנדו	kathmandu
קאתרין	katherine
קבאני	qabbani
קבאסנאק	kvasnak
קבה	kebe
קביסט	qvist
קדומים	kedumim
קדימה	kadima
קדיר	kadeer
קהווג'י	kahveci
קהלאני	kahalani
קהרמאנמאראס	kahramanmaras
קו	coe
קואדוו	kwadwo
קואזימודו	quasimodo
קואטימוק	cuauhtemoc
קואלוסקי	kowalewski
קואליארילא	quagliarella
קואמי	kwame
קואן	quan
קואנזא	kwanzaa
קואנטאס	qantas
קואק	coeck
קואריסמא	quaresma
קואשי	quashie
קואשימא	kuwashima
קובאד	qubad
קובאטש	kovac
קובאטשיביטש	kovacevic
קובאיאשי	kobayashi
קובאלא	kubala
קובאליוב	kovalyov
קובאר	kubar
קובו	kubo
קובון	kobun
קובונטו	kubuntu
קובושי	kobushi
קובי	covey
קוביין	cobain
קובילאס	cubillas
קובלאי	kublai
קובלנז	koblenz
קובנטרי	coventry
קוברמאנס	koevermans
קוג'י	koji
קוגא	koga
קוגיוקו	kogyoku
קודא	koda
קודאס	koudas
קודג'א	codjia
קודינא	codina
קודיצ'יני	cudicini
קודרו	queudrue
קוהארו	koharu
קוהייד	cohade
קווין	kevin
קוון	kwon
קוזא	cuza
קוזאק	cusack
קוזו	kozo
קוזמא	kozma
קוזמאן	quzman
קוזנטסובא	kuznetsova
קוזניטסוב	kuznetsov
קוטאיסי	kutaisi
קוטארבא	kotarba
קוטארו	kotaro
קוטב	qutb
קוטו	couto
קוטוקו	kotoko
קוטי	coty
קוטלר	kotler
קויאבא	cuiaba
קויאמא	koyama
קויאמאדא	koyamada
קויאסו	koyasu
קויד	quidde
קויומגיאן	kouyoumdjian
קויזומי	koizumi
קויט	kuyt
קוייד	quaid
קוילמאנס	ceulemans
קוין	qin
קוינטון	quinton
קוינטין	quintin
קוינקא	cuenca
קויס	kouis
קויסו	koiso
קויצ'י	koichi
קוך	koch
קולאק	colak
קולאר	collar
קולברט	colbert
קולהאס	koolhaas
קולהוף	kollhoff
קולו	kolo
קולודין	kolodin
קולוואטי	collovati
קולווין	colvin
קולוטוב	kolotov
קולומאן	koloman
קולומבא	columba
קולומביא	columbia
קולומבייה	colombier
קולונא	coluna
קולונטאי	kollontai
קולור	collor
קולוראדו	colorado
קולז	cools
קולט	colt
קולטר	colleter
קוליבאלי	coulibaly
קוליט	colette
קולייס	coulais
קולינא	culina
קולן	collin
קולפאקס	colfax
קולר	kohler
קולשראיבר	kohlschreiber
קום	kumm
קומאלו	khumalo
קומאן	koeman
קומאנו	komano
קומאנצ'י	comaneci
קומב	kumbh
קומבין	combin
קומו	como
קומודוס	commodus
קומז	combs
קומט	comte
קומי	kumi
קומיקס	comics
קומלינוביטש	komljenovic
קומפאורי	compaore
קומראן	qumran
קון	cohn
קונאן	conan
קונאקרי	conakry
קונביי	convey
קונג	kong
קונגו	congo
קונדו	kondo
קונדוליזא	condoleezza
קונדירא	kundera
קונו	konno
קונויה	konoe
קונוסוקה	konosuke
קונור	conor
קונטאדור	contador
קונטאר	kuntar
קונטי	conte
קונטרא	contra
קוני	kuni
קוניב	konev
קוניהיקו	kunihiko
קוניו	cuneo
קוניטסין	kunitsyn
קונילי	connelly
קונינגהאם	cunningham
קונישיגי	kunishige
קונסטאבל	constable
קונסטאנט	constant
קונסטאנטיוס	constantius
קונסטאנטין	konstantin
קונסטאנטינו	konstantinou
קונסטאנטינוס	konstantinos
קונסטאנטינסקו	constantinescu
קונסטנזא	constanze
קונסיסאו	conceicao
קונץ	kuntz
קונקורד	concorde
קונראד	conrad
קונרט	kunert
קונרי	connery
קונשיטא	conchita
קונשיסקי	konchesky
קוס	coase
קוסא	cosa
קוסאו	kusao
קוסבי	cosby
קוסגרוב	cosgrove
קוסוגי	kosugi
קוסומי	kusumi
קוסוקי	kosuke
קוסט	coast
קוסטא	costa
קוסטאנזו	costanzo
קוסטאס	kostas
קוסטוניקא	kostunica
קוסטוריצא	kusturica
קוסטיטש	kostic
קוסטילו	costello
קוסטינהא	costinha
קוסטיקוס	kostikos
קוסטר	koster
קוסטרס	custers
קוסיגין	kosygin
קוסימוב	qosimov
קוסין	kosin
קוסל	kossel
קוסקו	cusco
קופא	kopa
קופה	coupet
קופולא	coppola
קופי	coffi
קופירין	couperin
קופמאן	kaufmann
קופנהאגן	copenhagen
קופקה	kopke
קופרניקוס	copernicus
קוצ'אק	kuszczak
קוצ'אריאן	kocharyan
קוק	cook
קוקארד	cocard
קוקוזקא	kokoszka
קוקושקא	kokoschka
קוקי	koki
קוקיס	cocis
קוקיצ'י	kokichi
קוקן	koken
קוקס	cox
קוקסון	coxon
קוראדו	corrado
קוראדי	corradi
קוראני	kuranyi
קוראס	coras
קוראקי	kuraki
קורבוסייה	corbusier
קורביס	courbis
קורבן	korban
קורבר	corver
קורדאחי	kurdahi
קורדיסטאן	kurdistan
קורדל	cordell
קורו	curro
קורודא	kuroda
קורוטורק	koruturk
קורוליוב	korolyov
קורוסאקי	kurosaki
קורוקאוא	kurokawa
קורזאין	corzine
קורזו	corzo
קורט	kurt
קורטז	kurtz
קורטיזול	cortisol
קורטין	curtin
קורטיס	cortes
קורטני	courteney
קורי	cory
קוריא	correia
קוריאן	korean
קוריול	couriol
קוריוליס	coriolis
קורין	corin
קוריע	qurei
קוריקיו	korekiyo
קורל	curl
קורליוני	corleone
קורן	koren
קורנברג	kornberg
קורנה	cornet
קורנואל	cornwall
קורנויל	cornwell
קורנייב	korneyev
קורניל	cornell
קורניליא	cornelia
קורניליו	corneliu
קורניליוס	cornelius
קורניקובא	kournikova
קורנתויט	cornthwaite
קורסיטי	corsetti
קורפו	corfu
קורקמאז	korkmaz
קוש	kusch
קושיס	kocsis
קושנר	kouchner
קזאנתופולוס	xanthopoulos
קטגורי	category
קטן	katan
קטע	kata
קטר	qatar
קי	kyi
קיאר	kjar
קיאראן	ciaran
קיארוסטאמי	kiarostami
קיבאקי	kibaki
קיג'ורו	kijuro
קיגאן	keegan
קידו	kido
קידמאן	kidman
קידמט	kidmat
קיו	kyu
קיובא	cuba
קיווס	kiwus
קיוטאקא	kiyotaka
קיוטו	kyoto
קיוטי	quixote
קיוליק	ciolek
קיומא	kyuma
קיומורי	kiyomori
קיומין	cumin
קיורא	kiyoura
קיורי	curie
קיזאנישבילי	khizanishvili
קיזיל	kyzyl
קיזלר	czeizler
קיט	kit
קיטאזאוא	kitazawa
קיטאנו	kitano
קיטון	keaton
קיטיסאק	kittisak
קיטירינג	kettering
קיטס	kitts
קיטש	keach
קיטשירו	kiichiro
קיי	kaye
קייג'	cage
קייגו	keigo
קייזא	chiesa
קייזו	keizo
קייט	kate
קייטא	keita
קייטו	cato
קייטי	katie
קייליני	chiellini
קיין	caine
קייס	kais
קייק	cake
קיירוז	kayrouz
קיל	kyel
קילא	kila
קילאמבי	kilambe
קילה	kela
קילי	kelley
קילמר	kilmer
קילן	killen
קילסו	kelso
קילפן	kilpin
קים	kim
קימברלי	kimberly
קימוקו	kemoko
קימי	kimi
קימירובו	kemerovo
קימפס	kempes
קימפף	kempff
קין	keene
קינאן	kenan
קינג	king
קינגו	kengo
קינגסון	kingson
קינגסטון	kingston
קינגסלי	kingsley
קינז	keynes
קינזי	kinsey
קינטא	kenta
קינטארו	kentaro
קיני	kenny
קיניא	kenya
קיניאטא	kenyatta
קיניאר	kinnear
קינידי	kennedy
קיניי	quesnay
קיניצ'י	kenichi
קינית	kenneth
קינמוצ'י	kinmochi
קינקל	kinkel
קינשאסא	kinshasa
קינשין	kenshin
קיסאי	kessai
קיסאיצ'י	kisaichi
קיסוקה	keisuke
קיסט	kist
קיסיליוב	kiselyov
קיסינג'ר	kissinger
קיסלרינג	kesselring
קיפט	kieft
קיפלינג	kipling
קיפר	kiefer
קיפריאן	ciprian
קיצ'י	kiichi
קיקוצ'י	kikuchi
קיקי	kiki
קירא	keira
קיראלא	kerala
קיראסטאס	kyrastas
קירבי	kirby
קירגיאקוס	kyrgiakos
קירוז	queiroz
קירון	kieron
קירזהאקוב	kerzhakov
קירי	kerry
קיריבאטי	kiribati
קיריגאן	kerrigan
קיריל	kiril
קירילנקו	kirilenko
קיריניא	kyrenia
קיריצ'נקו	kirichenko
קירלון	kerlon
קירני	cerny
קירסטן	kirsten
קירק	kirk
קירקהופס	kerckhoffs
קירקלונד	kyrklund
קירשן	kirschen
קירשנבאום	kirschenbaum
קירשנר	kirshner
קישו	kisho
קישי	kishi
קישימוטו	kishimoto
קית	keith
קל	kol
קלאודיו	claudio
קלאודיוס	claudius
קלאוס	klaus
קלאיב	clive
קלאין	klein
קלאינירט	kleinert
קלאיפידא	klaipeda
קלאמפיט	clampett
קלאן	klan
קלאנסי	clancy
קלאסניטש	klasnic
קלאפטון	clapton
קלארא	clara
קלארנס	clarence
קלארק	clarke
קלארקסון	clarkson
קלאשניקוב	kalashnikov
קלוג	klug
קלוד	claude
קלודט	claudette
קלויברט	kluivert
קלופ	klopp
קלוראמפיניקול	chloramphenicol
קליבי	klibi
קליבלאנד	cleveland
קליברסון	kleberson
קליופאטרא	cleopatra
קליי	klee
קלייד	clyde
קלייר	claire
קלימוב	klimov
קלימינז	clemens
קלימינס	clemence
קלימנט	clement
קלימנטי	clemente
קלינגופר	klinghoffer
קלינגר	klinger
קלינט	clint
קלינטון	clinton
קלינקינבירד	clinkenbeard
קלינת	cleanth
קליף	kleff
קליפורד	clifford
קליפט	clift
קליפטון	clifton
קלירווטר	clearwater
קלירי	cleary
קלישי	clichy
קלקטא	kolkata
קלקיליה	qalqilyah
קלר	keller
קלתום	kulthum
קמאל	kamal
קמבאט	combat
קמבודיא	cambodia
קמפ	kemp
קן	ken
קנאן	kinan
קנאפ	knapp
קנג'י	kenji
קנדא	canada
קנדהאר	kandahar
קנדו	kendo
קנדריק	kendrick
קנוט	knut
קנזו	kenzo
קנט	kent
קנטאריא	kantaria
קניפר	knipper
קנפאני	kanafani
קנקוני	kankoune
קסאב	kassab
קסורי	xuri
קסיאנג	xiang
קסינופאניס	xenophanes
קסיר	kassir
קסר	qasr
קסראוי	kasraoui
קעבי	kaebi
קפורי	kfoury
קפלאן	kaplan
קפלר	kepler
קצרין	katzrin
קקי	kakhi
קקיטי	keketi
קראבירו	cravero
קראגוג'יבאק	kragujevac
קראוטש	crouch
קראולי	crowley
קראוס	krauss
קראיטשק	krajicek
קראמניק	kramnik
קראנוסיטש	karanusic
קראניקאר	kranjcar
קראנקל	krankl
קראסנודאר	krasnodar
קראקאטוא	krakatoa
קראקו	krakow
קראקסי	craxi
קראר	karrar
קרב	krav
קרבייל	kerviel
קרבינקובסקי	crvenkovski
קרו	crowe
קרוגר	krueger
קרודאפ	crudup
קרוז	cruz
קרוזר	kreuzer
קרוטו	kroto
קרוטיקוב	krutikov
קרוי	karoui
קרויישה	croatia
קרול	krul
קרולדרופ	kroldrup
קרומוול	cromwell
קרונבאך	cronbach
קרוננברג	cronenberg
קרוס	cross
קרוסבי	crosby
קרופוטקין	kropotkin
קרוצ'י	croce
קרוקי	croci
קרוקיט	crockett
קרוקר	crocker
קרותרס	crothers
קרזאי	karzai
קרזוייל	kurzweil
קרזינוויק	krzynowek
קריימר	kramer
קרייסטון	crayston
קרייסקי	kreisky
קרייפורד	crayford
קרילוב	krylov
קרים	karim
קרימוב	kerimov
קרימייה	cremieux
קרימר	kremer
קרימרז	kremers
קריס	chris
קריסוסטום	chrysostome
קריסטאנא	kristanna
קריסטאנבאל	christanval
קריסטו	christou
קריסטוף	christophe
קריסטופורו	cristoforo
קריסטופיאס	christofias
קריסטופר	christopher
קריסטיאן	kristian
קריסטיאנו	cristiano
קריסטיאנסן	kristiansen
קריסטין	kristen
קריסטינא	christina
קריסטנסן	kristensen
קריספו	crespo
קריספוס	crispus
קריפטוזואולוג'י	cryptozoology
קריפן	crippen
קריק	crick
קריקטון	crichton
קרירי	kariri
קרישנא	krishna
קרישצ'אנסן	christiansen
קרית	kiryat
קרמניץ	kremnitz
קרעון	qaraoun
קרפינילו	carpinello
קרקואן	kerkouane
קשוע	kashua
קשמיר	kashmir
ראאד	raed
ראאף	raef
ראב	raab
ראבואל	rabuel
ראבוסיס	ravousis
ראביו	rabiu
ראבינא	ravenna
ראבנדראנאת	rabindranath
ראבשאן	ravshan
ראגב	ragheb
ראגח	rageh
ראדאנוביטש	radanovic
ראדהא	radha
ראדו	radu
ראדובאן	radovan
ראדוי	radoi
ראדויקו	radojko
ראדומיר	radomir
ראדוסיו	raducioiu
ראדוסלאב	radoslav
ראדי	radhi
ראדיו	radio
ראדיוהד	radiohead
ראדיק	radek
ראדישי	radice
ראדקליף	radcliffe
ראובן	reuven
ראוחי	rawhi
ראוייר	ravier
ראז	raz
ראזאנו	razzano
ראחיל	rahel
ראט	rat
ראטב	rateb
ראטומיר	ratomir
ראטזל	ratzel
ראטקו	ratko
ראיאן	ryan
ראיאנר	ryanair
ראידיל	ryedale
ראידר	ryder
ראיזיגיר	reiziger
ראיט	wright
ראיכשטאין	reichstein
ראילי	reilly
ראימאן	reimann
ראימון	raemon
ראימונד	raymond
ראימי	raimi
ראינהארט	reinhardt
ראינהולד	reinhold
ראיניא	rainea
ראיס	rice
ראיצ'ל	rachael
ראיק	reich
ראיקונן	raikkonen
ראכש	rakhsh
ראלב	raleb
ראלדיס	raldes
ראלסטון	ralston
ראלף	ralph
ראמא	rama
ראמאג'	ramage
ראמאט	ramat
ראמאטי	rahmati
ראמאיאנא	ramayana
ראמאמורתי	ramamurthy
ראמבוטאן	rambutan
ראמו	rameau
ראמוס	ramos
ראמי	ramy
ראמין	ramin
ראמיריז	ramirez
ראמירס	ramires
ראמל	ramel
ראמליאק	ramljak
ראמן	ramn
ראמסיי	ramsey
ראמספילד	rumsfeld
ראמפאל	rampal
ראנדאל	randall
ראנדולף	randolph
ראנדי	randy
ראני	rani
ראניירי	ranieri
ראנסום	ransome
ראנסטרום	runstrom
ראנספורד	ransford
ראס	ras
ראסא	rasa
ראסטאפארי	rastafari
ראסיזאדה	rasizade
ראסל	russel
ראסמוס	rasmus
ראסמוסין	rasmussen
ראספיוטין	rasputin
ראסק	rusk
ראפאייטש	rapaic
ראפאל	rafal
ראפופורט	rapoport
ראפי	rapp
ראצ'אד	rachad
ראקיטיטש	rakitic
ראשא	russia
ראשד	rashed
ראשומון	rashomon
ראשקי	raschke
רביב	raviv
רבין	rabin
רביץ	ravitz
רביקא	rebecca
רבל	revelle
רג'א	raja
רג'אבי	rajavi
רג'ב	rajab
רג'ולינא	rajoelina
רג'וסקי	rejewski
רג'פ	rexhep
רד	redd
רדמונד	redmond
רדפא	redfa
רו	roux
רואידא	rouwaida
רואני	rouani
רובאניאמי	rovaniemi
רובי	robbie
רובין	rubin
רובינג'	rovinj
רובינהו	robinho
רובינסונז	robinsons
רובינסטין	rubinstein
רוביק	rubik
רובלז	robles
רובן	robin
רובניז	robbins
רובנסון	robinson
רובסון	robeson
רוברט	robert
רוברטו	roberto
רוברטס	roberts
רוג'יר	rogier
רוג'ר	roger
רוג'רז	rogers
רוגובא	rugova
רוגיבין	roggeveen
רוגיירו	ruggiero
רוגיריו	rogerio
רוגן	rogen
רוד	rod
רודאן	roudhan
רודאקוב	rudakov
רודבאריאן	roudbarian
רודולף	rudolf
רודולפו	rodolfo
רודזיק	rodzik
רודי	rudi
רודיסיא	rhodesia
רודיק	roddick
רודני	rodney
רודר	roeder
רודריגו	rodrigo
רודריגז	rodrigues
רודריגיז	rodriguez
רודריק	roderick
רוהר	rohr
רוון	rowen
רוז	rose
רוזא	rosa
רוזאטו	rosato
רוזאריו	rosario
רוזיהנאל	rozehnal
רוזיטי	rosetti
רוזנבאום	rosenbaum
רוזנבלום	rosenblum
רוזנברג	rosenberg
רוזנטאל	rosenthal
רוטאן	rutan
רוטאנא	rotana
רוטארו	rotaru
רוטבלאט	rotblat
רוטל	ruutel
רוטלדיגص	routledge
רוטרדאם	rotterdam
רוי	ruy
רויאל	royal
רויז	ruiz
רויטמאן	roitman
רויטר	reuter
רויסי	rouissi
רול	ruhl
רולאנד	rolland
רולדר	roleder
רולו	rollo
רולינג	rowling
רולף	rolff
רולפו	rulfo
רולפס	rolfes
רולר	roehler
רום	rome
רומאלד	romuald
רומאן	roman
רומאנו	romano
רומאריו	romario
רומארין	romarin
רומיו	romeo
רומיין	romain
רומייניאנז	romanians
רומייניה	romania
רומינא	romina
רומיקו	rumiko
רומירו	romero
רומל	rommel
רומני	romney
רומר	roemer
רון	ron
רונאלד	ronald
רונאלדו	ronaldo
רונאלדינהו	ronaldinho
רונד	ronde
רונדוניא	rondonia
רונטגניום	roentgenium
רונית	ronit
רוס	ross
רוסדיסקי	rusedski
רוסו	rousseau
רוסודאן	rusudan
רוסוליני	rossellini
רוסום	rossum
רוסוס	roussos
רוסטאבי	rustavi
רוסטוב	rostov
רוסטום	rostom
רוסטי	rosti
רוסטיסלאב	rostislav
רוסי	rosi
רוסיט	rousset
רוסיני	rossini
רוסיניור	rosenior
רוסיקי	rosicky
רוסלאן	ruslan
רוסליפ	ruislip
רופאלו	ruffalo
רופין	ruppin
רוצ'יטו	rocheteau
רוצ'מבאק	rochemback
רוקו	roko
רוקוול	rockwell
רוקי	rocchi
רוקמונד	rockmond
רוקסאס	roxas
רוקסבורג	roxburgh
רורק	rourke
רושאן	roshan
רושדי	rushdy
רושוס	rochus
רושיל	rochelle
רות	roth
רותליסבירגר	rothlisberger
רותמאן	rothman
רותשילד	rothschild
רזא	reza
רחבעם	rehavam
רחובות	rehovot
רחימה	rehema
רחמאן	rehman
רי	rei
ריאד	riyad
ריאן	rayyan
ריבא	riva
ריבאז	revaz
ריבאלדו	rivaldo
ריבאק	rybak
ריבו	ribot
ריביירו	ribeiro
ריבילא	rivilla
ריביליר	reveillere
ריביר	revere
ריבירא	rivera
ריבירוס	riveros
ריבסט	rivest
ריברי	ribery
ריגובירטא	rigoberta
ריגוברט	rigobert
ריגוט	riggott
ריגיירו	regueiro
ריגל	riegel
ריגנסברג	regensburg
רידג'וול	ridgewell
רידון	redon
רידונדו	redondo
רידל	riedle
רידלי	ridley
רידנאפ	redknapp
רידניק	rednic
ריה	rie
ריהאגל	rehhagel
ריוג'י	ryuji
ריוגصי	ryoji
ריומא	ryoma
ריוסיי	ryusei
ריוצ'	rioch
ריוצ'י	ryoichi
ריוקו	ryoko
ריזאל	rizal
ריזיק	rizik
ריזק	rizk
ריט	ritt
ריטא	rita
ריטו	reto
ריטוילד	rietveld
ריטסוס	ritsos
ריטר	ritter
ריי	ray
רייג'ירו	reijiro
רייגן	reagan
ריידון	radon
רייזר	reiser
ריימונט	reymont
ריינדירס	reinders
ריינהארט	reinhart
רייצ'ל	rachel
רייק	reik
רייקי	reiki
ריכא	reija
רילמי	relmy
רים	rym
רימאן	riemann
רימבו	rimbaud
רימון	rimon
רימיט	rimet
רימיטי	rimitti
רימיטיר	remetter
רימיני	rimini
רינאט	renate
רינאטו	renato
רינאלד	reynald
רינאלדו	rinaldo
רינאלדז	reynolds
רינאן	renan
רינגו	ringo
רינהארד	reinhard
רינו	reno
רינולט	renault
רינוניס	renones
רינזו	renzo
רינסינברינק	rensenbrink
רינסניג	rensing
רינקו	rinko
רינקוין	renquin
רינקויסט	rehnquist
רינקון	rincon
רינר	renner
רינת	rinat
ריסא	risa
ריסוס	rissos
ריסטו	risto
ריסין	ricin
ריסקין	riskin
ריסר	risser
ריפיטו	repetto
ריפלי	ripley
ריפעט	rifaat
ריצ'ארד	richard
ריצ'ארדז	richards
ריצ'ארדסון	richardson
ריצ'י	ricci
ריצ'רט	richert
ריק	rik
ריקארד	rijkaard
ריקארדו	riccardo
ריקארדינהו	ricardinho
ריקו	rico
ריקובא	recoba
ריקודירק	recouderc
ריקי	ricki
ריקיא	rikiya
ריקילמי	riquelme
ריקמאן	rickman
ריקס	reichs
רישטהופן	richthofen
רישטר	richter
רישיליו	richelieu
רכמאנינוף	rachmaninoff
רמבראנט	rembrandt
רמדאן	ramdane
רמזאן	ramazan
רמזי	ramzy
רמי	remy
רמייש	rmaich
רמלה	ramla
רמסיס	ramesses
רן	wren
רנאט	renat
רנה	rene
רנשלר	renschler
רסול	rasoul
רסיפי	recife
רסלאן	raslan
רפ	rep
רפאל	raphael
רפאלי	raffaele
רפח	rafah
רפיק	rafik
רקפי	rexhepi
רשאד	rashad
רשיד	rasheed
רשידי	rashidi
רשמור	rushmore
שאבאני	shabani
שאבי	xabi
שאביס	chaves
שאגאל	chagall
שאגאס	chagas
שאגארי	shagari
שאד	shahd
שאדי	shady
שאדלי	chedli
שאהין	shaheen
שאהנאמה	shahnameh
שאו	shao
שאול	shaul
שאוקאט	shaukat
שאוקי	shawki
שאורמא	shawarma
שאז	chazz
שאטילי	shatili
שאטלוורת	shuttleworth
שאכט	schacht
שאמבירס	chambers
שאמון	chamoun
שאמי	schami
שאמיל	shamil
שאמך	shamekh
שאמכאני	shamkhani
שאמלו	shamlou
שאן	shan
שאנדונג	shandong
שאנטאל	chantal
שאניא	shania
שאנקאר	shankar
שאנקלי	shankly
שאף	schaaf
שאפוזיו	chappuzeau
שאפור	shapour
שאפירא	shapira
שאצ'נר	schachner
שאצקיך	shatskikh
שאקא	shaka
שאקיב	shakib
שאקיל	shaquille
שאקירא	shakira
שאקלטון	shackleton
שאראנסקי	sharansky
שאריט	sharett
שארלוט	charlotte
שארמא	sharma
שבאב	shabab
שבאינשטאיגר	schweinsteiger
שבזי	shabazi
שבתאי	sabbatai
שדיד	chadid
שדרות	sderot
שהאב	shehab
שהו	shehu
שהזאד	shehzad
שהיד	shahid
שו	sho
שוארmמן	schwartzman
שוארץ	schwartz
שוארצמאן	schwartzmann
שוארצניגר	schwarzenegger
שוארצר	schwarzer
שובייר	shobair
שוביר	schober
שובל	shoval
שובן	chauvin
שוג'אעי	shojaei
שוטוקאן	shotokan
שוי	shui
שויטשי	shuichi
שויקאר	shwikar
שול	scholl
שולא	shola
שולטז	schultz
שולמית	shulamit
שולצה	schulze
שומאכר	schumacher
שומאן	schumann
שומו	shomu
שומיי	shumei
שומפיטר	schumpeter
שון	xun
שונסוקי	shunsuke
שוסאקו	shusaku
שוסטיקוב	shustikov
שוסטר	schuster
שוסל	schussel
שועאע	shouaa
שועיב	shoaib
שופאן	chopin
שופנהאור	schopenhauer
שוקיירי	shukeiri
שוקלי	shockley
שוקרי	shoukry
שור	shore
שורי	shorey
שוש	shosh
שושנה	shoshana
שטאודינגר	staudinger
שטאינמאיר	steinmeier
שטורה	chtaura
שטיפי	steffi
שטרית	sheetrit
שי	shai
שיאבוני	schiavone
שיאושו	xiaoxu
שיארים	shearim
שיבא	shiba
שיבאטא	shibata
שיבאם	shibam
שיבאנטון	chevanton
שיבינינגן	scheveningen
שיברדנאדזה	shevardnadze
שיגיושי	shigeyoshi
שיגירו	shigeru
שידיהארא	shidehara
שיה	shih
שיוזאוא	shiozawa
שיטו	shittu
שייז	shays
שיילין	shailene
שיימוס	seamus
שיין	shane
שייפלי	shapley
שיך	cheik
שיכאוי	chikhaoui
שילא	shilla
שילבי	shelby
שילד	shield
שילדון	sheldon
שילטן	shelton
שילפא	shilpa
שילר	schiller
שימבורסקא	szymborska
שימומורא	shimomura
שימינא	ximena
שין	sheen
שינאואטרא	shinawatra
שינגיליא	shengelia
שינודה	shinoda
שינזו	shinzo
שינטו	shinto
שינינגאיאמוי	shiningayamwe
שינקאנסן	shinkansen
שינקיצ'י	shinkichi
שינריקיו	shinrikyo
שיף	shiff
שיפארד	shepard
שיפילד	sheffield
שיפר	schiffer
שיקאבאלא	shikabala
שיקאגו	chicago
שיקארד	schickard
שיקמא	shikma
שיר	cher
שיראי	shirai
שיראישי	shiraishi
שיראק	chirac
שירו	shiro
שירוקוב	shirokov
שירזינגר	scherzinger
שירי	shiri
שיריא	scirea
שירידאן	sheridan
שיריל	cheryl
שירין	shirin
שירלי	shirley
שירנגהאם	sheringham
שישאקלי	shishakli
שישילוב	shishelov
שלאים	shlaim
שלאלא	shalala
שלהוב	shalhoub
שלום	shalom
שלומי	shlomi
שלטוט	shaltut
שלי	shelley
שליט	shalit
שלמה	shlomo
שלמנסר	shalmaneser
שמאס	shammas
שמואל	shmuel
שמולק	schmolck
שמונה	shmona
שמידט	schmidt
שמיט	schmitt
שמשון	shimshon
שמاדהובר	schmidhuber
שנאבל	schnabel
שנאידר	sneijder
שנאידרהאן	schneiderhan
שעבו	chaabo
שעבי	chaabi
שעראוי	shaarawi
שעת	shaath
שפירי	spyri
שפר	schefer
שפרינצק	sprinzak
שקאקי	shaqaqi
שקד	shaked
שקודר	shkoder
שקור	chacour
שקיב	chakib
שקלובסקי	shklovsky
שקספיר	shakespeare
שקשוקה	shakshouka
שר	sher
שראטון	sheraton
שראיבי	chraibi
שרבאט	sharbat
שרגא	shraga
שרודר	schroeder
שרווד	sherwood
שרוט	shroot
שרויף	schrojf
שרון	sharon
שריברז	schrijvers
שריהאן	sherihan
שריעטי	shariati
שריף	sharif
שריקי	chriqui
שרית	sarit
שרלוק	sherlock
שרמאן	sherman
שרק	shrek
תאבו	thabo
תאבט	thabet
תאטא	thatta
תאימין	thymine
תאליא	thalia
תאלמאן	thalmann
תאני	thani
תאצ'י	thaci
תאקסין	thaksin
תג'וויד	tajwid
תואיט	thwaite
תון	thon
תונגלאו	thonglao
תוסנד	thousand
תוקידידיז	thucydides
תור	thor
תורה	torah
תורו	thoreau
תורמאן	thurman
תורסט	thorst
תיאגו	thiago
תיאודור	theodor
תיו	theo
תיודוסיוס	theodosius
תיודור	theodore
תיודורא	theodora
תיופאניס	theofanis
תיס	thys
תיסאלוניקי	thessaloniki
תיסיגר	thesiger
תיסיוס	theseus
תיסין	thijssen
תיסן	thissen
תיראבאדא	theravada
תיראווסין	theerawesin
תירופודא	theropoda
תלאסימיא	thalassemia
תלמוד	talmud
תלפיות	talpiot
תמים	tamim
תמר	tamar
תקוה	tikva
תרדסאק	therdsak
תריונין	threonine
תרייס	thrace
عאלנטין	valentin
عאסילי	vasili
