אבחאזיא	abkhazia
אבטובאז	avtovaz
אביוקוטא	abeokuta
אבישי	avishai
אבראג'	abraj
אברם	avram
אברסט	everest
אגאתא	agatha
אגוילאר	aguilar
אגיין	again
אדבארד	edvard
אדי	eddie
אדם	adam
אדמונד	edmund
אדריאטיק	adriatic
אובאמא	obama
אוגאנדא	uganda
אוגוסטא	augusta
אולימפיק	olympic
אונטייריו	ontario
אוסאמה	osama
אוסואלד	oswald
אוסטראבא	ostrava
אוק	uk
אורהאן	orhan
אורל	aurel
אטיאס	attias
אטלאנטיק	atlantic
איבאנהו	ivanhoe
איבאנוביטש	ivanovic
איגנץ	ignac
איופאן	iofan
איזאק	isaac
איטאלי	italy
איילה	ayala
אינמארסאט	inmarsat
איסטא	issta
איסלאם	islam
איפאמינונדאס	epaminondas
איפטאר	iftar
איראד	irad
איראקלי	irakli
אירוקויס	iroquois
אירי	eri
אירלנדא	ireland
אירשאיר	ayrshire
איתם	eitam
איתן	eitan
אלבאירק	albayrak
אלבראדעי	elbaradei
אלברט	albert
אלגיפארי	alghifari
אלדייר	aldair
אליוט	elliott
אליין	alain
אלמאימני	almaimani
אלמאלח	elmaleh
אלמאסזאדה	almaszadeh
אלמוג	almog
אלעלואני	alalwani
אלעשי	elachi
אלפרד	alfred
אמאם	emam
אמסאעד	imsaad
אמציה	amatzia
אנדרו	andrew
אנדרוניקוס	andronicus
אנונסיאטא	annunziata
אנטארקטיק	antarctic
אנטיגוא	antigua
אסטבאן	esteban
אסטודיאנטיס	estudiantes
אסטי	asti
אסלאן	aslan
אף	f
אפופיס	apophis
אקויטיין	aquitaine
אראד	arad
אראטו	erato
אראנגו	arango
אריסטידיס	aristides
ארנון	arnon
ארנסט	ernst
ארקנסו	arkansas
אשל	eshel
אשר	asher
אתולוג'י	ethology
אתיופיא	ethiopia
אתיין	ethane
אתנאסיוס	athanasius
באודרילארד	baudrillard
באטלס	batlles
באטס	bats
באירם	bajram
באלבוא	balboa
באלטי	balti
באלל	balel
באלמונט	balmont
באנטון	bunton
באס	bass
באסק	busk
באקלי	buckley
באראנקוילא	barranquilla
באריטש	baric
בארינבוים	barenboim
בארניא	barnea
בגין	begin
בדואן	bidouane
בדר	badr
בדריש	bedrich
בו	bo
בובי	bobby
בובלה	buble
בוגאלו	bugalo
בוגוטא	bogota
בודארט	bodart
בודו	bodo
בודי	budi
בודליר	baudelaire
בוהין	bauhin
בוטרוס	butrus
בולעראס	boulares
בומדין	boumediene
בונא	bouna
בונגו	bongo
בונן	boonen
בוסון	buson
בוקאי	bucaille
בורא	bora
בורדין	bordin
בורן	born
בורסילינו	borsellino
בוש	bosch
בידאטסו	bidatsu
ביטאנקורט	betancourt
ביטיגא	bettega
בייבל	bejbl
בילין	beilin
ביליני	bellini
בילירובין	bilirubin
בינג	bing
בינו	benno
בינוש	binoche
ביניטו	benito
בירגירו	bergeroo
בירינג	bering
בירל	berl
בירנארט	beernaert
בישר	becher
בלומי	belloumi
בלומנתאל	blumenthal
בליצר	blitzer
בלקאן	balkan
בם	bem
בנג'אני	benjani
בני	bene
בנסון	benson
בעל	baal
בר	barr
בראזאוסקאס	brazauskas
בראיט	bright
ברגותי	barghouti
ברודבנט	broadbent
ברודי	brody
ברוס	bruce
ברוק	brock
ברוקינג	brooking
ברזוצקי	berezutski
בריטאן	britain
ברינדא	brenda
ברנאל	bernal
ברק	barak
ג'אוהר	jawhar
ג'אנוסקי	janowski
ג'אסיק	jacek
ג'אסירון	jasseron
ג'אקה	jacquet
ג'אקוב	jakob
ג'אקומו	giacomo
ג'בוטנסקי	jabotinsky
ג'וביאן	jovian
ג'וג'ירו	jujiro
ג'וזפין	josephine
ג'ויא	joya
ג'וליון	joleon
ג'וליטי	giolitti
ג'ון	jon
ג'ונא	jonah
ג'ונדיאד	jundiaad
ג'וניור	junior
ג'וניצ'י	junichi
ג'וסף	josef
ג'ופ	jop
ג'ורג'	george
ג'טו	jettou
ג'יג'י	gigi
ג'ייקוב	jacob
ג'ילאלי	djilali
ג'ימי	jimmy
ג'יצ'י	jiechi
ג'ירי	jiri
ג'מאלזאדה	jamalzadeh
ג'סי	jesse
ג'פירסון	jefferson
גאבריאל	gabriele
גאבריל	gavriil
גאזאנקולו	gazankulu
גאזיאנטפ	gaziantep
גאלאגר	gallagher
גאלופ	gallup
גאלילאו	galileo
גאלר	galler
גאסטון	gaston
גארודי	garaudy
גארנר	garner
גבאגבו	gbagbo
גבי	gabi
גבעת	givat
גבריאל	gavriel
גוארין	guerin
גודייר	goodyear
גודמאן	goodman
גווארא	guevara
גוטאמא	gautama
גוטהילף	gotthelf
גוטפריד	gottfried
גויי	gueye
גויסדון	guesdon
גולד	gould
גולדמאן	goldman
גולן	golan
גומיס	gomis
גונג	gong
גונטר	gunter
גוקדניז	gokdeniz
גור	goor
גוראן	goran
גורסל	gursel
גורפיגי	gurpegui
גזא	geza
גזאל	ghezal
גיב	gibb
גיגיא	ghiggia
גילארדינו	gilardino
גיליאד	gilead
גינתון	ginaton
גיר	geir
גלאדסטון	gladstone
גלאסגו	glasgow
גלבוע	gilboa
גליל	galil
גמאל	gamal
גראינדר	grinder
גראציאני	graziani
גרובר	grover
גרילי	greeley
גרימי	grimi
גריס	gris
גריקו	greco
דאגון	dagon
דאדלי	dudley
דאיאקלישן	diocletian
דאיהאטסו	daihatsu
דאיקי	daiki
דאלי	dali
דאלידא	dalida
דאלמאט	dalmat
דאמארקוס	damarcus
דאמון	damon
דאקורט	dacourt
דארוי	darui
דארון	daron
דבוז	debbouze
דהן	dehn
דואי	dewey
דואלא	douala
דוביאס	dobias
דובינסקי	dubinski
דודק	dudek
דוומוה	dwomoh
דולף	dolph
דוסלדורף	dusseldorf
דוקסא	doxa
דוריף	dourif
דוריקס	durix
דורסן	dorsin
דחלאן	dahlan
דיב	dib
דיבא	diba
דיברא	debra
דיגוק	degauque
דידייה	didier
דידיקינד	dedekind
דיטליב	detlev
דיטר	dieter
דיטריך	dietrich
דייויס	davis
דיימוס	deimos
דיינס	danes
דילפי	delphi
דימיטר	demeter
דימיטרי	dimitri
דימיריט	demerit
דין	dean
דינאנט	dinant
דינג	deng
דיס	diss
דיסקין	diskin
דיפו	defoe
דיפלאנדר	deflandre
דיץ	dietz
דיקינסון	dickinson
דיקר	dekker
דיראני	dirani
דירואל	derwall
דישאמפ	deschamps
דניסטר	dniester
דר	der
דראמאני	dramani
האבל	hubble
האברמאס	habermas
האברקורן	haberkorn
האדג'נז	hudgens
האיטי	haiti
האלז	halls
האלפורד	halford
האם	hamm
האמפדן	hampden
האן	han
האנובר	hanover
האסי	haase
האקאבי	huckabee
הארגריבז	hargreaves
הארדין	hardin
הארטרי	hartree
הארלו	harlow
הארלם	harlem
הארניק	harnik
האשמיאן	hashemian
הדי	hedi
הוברט	hubbert
הוגיז	hugues
הומאיון	homayoun
הומנבאד	homnabad
הון	hon
הונג	hong
הוסוקאוא	hosokawa
הופמאן	huffman
הורט	hurt
הושינו	hoshino
הידיאקי	hideaki
הידיו	hideo
הידיטושי	hidetoshi
הידיקאטסו	hidekatsu
הייפליק	hayflick
היל	hill
הילאריו	hilario
הילאריון	hilarion
הילברט	hilbert
הילדבראנד	hildebrand
הילמאן	hellman
הינג	heng
הינמאן	henman
הינצ'וז	henchoz
היקל	haeckel
היראטא	hirata
הירוסו	hirosue
היתרו	heathrow
הכובש	hakovesh
הל	halle
הנקין	henkin
הראנט	hrant
ואיאט	wyatt
ואיז	weisz
ואיט	white
ואלאדאריס	valladares
ואלדיר	valdir
ואלוורת	walworth
ואנגצ'וק	wangchuck
ואנדנדייל	vandendaele
ואסקי	waske
וארן	warren
וארנר	warner
ואשינגטן	washington
וודקוק	woodcock
ווטקה	wuttke
וולאדא	vlada
וולטא	volta
וולטייר	voltaire
וולמאר	wolmar
וונדר	wonder
ווסט	west
ווריאדיס	voreadis
ויו	viv
ויוארסון	vioarsson
ויטאליס	vitalis
ויטולד	witold
ויטסטשג	witschge
ויין	wayne
ויל	will
וילהלמסהייבן	wilhelmshaven
ויליס	willis
וילניוס	vilnius
וילקי	wilkie
וילקינז	wilkins
וינהוי	wenhui
ויניק	weinek
וינצ'ינזו	vincenzo
ויסואנאתאן	viswanathan
ויסילינוביטש	veselinovic
ויסקונטי	visconti
ויק	vik
ויקאש	vikash
ויקראם	vikram
ולאסוב	vlasov
וליד	waleed
ורזאזאת	ouarzazate
וריסן	vreijsen
זאורי	zauri
זאיד	zaid
זאמברוטא	zambrotta
זבולון	zevulun
זהא	zaha
זהרא	zahra
זון	zune
זונגול	zungul
זוף	zoff
זוקו	zoco
זוקורו	xucuru
זייביאר	xavier
זייטוני	zitouni
זין	xin
זיקלון	zyklon
זלאטאן	zlatan
זקאת	zakat
ח'יגאב	hijab
חאטמי	khatami
חאצ'אטוריאן	khachaturian
חאריס	haris
חגי	haggai
חדאד	hadad
חואילד	khuwaylid
חובארא	houbara
חולוסי	hulusi
חוסאם	hussam
חורקיירא	jorquera
חיסן	hissene
חירז	hirz
חלחול	halhul
חליל	khalil
חלילוביטש	halilovic
חמידי	hemidi
חסנל	hassanal
טאבי	tabi
טאדיראן	tadiran
טאוב	taub
טאופו	taupo
טאטארסטאן	tatarstan
טאטו	tautou
טאיוו	taiwo
טאיט	tite
טאימא	tayma
טאיניו	tainio
טאיפיי	taipei
טאלבאני	talabani
טאמיט	tammet
טאמיל	tamil
טאנג'ו	tanju
טאקאטוקי	takatoki
טאקאשי	takashi
טאקידא	takeda
טאקיוצ'י	takeuchi
טג'לי	tajalli
טהמאספ	tahmasp
טוגנדהאט	tugendhat
טוטמא	totma
טולדו	toldo
טום	tom
טומאסו	tommaso
טומוהירו	tomohiro
טורילי	torelli
טורנאטורי	tornatore
טיאסי	tiasse
טיגילס	teugels
טיטא	titta
טימו	teemu
טינג	ting
טיצ'י	tichy
טיקריט	tikrit
טיר	tir
טירים	terim
טירנר	turner
טלאס	tlass
טמאס	tamas
טראיס	trice
טראנקוילו	tranquillo
טראפאלגאר	trafalgar
טרייסי	tracy
טרימולינאס	tremoulinas
יאזאלדי	yazalde
יאמאסאקי	yamasaki
יאן	jan
יאניס	yannis
יאנקוביטש	jankovic
יאסא	yassa
יאסין	yacine
יאסקילאינן	jaaskelainen
יאסר	yasser
יאקופו	jacopo
יארקו	jarkko
יואב	yoav
יויצ'י	yuichi
יויצ'ירו	yoichiro
יולדוש	yo‘ldosh
יומי	yumi
יונלונג	yunlong
יוקוס	yukos
יוקי	yuki
יורופ	europe
יושיו	yoshio
יושצ'נקו	yushchenko
יפים	yefim
לאבאל	laval
לאברא	lavra
לאברונינקו	lavronenko
לאו	lau
לאואל	lawal
לאזאר	lazare
לאזאריב	lazarev
לאיפזיג	leipzig
לאמאר	lamar
לאנג	lange
לאנדשטאינר	landsteiner
לאסקארינא	laskarina
לאפורטא	laporta
לביב	lviv
להיב	laheeb
לובודזינסקי	lobodzinski
לוביט	lovett
לוגו	lugo
לומיר	lemerre
לוס	lous
לוסין	leucine
לוקאס	lucas
לוקאש	lukacs
לוקהד	lochhead
לורנז	lorenz
לחד	lahad
ליאו	leo
ליבני	livni
ליבנת	livnat
ליגיא	legia
ליטון	litton
ליטל	little
לילהאמר	lillehammer
לילי	lilli
לימארי	lymari
לינדון	lyndon
ליסטראד	lestrade
ליפא	lipa
ליפי	lippi
לירוי	leroy
לערפאוי	larfaoui
מאג'ר	madjer
מאגדה	magda
מאהוט	mahut
מאזדא	mazda
מאטו	mato
מאטיראצי	materazzi
מאטסוי	matsui
מאי	mai
מאיאמי	miami
מאלארין	malaren
מאלוני	maloney
מאלכאז	malkhaz
מאנדריבא	mandriva
מאנינגר	manninger
מאניע	manea
מאסאקיו	masakiyo
מאסופסט	masopust
מאסינג	masing
מאצ'לאס	machlas
מאקאנגא	macanga
מאקינדו	mcindoe
מאקנרו	mcenroe
מאראט	marat
מארט	mart
מארייט	mariette
מאריסקא	maresca
מארלין	marlene
מארמאדוק	marmaduke
מארצן	marcin
מארקוס	markus
מדאח	maddah
מהרזאד	mehrzad
מובלי	mobley
מודיבו	modibo
מודירי	modiri
מודנה	modena
מוזפר	mudhafar
מוחמד	mohammad
מוטוקו	motoko
מוטסטיג	meutstege
מולא	molla
מולייר	moliere
מולינגא	mulenga
מומו	mommu
מונוז	munoz
מונזא	monza
מונטאנייה	montagnier
מוניקא	monica
מונקאיו	moncayo
מוסעב	mosab
מוצארט	mozart
מוקרג'י	mukerji
מורוזיביטש	morozevich
מורטאז	murtaz
מוריאנטס	morientes
מורילו	morello
מוריסיו	mauricio
מורסאל	mursal
מזאר	mazar
מזרחי	mizrahi
מטוואלי	metwalli
מיאמוטו	miyamoto
מידלטון	middleton
מיוצ'י	meucci
מיט	mit
מיטאל	mittal
מיטאליקא	metallica
מייזונו	maezono
מילאניטש	miljanic
מיליבא	mileva
מיליקאמפס	millecamps
מימי	mimi
מיניונא	mignogna
מינקובסקי	minkowski
מיקהיו	mchugh
מיקימוטו	mikimoto
מירג'לול	mirjalol
מיריי	mireille
מישר	miescher
מלאלאי	malalai
מלינדא	melinda
מלקי	melki
מלקיאן	malakian
מלרוז	melrose
מנדל	mendel
מנצ'ו	menchu
מסארו	massaro
מערוף	marouf
מקאבוי	mcavoy
מקבראיד	mcbride
מקטירנאן	mctiernan
מקלאקלאן	mclachlan
מקסיס	mexes
מרבאח	merbah
מרום	merom
מריאח	meriah
מרניסי	mernissi
נאואז	nawaz
נאוהירו	naohiro
נאיף	nayef
נאסר	naser
נאקאזאוא	nakazawa
נאקאטא	nakata
נבון	navon
נגאטג'זיקו	ngatjizeko
נד	ned
נהאלפו	nhlapo
נואקשוט	nouakchott
נובוטל	novotel
נובטושי	nobutoshi
נולאן	nolan
נורברט	norbert
נוריו	norio
נורילסק	norilsk
נורמי	nurmi
נחשון	nachshon
ניליס	nellis
ניקולודיס	nikoloudis
נלי	nelly
נסיבאמבי	nsibambi
נסרה	nasra
נפאל	nepal
נפר	knepper
סאבינא	sabina
סאביר	sabeer
סאברי	saberi
סאגאנווסקי	saganowski
סאוור	sauer
סאורי	saori
סאייד	sayyid
סאלח	saleh
סאלינקו	salenko
סאמפאיו	sampaio
סאנגויניטי	sanguinetti
סאנגר	sanger
סאנז	sanz
סארא	sara
סארטג'י	saartjie
סארין	sarin
סארינאנא	sarinana
סבאסטיאו	sebastiao
סביטקוביטש	cvetkovic
סבירבנק	sberbank
סדרא	sadra
סואנק	swank
סוגיהארא	sugihara
סוהראב	sohrab
סויקו	suiko
סויר	soyer
סוירי	sverre
סוכומי	sukhumi
סולטאני	soltani
סומא	soma
סוניס	souness
סוסוקה	sosuke
סופר	sofer
סורינטו	sorrento
סושא	sucha
סזוליק	szulik
סטאזי	stasi
סטויצ'קוב	stoichkov
סטילא	stella
סטיפאנאקירט	stepanakert
סטיפאנופולוס	stephanopoulos
סטיפאני	stefani
סטראדיבאריוס	stradivarius
סטריפ	streep
סיאגריוס	syagrius
סיאק	sjaak
סיבאסטיאן	sebastien
סיביניק	sibenik
סיגורני	sigourney
סידון	sidon
סיליטש	cilic
סימונז	simons
סימיונוב	semyonov
סינא	senna
סינאן	sinan
סינאקי	senaki
סינדי	cindy
סינקיביטש	sienkiewicz
סליבי	salibi
סנטורי	centauri
ספארטא	sparta
ספיגלר	spiegler
ספילינג	spelling
ספיר	speer
ספרי	safri
סקאח	skah
סקולא	scola
סקלטון	skelton
עאיל	ayil
עאמיר	aamir
עוואד	awad
עין	ayn
עליחאני	alikhani
עלמי	alami
ענאיאטי	enayati
עסאקיר	asakir
עפאר	afar
פאדו	fado
פאהד	fahed
פאולינא	paulina
פאזיקאס	fazekas
פאיק	pike
פאיריטו	pairetto
פאלה	palais
פאלוסקי	paloschi
פאמא	fama
פאן	fan
פאנדל	fandel
פאנטוליאנו	pantoliano
פאסטון	paston
פאסילינא	paasilinna
פאפאפלוראטוס	papafloratos
פאפוא	papua
פארקאס	farkas
פדלאן	fadlan
פוזי	posey
פוטוק	potok
פוטר	potter
פולאק	polak
פומיו	fumio
פונד	pond
פונטיין	fontaine
פוסטר	foster
פוספיך	pospech
פוצו	pozzo
פוקוי	fukui
פוקויאמא	fukuyama
פוקונישי	fukunishi
פורוג	forough
פורויא	furuya
פורטמאן	portman
פורי	faure
פורלונג	furlong
פידרלאין	federline
פיהר	fehr
פיט	piet
פיטרז	peters
פיי	fey
פייזון	faison
פיין	paine
פיישאנס	patience
פילופוניז	peloponnese
פילישא	felicia
פילסנר	felsner
פיסטוני	pistone
פיפר	pepper
פירדי	ferdi
פיריני	ferrini
פירינק	ferenc
פיש	fish
פלטייר	peltier
פליס	pless
פלמחים	palmachim
פנקוסט	pancoast
פסיירו	peseiro
פקרי	fekri
פראדיק	fradique
פראו	frau
פראיא	praia
פראנסס	francis
פראנקו	franco
פראסיודימיום	praseodymium
פרג'	faraj
פרוקופ	prokop
פרידי	freddy
פרליטו	ferlito
פרנאנדו	fernando
פרר	ferrer
פתחי	fathy
צ'ילמבי	chilembe
צ'יפולא	cipolla
צ'יפוליני	cipollini
צ'מראן	chamran
קאבאנא	cavanna
קאואסומי	kawasumi
קאופמאן	kaufman
קאטאיאמא	katayama
קאטאלינסקי	katalinski
קאטסוקי	katsuki
קאלאטש	kalac
קאלדירון	calderon
קאמפס	camps
קאן	cannes
קאנא	canna
קאנדר	kander
קאנטאבריא	cantabria
קאנטי	kante
קאניו	canio
קאניזאריס	canizares
קאסאי	kassai
קאסאנו	cassano
קאסטילא	castilla
קאסיראגי	casiraghi
קאסיריו	chasseriau
קאסם	qassem
קאפאק	capac
קאפארוני	capparoni
קאר	carr
קארלוביטש	karlovic
קארליבאך	carlebach
קארלסן	carlsen
קארמילו	carmelo
קאתי	kathy
קאתקארט	cathcart
קדירוב	kadyrov
קובינו	cobeno
קובריק	kubrick
קודג'ו	kodjo
קודי	cody
קודריא	codrea
קוזינקיביטש	kozynkevych
קוזמין	cosmin
קויבאס	cuevas
קויביק	quebec
קוים	quim
קוינטו	quinto
קויני	queeny
קוינסלאנד	queensland
קול	kohl
קולודזיטשאק	kolodziejczak
קולומבו	colombo
קולומבוס	columbus
קולין	colleen
קולינז	collins
קולמאר	colmar
קומאי	kumai
קומאר	kumar
קומורא	komora
קומפטון	compton
קונדול	coundoul
קונרז	connors
קוסטאנזא	costanza
קוסטאקורטא	costacurta
קוסמו	cosmo
קוסרי	cossery
קופור	kufuor
קורוסאוא	kurosawa
קוריגאן	corrigan
קורייר	corriere
קורילי	corelli
קורנל	kornel
קורסי	curci
קושי	koshi
קושניר	kushnir
קט	cat
קיוב	cube
קיוול	kewell
קיז	kees
קיטאג'ימא	kitajima
קייב	kiev
קינוק	kinnock
קיניניסא	kenenisa
קיראן	kieran
קירוס	kyros
קלאיסטרז	clijsters
קלאס	klas
קלוביס	clovis
קליבר	kleiber
קלינג	kling
קלינסמאן	klinsmann
קנזאבורו	kenzaburo
קציר	katzir
קראבילי	caravelli
קראיסלר	chrysler
קרבוניק	carbonic
קרוזן	kruzen
קרוידון	croydon
קרויף	cruyff
קריאטין	creatine
קרימי	karimi
קריסטוב	christov
קריסטובאל	cristobal
קרן	keren
ראבא	rabbah
ראגיב	raghib
ראדואנסקא	radwanska
ראול	raul
ראי	rai
ראיטש	reitsch
ראינר	rainer
ראמאז	ramaz
ראמאזוטי	ramazzotti
ראמון	ramon
ראש	rush
רוב	rob
רוברטסון	robertson
רוברידו	robredo
רוג	rogge
רוזאלינד	rosalind
רוזאנא	rossana
רוטלאנד	rutland
רוטסון	rotson
רולז	rawls
רומאנוס	romanos
רומולו	romulo
רומי	romi
רוני	roni
רושא	rocha
רותבארד	rothbard
רחמן	rahman
ריבאס	rivas
ריביסי	ribisi
ריוטארו	ryutaro
ריוקיצ'י	ryokichi
ריציטילי	rizzitelli
ריקא	rica
ריקדו	rikdo
רקס	rex
רתרפורד	rutherford
שאובו	shaobo
שאמס	shams
שאנון	shannon
שאקר	shaker
שארפ	sharpe
שוברט	schubert
שוירינג	scheuring
שולז	sholes
שוץ	schutz
שזר	shazar
שחק	shahak
שידיאק	chidiac
שילטון	shilton
שילקא	shilka
שינא	chynna
שינג'י	shinji
שינדלר	schindler
שיקיבו	shikibu
שירביוס	scherbius
שלוסברג	schlossberg
שמיר	shamir
שמעון	shimon
שפיק	shafiq
תיודוראקיס	theodorakis
תיודורוס	theodoros
