AACHEN	아헨
AARON	아론
AASEN	오센
ABADAN	아바단
ABBA	아바
ABBAS	아바스
ABBE	아베
ABBOTT	애버트
ABDUL	압둘
ABDULLAH	압둘라
ABDUS	압두스
ABEBE	아베베
ABEGG	아베그
ABEL	아벨
ABELL	아벨
ABERCROMBY	애버크롬비
ABERDEEN	애버딘
ABERNETHY	애버네시
ABIDJAN	아비장
ABIGAIL	애비개일
ABILENE	애빌린
ABIR	아비르
ABRAHAM	아브라함
ABRAM	아브람
ABRAMS	아브람스
ABREU	어브레우
ABRUZZI	아브루치
ABUJA	아부자
ACAPULCO	아카풀코
ACCRA	아크라
ACHARD	아샤르
ACHESON	애치슨
ACHILLES	아킬레스
ACHIM	아심
ACKERMANN	아커만
ACOSTA	아코스타
ACTON	액튼
ADA	에이더
ADALBERT	아달베르트
ADAM	아담
ADAMOV	아다모프
ADAMS	애덤스
ADANI	아다니
ADDAMS	애덤스
ADDINGTON	애딩턴
ADDISON	애디슨
ADEL	아델
ADELAIDE	애들레이드
ADEN	아덴
ADENAUER	아데나워
ADLER	아들러
ADOLF	아돌프
ADOLFO	아돌포
ADOLPHE	아돌프
ADONIS	아도니스
ADORNO	아도르노
ADRIAN	에이드리언
ADRIANO	아드리아노
ADRIENNE	에이드리엔
AFANASIEV	아파나시예프
AFGHANISTAN	아프가니스탄
AFRICA	아프리카
AGASSI	애거시
AGASSIZ	아가시
AGNELLI	아녤리
AGNES	아그네스
AGNEW	애그뉴
AGOSTINO	아고스티노
AGRICOLA	아그리콜라
AGRIPPA	아그리파
AGRIPPINA	아그리피나
AGUASCALIENTES	아과스칼리엔테스
AGUIRRE	아기레
AHERN	어헌
AHMAD	아마드
AHMADABAD	아마다바드
AHO	아호
AIKEN	에이킨
AILEEN	에일린
AITKEN	에이킨
AJACCIO	아작시오
AKBAR	아크바르
AKHMATOVA	아흐마토바
AKRON	애크런
ALABAMA	앨라배마
ALAIN	알랭
ALAMEDA	알러미다
ALAN	알란
ALASKA	알래스카
ALBA	알바
ALBAN	알반
ALBANI	알바니
ALBANIA	알바니아
ALBANO	알바노
ALBANY	올버니
ALBERS	알베르스
ALBERT	앨버트
ALBERTA	알바타
ALBERTI	알베르티
ALBERTO	알베르토
ALBERTVILLE	알베르빌
ALBINONI	알비노니
ALBRECHT	알브레히트
ALBUQUERQUE	앨버커키
ALDANOV	알다노프
ALDER	알더
ALDINGTON	올딩턴
ALDO	알도
ALDRIN	올드린
ALEC	앨릭
ALECSANDRI	알렉산드리
ALEJANDRO	알레한드로
ALEKSANDER	알렉산더
ALEKSANDR	알렉산드르
ALEKSEEV	알렉세예프
ALENCAR	알렌카르
ALESSANDRO	알레산드로
ALEX	알렉스
ALEXANDER	알렉산더
ALEXANDRA	알렉산드라
ALEXANDRE	알렉상드르
ALEXANDRIA	알렉산드리아
ALEXEI	알렉세이
ALEXIS	알렉시
ALF	알프
ALFA	알파
ALFIERI	알피에리
ALFONS	알폰스
ALFONSIN	알폰신
ALFONSO	알폰소
ALFORD	알포드
ALFRED	앨프레드
ALFREDO	알프레도
ALGECIRAS	알헤시라스
ALGER	알제
ALGERIA	알제리
ALGIERS	알제
ALGREN	올그런
ALI	알리
ALICE	엘리스
ALISON	앨리슨
ALLAH	알라
ALLAN	앨런
ALLARD	알라드
ALLEN	알렌
ALLENDE	아옌데
ALLENTOWN	알렌타운
ALLON	알론
ALMA	알마
ALMEIDA	알메이다
ALMQVIST	알름크비스트
ALOYSIUS	알루아시우스
ALPHONSE	알퐁스
ALPHONSO	알폰소
ALSTON	엘스톤
ALT	알트
ALTAMIRA	알타미라
ALTENBERG	알텐베르크
ALTHUSSER	알튀세르
ALTISSIMO	알티시모
ALTMAN	올트먼
ALTON	알톤
ALVA	알바
ALVARES	알바레스
ALVAREZ	앨버레즈
ALVARO	알바로
ALVIN	앨빈
AMADO	아마도
AMALIA	아말리아
AMANDA	아만다
AMARA	아마라
AMATO	아마토
AMAZON	아마존
AMBER	앰버
AMBLER	앰블러
AMBROSE	앰브로즈
AMBROSIUS	암브로시우스
AMELIA	아멜리아
AMERICA	아메리카
AMES	에임스
AMIEL	아미엘
AMIENS	아미앵
AMIN	아민
AMIR	아미르
AMMAN	암만
AMMON	아몬
AMON	아몬
AMONTONS	아몽통
AMOS	아모스
AMRITSAR	암리차르
AMSTERDAM	암스테르담
AMUNDSEN	아문젠
AMY	에이미
AMYOT	아미요
ANA	아나
ANAHEIM	애너하임
ANATOLE	아나톨
ANATOLIA	아나톨리아
ANCHORAGE	앵커리지
ANCONA	안코나
ANDALUSIA	안달루시아
ANDERS	안데르스
ANDERSEN	안데르센
ANDERSON	앤더슨
ANDERSSON	안데르손
ANDERTON	안더톤
ANDES	안데스
ANDORRA	안도라
ANDRE	안드레
ANDREA	안드레아
ANDREAS	안드레아스
ANDREEV	안드레예프
ANDREI	안드레이
ANDREOTTI	안드레오티
ANDRES	안드레스
ANDREW	안드레
ANDREWS	앤드루스
ANDRI	안드리치
ANDROPOV	안드로포프
ANDRZEJ	안제이
ANDRZEJEWSKI	안제예프스키
ANDY	앤디
ANFINSEN	안핀슨
ANGARA	안가라
ANGEL	엔젤
ANGELA	앙겔라
ANGELES	엔젤레스
ANGELIKA	앙겔리카
ANGELL	에인절
ANGELO	안젤로
ANGELOU	앤젤루
ANGLE	앵글
ANGOLA	앙골라
ANGORA	앙고라
ANGUS	앵거스
ANIBAL	아니발
ANITA	아니타
ANKARA	앙카라
ANKRAH	안크라
ANN	앤
ANNA	안나
ANNABEL	아나벨
ANNAPOLIS	아나폴리스
ANNE	안네
ANNEMARIE	아네마리
ANNETTE	아네트
ANOUILH	아누이
ANSEL	언셀
ANSERMET	앙세르메
ANSON	앤슨
ANSTEY	앤스티
ANTAL	앤탈
ANTANANARIVO	안타나나리보
ANTE	안테
ANTELAMI	안텔라미
ANTHONY	안토니오
ANTOINE	앙투안
ANTON	안톤
ANTONESCU	안토네스쿠
ANTONIN	안토닌
ANTONINA	안토니나
ANTONIO	안토니오
ANTONIUS	안토니우스
ANTONOV	안토노프
ANTWERP	앤트워프
ANWAR	안와르
ANWARI	안와리
ANZENGRUBER	안첸그루버
APELT	아펠트
APHRA	애프라
APIA	아피아
APOLLINAIRE	아폴리네르
APOLLO	아폴로
APPALACHIA	아파라치아
APPEL	아펠
APPENZELLER	아펜젤러
APPERT	아페르
APPIA	아피아
APPLETON	애플턴
APTIDON	압티돈
AQUINO	아키노
ARAB	아랍
ARAD	아라드
ARAGO	아라고
ARAGON	아라곤
ARAM	아람
ARBER	아르버
ARBOLEDA	아르볼레다
ARBOS	아르보스
ARBUZOV	아르부조프
ARCE	아르세
ARCOS	아르코스
ARDEN	아든
ARDENNES	아르덴
ARENAS	아레나스
ARETINO	아레티노
ARGENTINA	아르헨티나
ARGHEZI	아르게지
ARI	애리
ARIE	아리에
ARIEL	아리엘
ARIOSTO	아리오스토
ARIZONA	애리조나
ARKANSAS	아칸소
ARLINGTON	알링턴
ARMAND	아르망
ARMANDO	아르만도
ARMENIA	아르메니아
ARMINIUS	아르미니우스
ARMSTRONG	암스트롱
ARNALDO	아르날도
ARNAULD	아르노
ARNDT	아른트
ARNE	아르네
ARNHEM	아른헴
ARNIM	아르님
ARNO	아르노
ARNOLD	아놀드
ARNOLDSON	아르놀드손
ARON	아롱
ARP	아르프
ARRHENIUS	아레니우스
ARROYO	아로요
ARTHER	아서
ARTHUR	아르투르
ARTIGAS	아르티가스
ARTSYBASHEV	아르치바셰프
ARTURO	아르투로
ARUBA	아루바
ARVID	아르비드
ASA	아사
ASAM	아잠
ASCH	애쉬
ASH	애쉬
ASHCROFT	애슈크로프트
ASHER	아셀
ASHKENAZI	아시케나지
ASHKHABAD	아슈하바트
ASHLEY	애슐리
ASHRAF	아슈라프
ASHTON	애슈턴
ASIA	아시아
ASIMOV	아시모프
ASKE	아스케
ASLAN	아슬란
ASMARA	아스마라
ASPINALL	아스피날
ASQUITH	애스퀴스
ASSAD	아사드
ASSER	아세르
ASTANA	아스타나
ASTLEY	애스틀리
ASTON	애스턴
ASTRAKHAN	아스트라한
ASTURIAS	아스투리아스
ASUNCION	아순시온
ATAHUALPA	아타왈파
ATHABASCA	애서배스카
ATHANASIUS	아타나시우스
ATHENS	아테네
ATHOS	에이소스
ATLANTA	애틀랜타
ATLAS	아틀라스
ATTAR	애타
ATTENBOROUGH	애튼버러
ATTWOOD	애투드
ATWOOD	애투드
AUBERT	오베르
AUBREY	오브리
AUCKLAND	오클랜드
AUDEN	오든
AUDREY	오드리
AUDUBON	오듀본
AUER	아우어
AUERBACH	아우어바흐
AUGUST	아우구스트
AUGUSTA	오거스타
AUGUSTIN	오구스틴
AUGUSTINE	어거스틴
AUGUSTO	아우구스토
AUGUSTUS	아우구스투스
AUKEN	아우켄
AURIOL	오리올
AURORA	아우로라
AUSTEN	오스틴
AUSTERLITZ	아우스터리츠
AUSTIN	오스틴
AUSTRALIA	오스트레일리아
AUSTRIA	오스트리아
AVA	에바
AVELLANEDA	아베야네다
AVENARIUS	아벤나리우스
AVERY	에버리
AVOGADRO	아보가드로
AVRAHAM	아브라함
AVVAKUM	아바쿰
AXEL	악셀
AXELROD	액설로드
AYLWIN	아일윈
AZERBAIJAN	아제르바이잔
AZHARI	아자리
BAADE	바데
BAAL	바알
BABBAGE	배비지
BABBITT	바비트
BABCOCK	뱁콕
BABE	베이브
BABEUF	바뵈프
BABS	밥스
BABSON	뱁슨
BABYLON	바빌론
BACCELLI	바셀리
BACCHUS	바커스
BACH	바흐
BACHELARD	바슐라르
BACKHAUS	바크하우스
BACON	베이컨
BADAJOZ	바다호스
BADEN	바덴
BAEKELAND	베이클랜드
BAER	베어
BAFFIN	배핀
BAGEHOT	배젓
BAGHDAD	바그다드
BAHAR	바하르
BAHR	바르
BAHRAIN	바레인
BAIER	바이어
BAILEY	베일리
BAINBRIDGE	베인브리지
BAIRD	베어드
BAJER	바예르
BAKER	베이커
BAKERSFIELD	베커즈필드
BAKHTIN	바흐친
BAKST	박스트
BAKU	바쿠
BAKUNIN	바쿠닌
BALAS	발라스
BALBOA	발보아
BALCH	볼치
BALDUNG	발둥
BALDUS	발두스
BALDWIN	볼드윈
BALENCIAGA	발렌시아가
BALES	베일즈
BALFOUR	발푸어
BALI	발리
BALL	볼
BALLARD	발라드
BALMER	발머
BALTIMORE	볼티모어
BALZAC	발자크
BAMAKO	바마코
BAMBER	뱀버
BAMBERGER	뱀버거
BANACH	바나흐
BANDARANAIKE	반다라나이케
BANDEIRA	반데이라
BANDELLO	반델로
BANG	방
BANGALORE	방갈로르
BANGEMANN	방게만
BANGKOK	방콕
BANGLADESH	방글라데시
BANGUI	방기
BANJUL	반줄
BANKS	뱅크스
BANTING	밴팅
BANVILLE	방빌
BARBADOS	바베이도스
BARBARA	바버라
BARBER	바버
BARCELONA	바르셀로나
BARDEEN	바딘
BARDEM	바뎀
BARENTS	바렌츠
BARI	바리
BARKLEY	바클리
BARLACH	바를라흐
BARLETTA	바를레타
BARMEN	바르멘
BARNABY	바르나비
BARNARD	바너드
BARNES	바네즈
BARON	바론
BARONE	바로네
BARRANQUILLA	바랑키야
BARRE	바레
BARRETT	바렛
BARRIE	배리
BARRIOS	바리오스
BARROSO	바로수
BARRY	배리
BARRYMORE	베리모어
BARSTOW	바르스토우
BART	바트
BARTH	바르트
BARTHES	바르트
BARTLETT	바틀릿
BARTLEY	바트리
BARTOLOMMEO	바르톨롬메오
BARTON	바턴
BARUCH	바루크
BASEL	바젤
BASIE	베이시
BASIL	배절
BASIN	바신
BASOV	바소프
BASQUE	바스크
BASRA	바스라
BASS	배스
BASSETERRE	바스테르
BASSETT	바셋
BAST	바스트
BASTIAN	바스티안
BASU	바수
BATAILLE	바타유
BATCHELOR	배첼러
BATES	베이츠
BATESON	베이트슨
BATH	바스
BATMAN	배트맨
BATONI	바토니
BATTLE	배틀
BATY	바티
BATYUSHKOV	바튜슈코프
BAUCUS	바크스
BAUER	바우어
BAUMEISTER	바우마이스터
BAUMGARTEN	바움가르텐
BAUSCH	바우슈
BAUTISTA	바티스타
BAXTER	백스터
BAYARD	바야르
BAYER	바이어
BAYLE	벨
BAYLEY	베이레이
BAYLOR	배일러
BAYONNE	바욘느
BAYREUTH	바이로이트
BAZIN	바쟁
BEADLE	비들
BEAR	베아
BEARD	비어드
BEARDSLEY	비어즐리
BEATRICE	베아트리체
BEATRIX	베아트릭스
BEATTIE	비티
BEATTY	비티
BEAUCHAMP	보샹
BEAUFORT	보퍼트
BEAUMARCHAIS	보마르셰
BEAUMONT	바몬트
BEAUVOIR	보부아르
BEAVERBROOK	비버브룩
BEBEL	베벨
BECHER	베허
BECKENBAUER	베켄바우어
BECKER	베커
BECKET	베케트
BECKETT	베케트
BECKMANN	베크만
BECKY	베키
BEDDOES	베도스
BEDFORD	베드퍼드
BEDNORZ	베드노르츠
BEECHAM	비첨
BEERNAERT	베르나르트
BEETS	베츠
BEGIN	베긴
BEHAIM	베하임
BEHN	벤
BEHRENS	베렌스
BEHRING	베링
BEHRMAN	베어먼
BEILA	베이라
BEIQI	베이치
BEIRUT	베이루트
BELARUS	벨로루시
BELASCO	벨라스코
BELCHER	벨처
BELFAST	벨파스트
BELFORT	벨포
BELGIUM	벨기에
BELGRADE	벨그라드
BELIAEV	벨리아에프
BELIZE	벨리즈
BELL	벨
BELLAMY	벨러미
BELLEVUE	벨레뷰
BELLMAN	벨만
BELLOC	벨록
BELLOW	벨로
BELMOPAN	벨모판
BEN	벤
BENACERRAF	베나세라프
BENARES	베나레스
BENAVIDES	베나비데스
BENDA	방다
BENDIX	벤딕스
BENEDETTO	베네데토
BENEDICT	베네딕트
BENGHAZI	벵가지
BENGT	벵트
BENIGNO	베니그노
BENIN	베냉
BENITEZ	베니테즈
BENITO	베니토
BENJAMIN	뱅자맹
BENN	벤
BENNETT	베넷
BENNY	베니
BENSON	벤슨
BENTHAM	벤담
BENTINCK	벤팅크
BENTON	벤턴
BENVENUTO	벤베누토
BENZ	벤츠
BERCHEM	버쳄
BEREGOVOY	브르고부아
BERENGER	베린저
BERENSON	베런슨
BERG	버그
BERGEN	베르겐
BERGENGRUEN	베르겐그륀
BERGER	버거
BERGERON	베르예론
BERGIUS	베르기우스
BERGMAN	버그먼
BERGMANN	베르크만
BERGSON	베르그송
BERING	베링
BERKELEY	바클리
BERKSHIRE	바크셔
BERLAGE	베를라헤
BERLIN	베를린
BERLIOZ	베를리오즈
BERMAN	버만
BERN	베른
BERNADETTE	버나데트
BERNAL	버널
BERNANOS	베르나노스
BERNARD	버나드
BERNARDINO	베르나르디노
BERNARDO	베르나르도
BERNAUER	베르나워
BERND	베른트
BERNE	베른
BERNHARD	번하드
BERNHARDT	베르나르
BERNHEIM	베른하임
BERNIER	베르니에
BERNOULLI	베르누이
BERNSTEIN	번스타인
BERRY	베리
BERT	베르트
BERTEL	베르텔
BERTHOLD	베르톨트
BERTI	베르디
BERTIE	버티
BERTIL	베르틸
BERTIN	베르탱
BERTINI	버티니
BERTO	베르토
BERTRAM	베르트람
BERTRAND	베르트랑
BERWICK	베릭
BERZELIUS	베르셀리우스
BESANCON	브장송
BESSARABIA	베사라비아
BESSEL	베셀
BESSEMER	베세머
BESSIE	베시
BETHE	베테
BETHEL	베델
BETHELL	베델
BETHESDA	베데스다
BETHLEHEM	베들레헴
BETJEMAN	베처먼
BETTINO	베티노
BETTY	베티
BEUST	보이스트
BEUYS	보이스
BEVAN	베번
BEVERIDGE	베버리지
BEVERLEY	베벌리
BEVERLY	비버리
BEVIN	베빈
BEYER	바이어
BEZA	베자
BHUTAN	부탄
BIAGIO	비아지오
BIAS	비아스
BIBER	비버
BIBLE	바이블
BIDDLE	비들
BIDEN	바이든
BIDWELL	비드웰
BIEBER	비버
BIENVILLE	비엔빌
BIHAR	비하르
BIKILA	비킬라
BILBAO	빌바오
BILL	빌
BILLINGS	빌링스
BILLY	빌리
BILOXI	빌록시
BINDER	바인더
BINDING	빈딩
BINET	비네
BING	빙
BINGHAM	빙햄
BINOCHE	비노슈
BINSWANGER	빈스방거
BINYON	비니언
BION	비온
BIRKHOFF	버코프
BIRMINGHAM	버밍엄
BISHKEK	비슈케크
BISHOP	비숍
BISMARCK	비즈마크
BISSAU	비사우
BISSET	비셋
BIYA	비야
BIZET	비제
BJERKNES	비에르크네스
BJORK	비요크
BJORKLUND	비요르크룬트
BLACHE	블라슈
BLACK	블랙
BLACKBURN	블랙번
BLACKETT	블래킷
BLACKPOOL	블랙풀
BLACKSTONE	블랙스톤
BLACKWELL	블랙웰
BLAGA	블라가
BLAINE	블레인
BLAIR	블레어
BLAKE	블레이크
BLAKESLEE	블레이크슬리
BLANC	블랑
BLANCHARD	블랑샤르
BLANCHE	블랑쉬
BLANCO	블랑코
BLAND	블랜드
BLANQUI	블랑키
BLASS	브레스
BLINDER	블라인더
BLIXEN	블릭센
BLOCH	블로크
BLOCK	블록
BLOEMFONTEIN	블룸폰테인
BLOK	블로크
BLOOMBERG	블룸버그
BLOOMFIELD	블룸필드
BLOOMINGTON	블루밍턴
BLOUNT	블라우트
BLUFF	블러프
BLUMBERG	블럼버그
BLUMENBACH	블루멘바흐
BLUNDEN	블런던
BLY	블라이
BO	보
BOAS	보애스
BOB	밥
BOBBY	보비
BOCAGE	보카제
BOCCACCIO	보카치오
BOCCHERINI	보케리니
BOCCIONI	보초니
BODE	보데
BODIN	보댕
BODO	보도
BOER	보어
BOERHAAVE	부르하페
BOERNER	뵈르너
BOETHIUS	보이티우스
BOGARDE	보가드
BOGHOSSIAN	보고시앙
BOGOMOLOV	보고모로프
BOGOTA	보고타
BOHEMIA	보헤미아
BOHR	보어
BOHUSLAV	보후슬라프
BOILEAU	부알로
BOISE	보이시
BOJER	보예르
BOLIVIA	볼리비아
BOLKIAH	볼키아
BOLTON	볼턴
BOLZANO	볼차노
BONAPARTE	보나파르트
BONDI	본디
BONDS	본즈
BONGO	봉고
BONHAM	본햄
BONHOEFFER	본회퍼
BONN	본
BONNARD	보나르
BONNER	보너
BONNET	보네
BONNEVILLE	보네빌
BONNEY	보니
BONNICI	보니치
BONOMI	보노미
BONSELS	본젤스
BONTEMPELLI	본템펠리
BOOLE	불
BOOTH	부드
BOOTHROYD	부스로이드
BOPHUTHATSWANA	보프타츠와나
BOPP	보프
BORCHARDT	보르하르트
BORCHERT	보르헤르트
BORDEAUX	보르도
BORGE	보르그
BORGES	보르헤스
BORGIA	보르자
BORING	보링
BORIS	보리스
BORJA	보르하
BORLAUG	볼로그
BORN	보른
BORODIN	보로딘
BORROW	보로
BORST	보르스트
BOSANQUET	보상케
BOSCH	보슈
BOSE	보스
BOSSUET	보쉬에
BOSTIC	보스틱
BOSTON	보스턴
BOSWELL	보즈웰
BOSWORTH	보즈워스
BOTH	보스
BOTHA	보타
BOTHE	보테
BOTSFORD	보츠포드
BOTSWANA	보츠와나
BOTTICELLI	보티첼리
BOUCHARD	부샤르
BOUCHER	바우처
BOUGAINVILLE	부건빌
BOUILLON	부이용
BOULANGER	불랑제
BOULDER	보울더
BOULT	보울트
BOURGEOIS	부르주아
BOURGET	부르제
BOURKE	보크
BOURNE	본
BOURNONVILLE	부르농빌
BOUSSINESQ	부스네스크
BOUTS	보츠
BOVERI	보베리
BOVET	보베
BOWDEN	보우덴
BOWDLER	보들러
BOWEN	보엔
BOWIE	보위
BOWKER	보우커
BOWLES	볼스
BOWMAN	보먼
BOWRING	보우링
BOWYER	바우어
BOYCE	보이스
BOYE	보위에
BOYER	보이어
BOYLE	보일
BRACTON	브랙턴
BRAD	브래드
BRADBURY	브래드버리
BRADFORD	브레드포드
BRADLEY	브래들리
BRADSTREET	브래드스트리트
BRADY	브래디
BRAGG	브래그
BRAHAM	브래험
BRAHM	브람
BRAHMS	브람스
BRAINE	브레인
BRAM	브람
BRAND	브랜드
BRANDENBURG	브란덴부르크
BRANDES	브라데스
BRANDON	브랜던
BRANDT	브란트
BRANGWYN	브랭귄
BRANNER	브라네르
BRANT	브란트
BRANTING	브란팅
BRASILIA	브라질리아
BRASSENS	브라상스
BRASSEUR	브라쇠르
BRATISLAVA	브라티슬라바
BRATTAIN	브래튼
BRATTELI	브라텔리
BRAUN	브라운
BRAUNS	브론즈
BRAZIL	브라질
BRAZZAVILLE	브라자빌
BRECHT	브레히트
BREMEN	브레멘
BREMER	브레메르
BREMERHAVEN	브레머하펜
BRENAN	브레넌
BRENDA	브렌다
BRENDAN	브렌던
BRENDEL	브렌델
BRENT	브렌트
BRENTANO	브렌타노
BRESCIA	브레시아
BRET	브렛
BRETON	브레튼
BRETT	브레트
BREUER	브로이어
BREYER	브레이어
BREZHNEV	브레주네프
BRIAN	브라이언
BRIAND	브리앙
BRIDGEPORT	브리지포트
BRIDGETOWN	브리지타운
BRIDIE	브라이디
BRIGGS	브리그스
BRIGHT	브라이트
BRIGHTMAN	브라이트만
BRIGHTON	브라이튼
BRIGITTE	브리짓
BRINDLEY	브린들리
BRISBANE	브리즈번
BRISCOE	브리스코
BRISTOL	브리스틀
BRITTAN	브리튼
BRITTEN	브리튼
BRNO	브르노
BROADBENT	브로드벤트
BROADWAY	브로드웨이
BROCH	브로흐
BROCKMAN	브로크만
BRODSKY	브로드스키
BRODY	브로디
BROGLIE	브로글리
BROMFIELD	브롬필드
BROMLEY	브롬리
BRONTE	브론테
BRONZINO	브론치노
BROOK	브룩
BROOKE	브룩
BROOKES	브룩스
BROOKINGS	브루킹스
BROOKLYN	브루클린
BROOKS	브룩스
BROWN	브라운
BROWNE	브라운
BROWNING	브라우닝
BRUANT	브뤼앙
BRUCE	브루스
BRUCH	브루흐
BRUCKNER	브루크너
BRUIN	브륀
BRUNAT	브뤼나
BRUNDAGE	브런디지
BRUNDTLAND	브룬틀란
BRUNEI	브루나이
BRUNEL	브루넬
BRUNI	브루니
BRUNNER	브루너
BRUNO	브루노
BRUSSELS	브뤼셀
BRUTUS	브루투스
BRYAN	브라이언
BRYANT	브라이언트
BRYCE	브라이스
BRYNNER	브리너
BRYULLOV	브률로프
BRYUSOV	브류소프
BRZEZINSKI	브레진스키
BUBER	부버
BUCH	부흐
BUCHANAN	뷰캐넌
BUCHAREST	부카레스트
BUCHENWALD	부헨발트
BUCHNER	부흐너
BUCK	펄
BUCKINGHAMSHIRE	버킹엄셔
BUCKLE	버클
BUDAPEST	부다페스트
BUFFALO	버펄로
BUFFON	뷔퐁
BUFORD	버포드
BUHARI	부하리
BUISSON	뷔송
BUJUMBURA	부줌부라
BUKHARIN	부하린
BULGAKOV	불가코프
BULGANIN	불가닌
BULGARIA	불가리아
BULLOCK	불럭
BUNCHE	번치
BUNDY	번디
BUNIN	부닌
BUNSEN	분젠
BUNYAN	번얀
BUONARROTI	부오나로티
BURBANK	버뱅크
BURCKHARDT	부르크하르트
BURDIN	버딘
BURG	부르그
BURGER	버거
BURGUNDY	부르고뉴
BURIDAN	뷔리당
BURKE	버크
BURLINGTON	버링톤
BURMA	버마
BURMAN	버마
BURNET	버넷
BURNETT	버넷
BURNEY	버니
BURNHAM	번햄
BURNS	번스
BURR	버
BURROUGHS	버로스
BURROWS	버로우즈
BURSTEIN	버스타인
BURTON	버턴
BURUNDI	부룬디
BURY	버리
BUSBY	버스비
BUSCH	부슈
BUSH	부시
BUSHMAN	부시먼
BUSIA	부시아
BUSONI	부소니
BUSSE	부세
BUSWELL	버스웰
BUTENANDT	부테난트
BUTLER	버틀러
BUTTE	뷰트
BUTTERFIELD	버터필드
BUTTERWORTH	버터워스
BUXTEHUDE	북스테후데
BYELORUSSIA	벨로루시
BYERS	바이어스
BYRD	버드
BYRNE	번
BYRNES	번스
BYRON	바이런
CABELL	캐벌
CABOT	캐벗
CABRAL	카브랄
CABRERA	카브레라
CACERES	카세레스
CADILLAC	캐딜락
CADIZ	카디스
CAEN	캉
CAESAR	시저
CAETANO	까에따누
CAGE	케이지
CAGLIARI	칼리아리
CAIN	카인
CAINE	케인
CAIRD	케어드
CAIRNES	케언스
CAIRNS	케인즈
CAIRO	카이로
CAJORI	카조리
CALAIS	칼레
CALCUTTA	캘커타
CALDECOTT	콜더컷
CALDER	콜더
CALDERON	깔데론
CALDERWOOD	칼더우드
CALDWELL	콜드웰
CALFA	찰파
CALGARY	캘거리
CALHOUN	칼훈
CALI	칼리
CALIFORNIA	캘리포니아
CALVIN	칼뱅
CALVINO	칼비노
CALYPSO	칼립소
CAMARA	카마라
CAMARGO	카마르고
CAMBIASO	캄비아소
CAMBODIA	캄보디아
CAMBRIDGE	케임브리지
CAMDEN	캠던
CAMDESSUS	캉드쉬
CAMERARIUS	카메라리우스
CAMERON	캐머런
CAMEROON	카메룬
CAMILLA	카밀라
CAMILLE	카미유
CAMILLO	카밀로
CAMILO	카밀로
CAMPANELLA	캄파넬라
CAMPBELL	캠벨
CAMPER	캄페르
CAMPIGLI	캄필리
CAMPO	캄포
CAMPOS	캄푸스
CAMPRA	캉프라
CAMUS	카뮈
CANADA	캐나다
CANADIAN	캐나디안
CANALETTO	카날레토
CANARO	카나로
CANBERRA	캔버라
CANDELA	캉델라
CANDICE	캔디스
CANDOLLE	캉돌
CANETTI	카네티
CANNING	캐닝
CANNON	캐넌
CANOVA	카노바
CANTERBURY	캔터베리
CANTH	칸트
CANTON	광둥
CANTOR	칸토어
CAPA	카파
CAPLET	캐플릿
CAPONE	카포네
CAPOTE	커포티
CAPRA	캐프라
CAPRI	카프리
CAPRIVI	카프리비
CAPUANA	카푸아나
CAPUTO	카푸토
CARACAS	카라카스
CARAGIALE	카라지알레
CARAVAGGIO	카라바조
CARD	카드
CARDANO	카르다노
CARDENAS	카르데나스
CARDIFF	카디프
CARDINAL	카디날
CARDINALE	카르디날레
CARDUCCI	카르두치
CAREY	케리
CARL	카를
CARLEY	칼리
CARLISLE	칼라일
CARLO	카를로
CARLOS	카를로스
CARLSON	칼슨
CARLSSON	칼손
CARLYLE	칼라일
CARMEL	카르멜
CARMEN	카르멘
CARMICHAEL	카마이클
CARMONA	카모나
CARNAP	카르납
CARNARVON	카나본
CARNEGIE	카네기
CARNEY	카니
CARNOT	카르노
CARO	카로
CAROL	캐럴
CAROLE	캐롤
CAROLINA	캐롤라이나
CAROLINE	캐롤라인
CAROLYN	캐럴린
CAROTHERS	캐러더스
CARPACCIO	카르파초
CARPENTER	카펜터
CARPENTIER	카르펜티에르
CARPINI	카르피니
CARR	카
CARRERA	카레라
CARRINGTON	캐링턴
CARROLL	캐롤
CARRY	케어리
CARSON	카슨
CARTAGENA	카르타헤나
CARTAN	카르탕
CARTER	카터
CARTIER	카르티에
CARTWRIGHT	카트라이트
CARUSO	카루소
CARVALHO	카르발료
CARVER	카버
CARY	캐리
CASABLANCA	카사블랑카
CASADESUS	카자드쥐
CASALS	카살스
CASANOVA	카사노바
CASELLA	카셀라
CASEY	케이시
CASH	캐시
CASPER	캐스퍼
CASSANDRA	카산드라
CASSANDRE	카상드르
CASSEL	카셀
CASSELL	카셀
CASSIDY	캐시디
CASSIN	카생
CASSINI	카시니
CASSOU	카수
CASTIGLIANO	카스틸리아노
CASTIGLIONE	카스틸리오네
CASTLEREAGH	캐슬레이
CASTRIES	캐스트리스
CASTRO	카스트로
CATALONIA	카탈로니아
CATANIA	카타니아
CATE	케이트
CATES	케이츠
CATHER	캐더
CATHERINE	카트린
CATHY	캐시
CATILINA	카틸리나
CATO	카토
CATON	케이튼
CATTELL	커텔
CAUCASUS	코카서스
CAUCHY	코시
CAVAIGNAC	카베냐크
CAVALCANTI	카발칸티
CAVENDISH	캐번디시
CAVOUR	카보우르
CAXIAS	카시아스
CAYENNE	카옌
CECCHETTI	체케티
CECH	체크
CECIL	세실
CECILIA	세실리아
CEDRIC	세드릭
CELAN	첼란
CELIA	셀리아
CELLINI	첼리니
CELSO	세르소
CENDRARS	상드라르
CENNINI	첸니니
CERVANTES	세르반테스
CESALPINO	체살피노
CESARE	체사레
CESAROTTI	체사로티
CEYLON	실론
CHABRIER	샤브리에
CHAD	차드
CHADWICK	채드윅
CHAGALL	샤갈
CHAIM	카임
CHAIN	체인
CHAMAI	차마이
CHAMBERLAIN	체임벌린
CHAMBERLIN	체임벌린
CHAMBERS	체임버스
CHAMISSO	샤미소
CHAMORRO	차모로
CHAMPAIGNE	상파뉴
CHAMPLAIN	샹플랭
CHAMPOLLION	샹폴리옹
CHAMSON	샹송
CHAN	챈
CHANDLER	챈들러
CHANDRA	찬드라
CHANDRASEKHAR	찬드라세카르
CHANEL	샤넬
CHAO	차오
CHAPLIN	채플린
CHAPMAN	채프먼
CHAPPE	샤프
CHAPSAL	샤프살
CHAPTAL	샤프탈
CHARDONNE	샤르돈
CHARLES	찰스
CHARLESTON	찰스턴
CHARLIE	찰리
CHARLOTTE	샬럿
CHARLOTTETOWN	샬럿타운
CHARLTON	찰턴
CHARPENTIER	샤르팡티에
CHATEAUBRIAND	샤토브리앙
CHATTANOOGA	채터누가
CHATTERJEE	차터지
CHATTERTON	채터턴
CHAUCER	초서
CHAUMONT	쇼몽
CHAUNCEY	첸시
CHAUSSON	쇼송
CHAUTEMPS	쇼탕
CHAVEZ	차베스
CHEDDAR	체더
CHEKHOV	체호프
CHELMSFORD	첼름스퍼드
CHEMNITZ	켐니츠
CHENEY	체니
CHERENKOV	체렌코프
CHERNENKO	체르넨코
CHERNOV	체르노프
CHERRY	체리
CHESHIRE	체셔
CHESS	체스
CHESTER	체스터
CHESTERFIELD	체스터필드
CHESTERTON	체스터턴
CHEVALIER	슈발리에
CHEVROLET	시보레
CHEYENNE	샤이엔
CHIANTI	칸티
CHICAGO	시카고
CHICHESTER	치체스터
CHILDE	차일드
CHILE	칠레
CHIPMAN	치프먼
CHIPPENDALE	치펜데일
CHISINAU	치시나우
CHISSANO	시사노
CHOISEUL	쇼아줄
CHOMSKY	촘스키
CHOPIN	쇼팽
CHOPRA	초프라
CHRIS	크리스
CHRIST	구세주
CHRISTA	크리스
CHRISTCHURCH	크라이스트처치
CHRISTENSON	크리스턴슨
CHRISTIAN	크리스천
CHRISTIE	크리스티
CHRISTINA	크리스티나
CHRISTOPHE	크리스토프
CHRISTOPHER	크리스토퍼
CHURCHILL	처칠
CHUVASH	추바슈
CIAMPI	참피
CIANO	치아노
CICERO	키케로
CIENFUEGOS	시엔푸에고스
CIGNA	시그나
CINCINNATUS	킨키나투스
CINDY	신디
CIRIACO	크리아코
CLAES	클라스
CLAPEYRON	클라페롱
CLARA	클라라
CLARENCE	클래런스
CLARENDON	클래런던
CLARK	클라크
CLAUDE	클라우데
CLAUDIA	클라우디아
CLAUDIO	클라우디오
CLAUDIUS	클라우디우스
CLAUS	클라우스
CLAUSEN	클로젠
CLAUSEWITZ	클라우제비츠
CLAUSIUS	클라우지우스
CLAXTON	클렉스턴
CLAYTON	클레이턴
CLEARWATER	클리어워터
CLEMENS	클레멘스
CLEMENTI	클레멘티
CLEMENTS	클레먼츠
CLEVE	클레베
CLEVELAND	클리블랜드
CLIFFORD	클리퍼드
CLIFTON	클리프턴
CLINTON	클린턴
CLIVE	클라이브
CLOUGH	클라프
CLOUZOT	클루조
COBALT	코발트
COBURN	코번
COCHET	코쉐
COCHIN	코친
COCHRANE	코크런
COHAN	코핸
COHEN	코언
COHN	콘
COIGNET	코와니에
COIMBRA	코임브라
COITER	코이터
COKER	코커
COLBERT	콜베르
COLE	콜
COLEMAN	콜맨
COLERIDGE	콜리지
COLETTE	콜레트
COLGATE	콜게이트
COLIN	콜랭
COLLETT	콜레트
COLLIER	콜리어
COLLIN	콜린
COLLINS	콜린스
COLMAN	콜먼
COLMAR	콜마르
COLOGNE	쾰른
COLOMBIA	콜롬비아
COLOMBO	콜롬보
COLORADO	콜로라도
COLT	콜트
COLUMBIA	컬럼비아
COLUMBUS	콜럼버스
COMENIUS	코메니우스
COMMONS	코먼스
COMO	코모
COMOROS	코모로
COMPTON	콤프턴
COMTE	콩트
CONAKRY	코나크리
CONCEPCION	콘셉시온
CONCORD	콩코드
CONDILLAC	콩디야크
CONDORCET	콩도르세
CONGO	콩고
CONNAUGHT	코넛
CONNECTICUT	코네티컷
CONNELLY	코널리
CONNOLLY	코널리
CONNOR	코너
CONRAD	콘래드
CONSTANCE	콘스탄스
CONSTANT	콩스탕
CONSTANTIN	콘스탄틴
CONSTANTINE	콩스탕틴
CONSTANTINESCU	콘스탄티네스쿠
CONTE	콩테
CONTI	콘티
COOLIDGE	쿨리지
COOPER	쿠퍼
COPE	코프
COPENHAGEN	코펜하겐
COPERNICUS	코페르니쿠스
COPLAND	코플랜드
COPPOLA	코플라
CORAL	코롤
CORBIN	코빈
CORNEILLE	코르네유
CORNELIO	코르넬리오
CORNELIS	코르넬리스
CORNELIUS	코르넬리우스
CORNELL	코넬
CORNFORTH	콘포스
CORNWALL	콘월
CORNWELL	콘월
CORRADI	코라디
CORSICA	코르시카
CORTONA	코르토나
COSSA	코사
COTTBUS	콧부스
COUBERTIN	쿠베르탱
COUNT	카운트
COUPERIN	쿠프랭
COUPLET	쿠플레
COURNOT	쿠르노
COURTELINE	쿠르틀린
COURTOIS	쿠르투아
COUSIN	쿠쟁
COUTO	코투
COVENTRY	코번트리
COVINGTON	코빙턴
COWPER	쿠퍼
COX	콕스
CRABBE	크래브
CRAIG	크레이그
CRAM	크램
CRANACH	크라나흐
CRANE	크레인
CRASHAW	크래쇼
CRAWFORD	크로퍼드
CREMER	크리머
CREMONA	크레모나
CRESPO	크레스포
CRESSENT	크레상
CRESSON	크레송
CRISPI	크리스피
CRISPIN	크리스피누스
CRIVELLI	크리벨리
CROATIA	크로아티아
CROCE	크로체
CROCKER	크로커
CROME	크롬
CROMER	크로머
CROMMELYNCK	크롬랭크
CROMPTON	크럼프턴
CROMWELL	크롬웰
CRONACA	크로나카
CRONIN	크로닌
CROSBY	크로스비
CRUYFF	크루이프
CRUZ	크루스
CUBA	쿠바
CUBE	큐빅
CUDWORTH	커드워스
CUGNOT	퀴뇨
CUKOR	쿠커
CUMBERLAND	컴벌랜드
CUMMINGS	커밍스
CUNNINGHAM	커닝엄
CUOMO	쿠오모
CUREL	퀴렐
CURIE	퀴리
CURT	쿠르트
CURTIS	커티스
CURTIUS	쿠르티우스
CURTIZ	커티스
CURZON	커즌
CUSHING	쿠싱
CUTHBERT	커스버트
CUVIER	퀴비에
CYPRUS	사이프러스
CYRANKIEWICZ	치란키에비치
CYRIL	키릴로스
CYRUS	키로스
CZECH	체코
CZERNY	체르니
DACCA	다카
DAFOE	데포
DAGERMAN	다게르만
DAHL	달
DAHLMANN	달만
DAIMLER	데임러
DAISY	다이시
DAKAR	다카르
DALADIER	달라디에
DALCROZE	달크로즈
DALE	데일
DALEY	데일리
DALIN	달린
DALLAPICCOLA	달라피콜라
DALLAS	댈러스
DALTON	달톤
DAM	담
DAMASCUS	다마스쿠스
DAMIANI	다미아니
DAMON	데이먼
DAMPIER	댐피어
DAN	단
DANA	데이나
DANE	데인
DANFORTH	댄포스
DANIEL	다니엘
DANIELI	다니엘리
DANIELL	다니엘
DANIELS	대니얼스
DANIELSSON	다니엘손
DANNEMANN	다네만
DANNY	다니
DANTE	단테
DANTON	당통
DANZIG	단치히
DAPHNE	다프네
DARBY	다비
DARIO	다리오
DARIUS	다리우스
DARLING	달링
DARLINGTON	달링턴
DARMSTADT	다름슈타트
DART	다트
DARTMOUTH	다트머스
DARWIN	다윈
DAUDET	도데
DAUGHERTY	도허티
DAUMIER	도미에
DAUSSET	도세
DAVE	데이브
DAVENPORT	대븐포트
DAVID	다비드
DAVIDS	다비츠
DAVIDSON	데이비슨
DAVIES	데이비스
DAVIS	데이비스
DAVISSON	데이비슨
DAVY	데이비
DAWES	도스
DAWKINS	도킨스
DAWN	돈
DAWSON	도슨
DAYAN	다얀
DAYTON	데이턴
DEAKIN	디킨
DEAN	딘
DEAVER	디버
DEBORAH	데보라
DEBREU	드브뢰
DEBS	데브스
DEBUSSY	드뷔시
DEBYE	디바이
DEDEKIND	데데킨트
DEFOE	디포
DEGAS	드가
DEHMEL	데멜
DEIRDRE	데어드르
DEISSMANN	다이스만
DELANE	딜레인
DELANO	딜라노
DELAUNAY	들로네
DELAWARE	델라웨어
DELHI	델리
DELIA	델리아
DELIBES	들리브
DELIUS	딜리어스
DELON	드롱
DELTA	델타
DEMBINSKI	뎀빈스키
DEMETER	데메테르
DENEUVE	드뇌브
DENIKIN	데니킨
DENIS	데니스
DENISE	데니즈
DENMARK	덴마크
DENNIS	데니스
DENNY	데니
DENT	텐트
DENVER	덴버
DENZEL	덴절
DERBY	더비
DERBYSHIRE	더비셔
DEREK	데릭
DERN	던
DERZHAVIN	데르자빈
DESAI	데사이
DESCHAMPS	데샹
DESIDERIUS	데시데리우스
DESMOND	데즈먼드
DESMOULINS	데물랭
DESNOS	데스노스
DESPIAU	데스피오
DESSAU	데사우
DETROIT	디트로이트
DEVI	데비
DEVILLE	드빌
DEVON	데번
DEVONSHIRE	데번셔
DEWAR	듀어
DEWEY	듀이
DIALLO	디앨로
DIANA	디아나
DIANE	다이안
DIAS	디어스
DIAZ	디아스
DICEY	다이시
DICHEV	디체프
DICK	딕
DICKENS	디킨즈
DICKINSON	디킨슨
DIDEROT	디드로
DIEFENBAKER	디펜베이커
DIEGO	디에고
DIESEL	디젤
DIETER	디트르
DIETRICH	디트리시
DIETZGEN	디츠겐
DILLON	딜런
DILTHEY	딜타이
DIMITRI	디미트리
DIMITROV	디미트로프
DINES	다인스
DINGLER	딩글러
DINO	디노
DIOCLETIANUS	디오클레티아누스
DIOGENES	디오게네스
DION	디옹
DIONYSIUS	디오니시
DIOR	디오르
DIOUF	디우프
DIRAC	디랙
DIRICHLET	디리클레
DISCOVERY	디스커버리
DISNEY	디즈니
DISRAELI	디즈레일리
DIX	딕스
DIXIE	딕시
DJIBOUTI	지부티
DJILAS	질라스
DLAMINI	들라미니
DMITRI	드미트리
DMOWSKI	드모프스키
DNEPROPETROVSK	드네프로페트로프스크
DNIEPER	드네프르
DOBRIANSKY	도브리언스키
DOBROLYUBOV	도브룰류보프
DOBSON	도브슨
DODD	다드
DODDS	도즈
DODGE	다지
DODOMA	도도마
DODSON	닷슨
DOE	도
DOHA	도하
DOHERTY	도허티
DOISY	도이지
DOLAN	돌런
DOLCE	돌체
DOLE	돌
DOLLAR	달러
DOLPH	돌프
DOLPHIN	돌핀
DOMINGO	도밍고
DOMINIC	도미니크
DOMINIQUE	도미니크
DON	단
DONAHUE	도나휴
DONALD	도널드
DONALDSON	도날드슨
DONAT	도나트
DONATUS	도나투스
DONEN	도넌
DONGEN	동겐
DONNA	도나
DONNAY	도네
DONNE	던
DONOVAN	도노번
DOOLITTLE	둘리틀
DOPPLER	도플러
DOPSCH	도프슈
DORAN	도런
DORCHESTER	도체스터
DORDRECHT	도르트레히트
DOREEN	도린
DORIA	도리아
DORIAN	도리안
DORIS	도리스
DORN	돈
DORNBUSCH	돈부시
DORNIER	도르니에
DOROTHY	도로시
DORSET	도세트
DORSEY	도어시
DORTMUND	도르트문트
DOUGLAS	더글러스
DOUMERGUE	두메르그
DOVER	도버
DOVZHENKO	도프젠코
DOWDEN	다우든
DOWDESWELL	도데스벨
DOWIYOGO	도위요고
DOWLAND	다울런드
DOWLING	다울링
DOWNEY	도니
DOWNING	다우닝
DOWNS	다운스
DOWSON	다우슨
DOYLE	도일
DRAGAN	드라간
DRAKE	드레이크
DRAPER	드레이퍼
DREISER	드라이저
DRESDEN	드레스덴
DREW	드류
DREXLER	드렉슬러
DREYFUS	드레퓌스
DRIESCH	드리슈
DRINKWATER	드링크워터
DRIVER	드라이버
DROZDOVA	드로즈도바
DRUCKER	드러커
DRURY	드루어리
DRYDEN	드라이든
DUANE	듀안
DUARTE	두아르테
DUBCEK	두브체크
DUBE	두베
DUBININ	두비닌
DUBLIN	더블린
DUBOIS	뒤부아
DUBROVNIK	두브로브니크
DUCHAMP	뒤샹
DUCLOS	뒤클로
DUCOMMUN	뒤코묑
DUDLEY	더들리
DUER	듀어
DUFOUR	두포봉
DUFY	뒤피
DUGAN	듀건
DUHEM	뒤엠
DUISBURG	뒤스부르크
DUISENBERG	도이센베르흐
DUKAS	뒤카
DUKE	듀크
DULBECCO	둘베코
DULLES	덜레스
DULUTH	덜루스
DUMAS	뒤마
DUMITRU	두미트루
DUNANT	뒤낭
DUNCAN	덩컨
DUNDEE	던디
DUNKIRK	뒹케르크
DUNLOP	던롭
DUNN	던
DUNSANY	던세이니
DUNSTABLE	던스터블
DUPLEIX	뒤플렉스
DUPUY	뒤퓨이
DURANGO	두랑고
DURANT	듀랜트
DURBAN	더반
DURHAM	더럼
DURKHEIM	뒤르켐
DUSHANBE	두샨베
DUSTIN	더스틴
DUTTON	듀톤
DUVAL	듀발
DUVALIER	뒤발리에
DUVALL	듀발
DUVIVIER	뒤비비에
DVORAK	드보르작
DYER	다이어
DYLAN	딜런
DYSON	다이슨
EADS	이즈
EAKINS	에이킨스
EAMES	임스
EAMON	에이먼
EARL	얼
EAST	동방
EASTMAN	이스트먼
EASTON	이스턴
EASTWOOD	이스트우드
EBBINGHAUS	에빙하우스
EBERT	에베르트
ECCLES	에클스
ECEVIT	에제비트
ECK	에크
ECKARDT	에카르트
ECKER	에커
ECKERMANN	에커만
ECKERSLEY	에커슬리
ECKERT	에케르트
ECKHART	에크하르트
ECUADOR	에콰도르
EDDINGTON	에딩턴
EDELMAN	에덜먼
EDELSTEIN	에델스테인
EDEN	에덴
EDER	에더
EDGAR	에드가르
EDGEWORTH	에지워스
EDINBURGH	에든버러
EDISON	에디슨
EDITH	에디트
EDKINS	애드킨스
EDMOND	에드몽
EDMONTON	에드먼턴
EDMUND	에드먼드
EDMUNDO	에드몬드
EDNA	에드나
EDOUARD	에두아르
EDUARD	에두아르트
EDUARDO	에두아르도
EDVARD	에드바르
EDWARD	에드바르트
EDWARDS	에드워즈
EDWIN	에드윈
EGBERT	에그버트
EGGLESTON	에글스턴
EGON	에곤
EGOROV	예고로프
EGYPT	이집트
EHRENBURG	에렌부르그
EHRENFELD	에런펠드
EHRLICH	에를리히
EICHENDORFF	아이헨도르프
EICHMANN	아이히만
EIFFEL	에펠
EIGEN	아이겐
EIJKMAN	에이크만
EIKHENBAUM	에이헨바움
EILEEN	아일린
EINDHOVEN	에인트호벤
EINHORN	아인혼
EINSTEIN	아인슈타인
EINTHOVEN	에인트호벤
EISENHOWER	아이젠하워
EISENSTADT	아이젠슈타트
EISENSTAEDT	아이젠스타트
EISENSTEIN	아이젠슈타인
EKATERINA	예카테리나
EKMAN	에크만
ELAINE	일레인
ELAM	엘람
ELBA	엘바
ELDER	엘더
ELEANOR	엘리너
ELENA	엘레나
ELGAR	엘가
ELGIN	엘긴
ELI	엘리
ELIA	엘리아
ELIADE	엘리아데
ELIAS	엘리아스
ELIE	엘리
ELIEZER	엘리에제르
ELIJAH	엘리야
ELION	엘리언
ELIOT	엘리어트
ELISABETH	엘리자베스
ELIZABETH	엘리자베스
ELLA	엘라
ELLEN	엘렌
ELLERY	엘러리
ELLESMERE	엘즈미어
ELLIE	엘리
ELLINGTON	엘링턴
ELLIOT	엘리어트
ELLIS	엘리스
ELLISON	엘리슨
ELLSWORTH	엘즈워스
ELMAN	엘먼
ELMER	엘머
ELS	엘스
ELSA	엘자
ELSHEIMER	엘스하이머
ELSIE	엘시
ELSTER	엘스터
ELTON	엘튼
ELY	일리
ELZEVIR	엘제비어
EMANUEL	에마누엘
EMERIC	이메릭
EMERSON	에머슨
EMIL	에밀
EMILE	에밀
EMILIO	에밀리오
EMILY	에밀리
EMINESCU	에미네스쿠
EMMA	에마
EMMANUEL	에마뉘엘
EMPSON	엠프슨
EMS	엠스
ENCKE	엥케
ENDERS	엔더스
ENDRE	엔드레
ENESCO	에네스코
ENGEL	엥겔
ENGELBERT	엥겔버트
ENGELS	엥겔스
ENGLER	엥글러
ENOCH	에녹
ENOS	에노스
ENRICO	엔리코
ENRIQUE	엔리케
ENSOR	엔소르
ENTEBBE	엔테베
ENVER	엔베르
EPHESUS	에페수스
EPHRAIM	에프라임
EPIRUS	에피루스
EPSTEIN	엡스타인
ERASMUS	에라스무스
ERASTUS	에라스투스
ERBAKAN	에르바칸
ERDMANN	에르드만
ERFURT	에르푸르트
ERHARD	에르하르트
ERIC	에릭
ERICA	에리카
ERICH	에리히
ERICK	에릭
ERICSSON	에릭슨
ERIK	에리크
ERIKSEN	에릭센
ERIKSON	에릭슨
ERIKSSON	에릭손
ERIN	에린
ERITREA	에리트레아
ERLANGER	얼랭어
ERMANNO	에라만노
ERNEST	어니스트
ERNESTINE	어니스틴
ERNESTO	에르네스토
ERNST	에른스트
ERROL	에럴
ERSKINE	어스킨
ERVING	어빙
ERWIN	어윈
ESAIAS	에사이아스
ESCHENBACH	에셴바흐
ESCHER	에셔
ESCOFFIER	에스코피에
ESENIN	예세닌
ESPEJO	에스페호
ESPINOZA	에스피노자
ESPOSITO	에스포시토
ESPRONCEDA	에스프론세다
ESPY	에스피
ESSEN	에센
ESSEX	에식스
ESTEBAN	에스테반
ESTELLE	에스텔
ESTHER	에스더
ESTONIA	에스토니아
ESTRADA	에스트라다
ESTREMADURA	에스트레마두라
ETCHEVERRY	에취베리
ETHAN	이선
ETHEL	에델
ETHIOPIA	에티오피아
ETIENNE	에티엔
EUCKEN	오이켄
EUCLID	유클리드
EUDORA	유도라
EUGEN	오이겐
EUGENE	유진
EUGENIO	에우제니오
EULER	오일러
EUNICE	유니스
EURASIA	유라시아
EUROPE	유럽
EUSEBIO	에우세비우
EUSTACHIO	유스타키오
EVAN	에번
EVANS	에번스
EVANSON	에반슨
EVANSVILLE	에번즈빌
EVE	이브
EVELYN	에벌린
EVEREST	에베레스트
EVERETT	에버렛
EVERHART	에버하트
EVERS	에버스
EVERSON	에버슨
EWALD	에발
EWING	유잉
EXETER	엑서터
EYCK	에이크
EYRE	에어
EYRING	아이링
EYSENCK	아이선크
EYSTEIN	에스타인
EZEKIEL	에제키엘
EZER	에제르
EZRA	에스라
FABIAN	파비안
FABRY	파브리
FADEEV	파데예프
FAHIM	파힘
FAHMI	파미
FAIRBANKS	페어뱅크스
FAITH	페이스
FAIZ	페이즈
FAJANS	파얀스
FALCONE	팔코네
FALCONET	팔코네
FALKBERGET	팔크베르게
FALKLAND	포클랜드
FALLOPIUS	팔로피우스
FANNING	패닝
FANNY	파니
FANO	파노
FANON	파농
FARADAY	패러디
FARBER	파버
FARJEON	파전
FARLEY	팔리
FARMINGTON	파밍턴
FAROUK	파루크
FARRELL	패럴
FARREN	패런
FAULKNER	포크너
FAURE	포레
FAUST	파우스트
FAYE	페이
FAZAL	파잘
FEATHERSTONE	피더스톤
FECHNER	페히너
FEDERICO	페데리코
FEDIN	페딘
FEETHAM	피샘
FEINBERG	파인버그
FEININGER	파이닝어
FELDMAN	펠드만
FELDSTEIN	펠드스타인
FELIPE	펠리페
FELIX	펠릭스
FERDINAND	페르디난드
FERENC	페렌츠
FERGUSON	퍼거슨
FERN	펀
FERNAND	페르낭
FERNANDEZ	페르난데스
FERNANDO	페르난도
FERRANTE	페란트
FERRARA	페라라
FERRARI	페라리
FERRE	페레
FERREIRA	페레이라
FERRY	페리
FESSENDEN	페센덴
FESTUS	페스터스
FET	페트
FEUCHTWANGER	포이히트방거
FEUERBACH	포이어바흐
FEYNMAN	파인먼
FIBIGER	피비게르
FICHTE	피히테
FICINO	피치노
FIDEL	피델
FIEDLER	피들러
FIELD	필드
FIELDING	필딩
FIJI	피지
FILCHNER	필히너
FILIP	필리프
FILIPOV	필리포프
FILIPPO	필리포
FILLMORE	필모어
FILMER	필머
FINI	피니
FINLAND	핀란드
FINN	핀
FINNEY	피니
FINSEN	핀센
FIONA	피오나
FIORENTINO	피오렌티노
FIORI	피오리
FIRESTONE	파이어스톤
FIRTH	퍼스
FISCHER	피셔
FISHER	피셔
FISK	피스크
FISKE	피스크
FITCH	피치
FITTIG	피티히
FITZ	피츠
FITZGERALD	피츠제럴드
FITZPATRICK	피츠패트릭
FIZEAU	피조
FLAGSTAD	플라그스타
FLAHERTY	플라어티
FLAMSTEED	플램스티드
FLANAGAN	플래너건
FLANDERS	플랜더스
FLAUBERT	플로베르
FLAVIO	플라비오
FLAVIUS	플라비우스
FLAXMAN	플랙스먼
FLEET	플리트
FLEISCHER	플라이셔
FLEMMING	플레밍
FLESCH	플레쉬
FLETCHER	플래처
FLINT	플린트
FLORA	플로라
FLORENCE	플로렌스
FLORES	플로레스
FLOREY	플로리
FLORIAN	플로리안
FLORIDA	플로리다
FLORIN	플로린
FLORY	플로리
FLYNN	플린
FO	포
FOCH	포슈
FOCKE	포케
FOERSTER	푀르스터
FOGAZZARO	포가차로
FOGEL	포겔
FOGGIA	포지아
FOKKER	포커
FOLEY	폴리
FONDA	폰다
FONSECA	폰세카
FONTAINE	퐁텐
FONTAINEBLEAU	퐁텐블로
FONTANA	폰타나
FONTANE	폰타네
FONTEYN	폰테인
FONVIZIN	폰비진
FOOTE	푸트
FORBES	포브스
FORD	포드
FORESTER	포레스터
FORLANI	폴라니
FORMAN	포르만
FORST	포르스트
FORSTER	포스터
FORT	포르
FORTUNE	포천
FOSTER	포스터
FOUCAULT	푸코
FOUQUET	푸케
FOURIER	푸리에
FOURNIER	푸르니에
FOWLER	파울러
FOWLES	파울즈
FOX	폭스
FRAGONARD	프라고나르
FRAKES	프레이크
FRAN	프란
FRANCE	프랑스
FRANCES	프랜시스
FRANCESCA	프란체스카
FRANCESCO	프란체스코
FRANCIS	프랑시스
FRANCISCO	프란시스코
FRANCK	프랑크
FRANCKE	프랑케
FRANCO	프랑코
FRANCOIS	프랑수아
FRANK	프랑크
FRANKEL	프란켈
FRANKEN	프랑켄
FRANKENSTEIN	프랑켄슈타인
FRANKFORT	프랭크퍼트
FRANKFURT	프랑크푸르트
FRANKLAND	프랭클랜드
FRANKLIN	프랭클린
FRANKS	프랭크스
FRANS	프란스
FRANZ	프란츠
FRASER	프레이저
FRAUNHOFER	프라운호퍼
FRAZER	프레이저
FRAZIER	프레이저
FRECHETTE	프레셰트
FRED	프레드
FREDA	프레다
FREDERIC	프레더릭
FREDERICK	프레드릭
FREDERICTON	프레더릭턴
FREDERIK	프레데리크
FREEMAN	프리먼
FREEMANTLE	프리맨틀
FREETOWN	프리타운
FREGE	프레게
FREI	프레이
FREIBERG	프라이버그
FREIBURG	프라이부르크
FREILIGRATH	프라일리그라트
FRENCH	프렌치
FRENCHMAN	프랑스인
FRESNEL	프레넬
FRESNO	프레즈노
FREUD	프로이트
FREUDENTHAL	프로이덴탈
FREY	프로이
FREYA	프로이야
FREYSSINET	프레이시넷
FREYTAG	프라이타크
FRICHE	프리체
FRICK	프릭
FRIDTJOF	프리드쇼프
FRIED	프라이드
FRIEDMAN	프리드만
FRIEDRICH	프리드리히
FRIES	프리스
FRISCH	프리슈
FRITS	프리츠
FRITSCH	프리치
FRITZ	프리츠
FROBENIUS	프로베니우스
FROMENTIN	프로망탱
FROMM	프롬
FRONTINUS	프론티누스
FROST	프로스트
FRUNZE	프룬제
FRYER	프라이어
FUENTES	푸엔테스
FULBRIGHT	풀브라이트
FULLER	풀러
FULLERTON	풀러턴
FULTON	풀턴
FUNAFUTI	푸나푸티
FUNK	풍크
FUNKE	풍케
FURMANOV	푸르마노프
GABIN	가뱅
GABLE	게이블
GABON	가봉
GABORONE	가보로네
GABRIEL	가브리엘
GABRIELA	가브리엘라
GABRIELE	가브리엘레
GABRIELI	가브리엘리
GABRIELLE	가브리엘
GADAMER	가다머
GADDA	가다
GAEDE	게데
GAETANO	가에타노
GAIA	가이아
GAIL	게일
GAILLARD	가이야르
GAINSBOROUGH	게인즈버러
GAIRDNER	게어드너
GAITSKELL	게이츠켈
GAJ	가이
GAJDUSEK	가이듀섹
GALBRAITH	캘브레이스
GALE	게일
GALILEI	갈릴레이
GALILEO	갈릴레오
GALL	갈
GALLAGHER	갤러거
GALLAND	갈랑
GALLE	갈
GALLIO	갈리오
GALLONI	갤로니
GALLUP	갤럽
GALPIN	갈핀
GALSWORTHY	골즈워디
GALTON	골턴
GALTUNG	갈퉁
GALVANI	갈바니
GALWAY	골웨이
GAMA	가마
GAMARRA	가마라
GAMBETTA	강베타
GAMBIA	감비아
GAMBIER	갬비어
GAMBLE	갬블
GANCE	강스
GANDHI	간디
GANGES	갠지스
GANTT	갠트
GAPON	가폰
GARANG	가랑
GARBO	가르보
GARBORG	가르보르그
GARCIA	가르시아
GARDINER	가드너
GARDNER	가드너
GARETH	개리스
GARFIELD	가필드
GARIBALDI	가리발디
GARLAND	갈런드
GARNER	가너
GARNETT	가넷
GARNIER	가르니에
GARR	가
GARRETT	가레트
GARRICK	개릭
GARRIS	가레스
GARRISON	개리슨
GARRY	게리
GARSHIN	가르신
GARVEY	가비
GARY	게리
GASCOIGNE	개스코인
GASCOYNE	개스코인
GASKELL	개스켈
GASPAR	가스파
GASPARD	가스파르
GASPARRI	가스파리
GASSENDI	가상디
GASSER	개서
GASTON	가스통
GATES	게이츠
GAUGUIN	고갱
GAUL	골
GAULTIER	고티에
GAUMONT	고몽
GAUSS	가우스
GAUTIER	고티에
GAVIN	개빈
GAY	게이
GAYOOM	가윰
GAZA	가자
GE	게
GEIBEL	가이벨
GEIGER	가이거
GEIJER	예이예르
GEISSLER	가이슬러
GEIST	가이스트
GELSENKIRCHEN	겔젠키르헨
GEMMA	제마
GENE	진
GENEVA	제네바
GENNADY	겐나디
GENTILE	젠틸레
GENTZ	겐츠
GEOFF	제프
GEOFFREY	제프리
GEORG	게오르그
GEORGE	게오르게
GEORGES	제오르제스
GEORGETOWN	조지타운
GEORGETTE	조젯
GEORGI	게오르기
GEORGIA	그루지아
GEORGINA	조르지나
GEPHARDT	게파트
GERAINT	제레인트
GERALD	제럴드
GERARD	제라르
GERARDUS	헤라르뒤스
GERASIMOV	게라시모프
GERBER	거버
GERD	게르트
GERHARD	게르하르트
GERHARDT	게르하르트
GERLACH	게를라흐
GERMAIN	제르맹
GERMANY	독일
GEROLAMO	제롤라모
GERONIMO	제로니모
GERRIT	헤리트
GERSHWIN	거슈윈
GERSTNER	거스너
GERTRUD	거트루드
GERTRUDE	거트루드
GERTSEN	게르첸
GERVINUS	게르비누스
GESELL	게젤
GESNER	게스너
GETTY	게티
GETTYSBURG	게티즈버그
GEULINCX	괼링크스
GHANA	가나
GHEORGHIU	게오르규
GHIBERTI	기베르티
GHOSH	고시
GIACOMETTI	자코메티
GIACOSA	자코사
GIAEVER	기에버
GIAMBATTISTA	잠바티스타
GIANFRANCO	잔프랑코
GIANNI	잔니
GIAUQUE	지오크
GIBB	깁
GIBBON	기번
GIBBONS	기번스
GIBBS	기브스
GIBSON	기브슨
GIDDENS	기든스
GIDDINGS	기딩스
GIELGUD	길구드
GIEREK	기에레크
GIGLI	질리
GIL	길
GILBERT	길버트
GILBRETH	길브레스
GILELS	길렐스
GILES	자일스
GILL	길
GILLESPIE	길레스피
GILLETTE	질렛
GILLIAN	질리언
GILMAN	길먼
GILSON	질송
GINASTERA	히나스테라
GINI	지니
GINO	지노
GINSBURG	긴즈버그
GIOBERTI	조베르티
GIOLITTI	졸리티
GIONO	지오노
GIORDANO	조르다노
GIORGIO	조르조
GIOVANNI	조반니
GIRARD	지라드
GIRARDON	지라르동
GIRAUDOUX	지로두
GIRONDE	지롱드
GISELA	지젤라
GISSING	기싱
GIULIANI	줄리아니
GIULIANO	줄리아노
GIULIO	줄리오
GIUSEPPE	주세페
GIUSTI	주스티
GIZA	기자
GJELLERUP	기엘레루프
GLADKOV	글랏코프
GLADSTONE	글래드스턴
GLADYS	글라이디스
GLASER	글레이저
GLASGOW	글래스고
GLASPELL	글래스펠
GLASS	글라스
GLAUBER	글라우버
GLAZUNOV	글라주노프
GLEIM	글라임
GLEIZES	글레이즈
GLEMP	글렘프
GLEN	글렌
GLENDA	글렌다
GLENDALE	글렌데일
GLENN	글렌
GLEYSTEEN	글라이스틴
GLICKMAN	글리크먼
GLORIA	글로리아
GLOUCESTER	글로스터
GLOVER	글로버
GLUCK	글루크
GNEISENAU	그나이제나우
GNEIST	그나이스트
GOA	고아
GOBAT	고바
GOBI	고비
GOBINEAU	고비노
GODARD	고다르
GODDARD	고더드
GODFREY	고드프리
GODWIN	고드윈
GOEBEL	괴벨
GOES	구스
GOETHALS	고설스
GOETHE	괴테
GOFFMAN	고프먼
GOGARTEN	고가르텐
GOGH	고흐
GOGOL	고골리
GOKHALE	고칼레
GOLD	골드
GOLDBECK	골드벡
GOLDBERG	골드버그
GOLDEN	골든
GOLDIE	골디
GOLDIN	골딘
GOLDING	골딩
GOLDMAN	골드망
GOLDMANN	골드만
GOLDONI	골도니
GOLDSCHMIDT	골트슈미트
GOLDSMITH	골드스미스
GOLDSTEIN	골드스타인
GOLDSWORTHY	골즈워디
GOLDWYN	골드윈
GOLGI	골지
GOMBRICH	곰브리치
GOMES	고메스
GOMPERS	곰퍼스
GOMULKA	고무우카
GONCHAROV	곤차로프
GONCOURT	공쿠르
GONSALVES	곤살베스
GONZALES	곤살레스
GONZALEZ	곤살레스
GONZALO	곤살로
GOOCH	구치
GOODE	구드
GOODMAN	굿맨
GOODNOW	굿노우
GOODWIN	굿윈
GOODYEAR	굿이어
GORBACHEV	고르바초프
GORCHAKOV	고르차코프
GORDIMER	고디머
GORDON	고든
GORE	고어
GORKY	고키
GORTER	고르테르
GOSSE	고스
GOSSEC	고세크
GOSSEN	고센
GOSSET	고셋
GOTH	고트
GOTTFRIED	고트프리트
GOTTHELF	고트헬프
GOTTLIEB	고틀리브
GOTTLOB	고틀로프
GOTTSCHED	고트셰트
GOTTWALD	고트발트
GOUGH	고푸
GOUJON	구종
GOULD	굴드
GOULED	굴레드
GOUNOD	구노
GOWER	가워
GOZZI	고치
GOZZOLI	고촐리
GRAAF	그라프
GRACCHUS	그라쿠스
GRACE	그라스
GRAF	그라프
GRAHAM	그레이엄
GRAHAME	그레이엄
GRAMME	그람
GRAMSCI	그람시
GRANADA	그라나다
GRANET	그라네
GRANIT	그라니트
GRANT	그랜트
GRASS	그라스
GRASSMANN	그라스만
GRAU	그라우
GRAVATT	그라바트
GRAVES	그라브산
GRAY	그레이
GRECO	그레코
GREECE	그리스
GREELY	그릴리
GREEN	그린
GREENE	그린
GREENLAND	그린란드
GREENSPAN	그린스펀
GREENVILLE	그린빌
GREER	그리어
GREG	그레그
GREGG	그레그
GREGOR	그레고르
GREGORIO	그레고리오
GREGORIUS	그레고리우스
GREGORY	그레고리
GREIN	그라인
GREKOV	그레코프
GRENADA	그레나다
GRENFELL	그렌펠
GRENVILLE	그렌빌
GRESHAM	그레셤
GREUZE	그뢰즈
GREW	그루
GREY	그레이
GRIEG	그리그
GRIFFIN	그리핀
GRIFFIS	그리피스
GRIFFITH	그리피스
GRIGOROVICH	그리고로비치
GRILLPARZER	그릴파르처
GRIMM	그림
GRIMMELSHAUSEN	그리멜스하우젠
GRIS	그리스
GROETHUYSEN	그레튀쟁
GROMAIRE	그로메르
GROMYKO	그로미코
GROOM	그룸
GROPIUS	그로피우스
GROS	그로
GROSSE	그로세
GROSSI	그로시
GROSSMAN	그로스먼
GROSZ	그로스
GROTE	그로트
GROTEWOHL	그로테볼
GROTH	그로트
GROTIUS	그로티우스
GROVE	그로브
GROZA	그로자
GRYPHIUS	그리피우스
GUADALAJARA	과달라하라
GUADALCANAL	과달카날
GUADALUPE	과달루페
GUAM	괌
GUARDI	과르디
GUARDINI	과르디니
GUARINI	과리니
GUARINO	과리노
GUARNIERI	과르니에리
GUATEMALA	과테말라
GUAYAQUIL	과야킬
GUDRUN	구드룬
GUERICKE	게리케
GUERRA	게라
GUERRERO	게레로
GUGGENHEIM	구겐하임
GUIANA	기아나
GUIDO	구이도
GUILLAUME	기욤
GUILLAUMIN	기요맹
GUILLEMIN	기유맹
GUINEA	기니
GUINEA-BISSAU	기니비사우
GUIZOT	기조
GULDBERG	굴드베르그
GULLSTRAND	굴스트란드
GUMPLOWICZ	굼플로비치
GUNDERSON	건더슨
GUNDOLF	군돌프
GUNNAR	군나르
GUNTER	건터
GUNTHER	건서
GUPTA	굽타
GURLEY	걸리
GURWITSCH	거비치
GUSOU	구써우
GUSTAF	구스타프
GUSTAV	구스타브
GUSTAVE	구스타브
GUSTAVO	구스타보
GUTENBERG	구텐베르크
GUTIERREZ	구티에레스
GUY	가이
GUYANA	가이아나
GUYAU	귀요
GUYON	귀용
GUZMAN	구즈먼
GWEN	그웬
GYULA	줄러
HAAG	헤이그
HAARLEM	하를렘
HAAS	하스
HAAVELMO	호벨모
HABAKKUK	하박국
HABER	하버
HABERMAS	하버마스
HABIB	하비브
HABRE	아브르
HABSBURG	합스부르크
HADLEY	하들리
HAECKEL	헤켈
HAGEN	하겐
HAGENBECK	하겐베크
HAGERSTOWN	헤거스타운
HAGGARD	해거드
HAGUE	헤이그
HAHN	안
HAHNEMANN	하네만
HAIDAR	하이다르
HAIDER	하이더
HAIFA	하이파
HAIG	헤이그
HAINS	엥스
HAITI	아이티
HAL	핼
HALAS	할라스
HALDANE	홀데인
HALE	헤일
HALES	헤일즈
HALEY	할리
HALIFAX	핼리팩스
HALL	홀
HALLE	할레
HALLER	할러
HALLEY	핼리
HALLWACHS	할박스
HALMA	핼머
HALS	할스
HALSTEAD	할스태드
HAMANN	하만
HAMBURG	함부르크
HAMEL	하멜
HAMILTON	해밀턴
HAMLET	햄릿
HAMLIN	햄린
HAMMER	하머
HAMMERSTEIN	해머스타인
HAMMOND	해몬드
HAMPSHIRE	햄프셔
HAMPTON	햄프턴
HAMSUN	함순
HANDEL	헨델
HANDLER	핸들러
HANK	행크
HANKEL	항켈
HANNA	한나
HANNAH	해나
HANNELORE	하넬로레
HANNIBAL	한니발
HANNOVER	하노버
HANOI	하노이
HANON	아농
HANOVER	하노버
HANS	한스
HANSARD	핸서드
HANSEN	한센
HANSLICK	한슬리크
HANSON	핸슨
HANSSON	한손
HANZI	한쯔
HARALD	하랄트
HARARE	하라레
HARBISON	하비슨
HARDEN	하든
HARDIE	하디
HARDING	하딩
HARDWICK	하드윅
HARDWICKE	하드위케
HARDY	하디
HARGREAVES	하그리브스
HARIS	하리스
HARLEM	할렘
HARLEY	할리
HARLOW	할로
HARMAN	하먼
HARMON	하먼
HARNACK	하르나크
HAROLD	해럴드
HARPER	하퍼
HARRIET	해리엇
HARRIMAN	해리먼
HARRINGTON	해링턴
HARRIS	해리스
HARRISBURG	해리스버그
HARRISON	해리슨
HARROW	해로
HARRY	해리
HARSANYI	허샤니
HART	하트
HARTE	하트
HARTFORD	하트퍼드
HARTLE	하틀
HARTLEY	하틀리
HARTLINE	하틀라인
HARTMANN	하르트만
HARTMUT	하르트무트
HARTUNG	아르퉁
HARVARD	하버드
HARVEY	하비
HARWOOD	하우드
HASENCLEVER	하젠클레버
HASKELL	하스켈
HASLER	하슬러
HASSAN	하산
HASSANAL	하사날
HASSE	하세
HASSEL	하셀
HASSLER	하슬러
HASTINGS	헤이스팅스
HATCH	해치
HATHAWAY	해서웨이
HAUFF	하우프
HAUGLAND	헤울란
HAUPTMANN	하웁트만
HAUSER	하우저
HAUSHOFER	하우스호퍼
HAVANA	아바나
HAVEL	하벨
HAWAII	하와이
HAWKE	호크
HAWKINS	호킨스
HAWKS	호크스
HAWN	혼
HAWORTH	하스
HAWTHORN	호손
HAWTHORNE	호손
HAY	헤이
HAYDEN	헤이든
HAYDN	하이든
HAYEK	하이에크
HAYES	헤이스
HAYNES	헤인즈
HAZARD	해저드
HAZEL	헤이즐
HAZLITT	해즐릿
HEALEY	힐리
HEARN	혼
HEARST	허스트
HEATH	히스
HEATHER	헤더
HEAVISIDE	헤비사이드
HEBBEL	헤벨
HEBEL	헤벨
HEBRA	헤브라
HEBRIDES	헤브리디스
HEBRON	헤브론
HECHT	헥트
HECKEL	헤켈
HECKLER	헤클러
HECKMAN	헤크먼
HECKSCHER	헤크셰르
HECTOR	헥토르
HEDIN	헤딘
HEDTOFT	헤드토프트
HEDY	헤디
HEFNER	헤프너
HEGEL	헤겔
HEIBERG	헤이베르그
HEIDEGGER	하이데거
HEIDELBERG	하이델베르크
HEIDENSTAM	헤이덴스탐
HEIFETZ	하이페츠
HEIJERMANS	하이예르만스
HEIKE	하이케
HEIM	하임
HEINE	하이네
HEINRICH	하인리히
HEINTZE	하이트체
HEINZ	하인츠
HEISENBERG	하이젠베르크
HEITOR	헤이토르
HEKMATYAR	헤크마티아르
HELD	헬드
HELEN	헬렌
HELENA	헬레나
HELENE	헬레네
HELGELAND	헬걸런드
HELLER	헬러
HELLMAN	헬먼
HELMHOLTZ	헬름홀츠
HELMONT	헬몬트
HELMS	헬름스
HELMUT	헬무트
HELSINKI	헬싱키
HEMINGWAY	헤밍웨이
HENCH	헨치
HENDERSON	헨더슨
HENDRICKSON	헨드릭슨
HENDRIK	헨드리크
HENDRIKX	헨드릭스
HENIE	헤니
HENKEL	헨켈
HENLE	헨레
HENLEY	헨리
HENNEBIQUE	엔비크
HENRI	앙리
HENRIETTA	헨리에타
HENRIK	헨리크
HENRIOT	앙리오
HENRIQUEZ	엔리케스
HENRY	앙리
HENRYK	헨리크
HENSEL	헨젤
HENSEN	헨젠
HENZE	헨체
HEPBURN	헵번
HEPPLEWHITE	헤플화이트
HEPWORTH	헵워스
HERB	허브
HERBART	헤르바르트
HERBERT	허버트
HERDER	헤르더
HEREFORD	헤리퍼드
HERFORD	헤어포트
HERING	헤링
HERMAN	허먼
HERMANN	헤르만
HERMES	헤르메스
HERNANDEZ	헤르난데스
HERNE	헤르네
HERON	헤론
HERRERA	헤레라
HERRICK	헤릭
HERRINGTON	헤링턴
HERRIOT	에리오
HERSCHEL	허셜
HERSEY	허시
HERSHEY	허시
HERTA	헤르타
HERTFORD	하트퍼드
HERTWIG	헤르트비히
HERTZ	헤르쯔
HERZBERG	헤르츠베르크
HERZL	헤르츨
HERZOG	헤어초크
HESELTINE	헤슬타인
HESS	헤스
HESSE	헤세
HESSEN	헤센
HETTNER	헤트너
HEUSS	호이스
HEWISH	휴이시
HEWITT	휴잇
HEWLETT	휴렛
HEYDEN	헤이덴
HEYERDAHL	헤위에르달
HEYM	하임
HEYMAN	헤이먼
HEYMANS	하이만스
HIBERNIA	하이버니아
HICKS	힉스
HIDALGO	이달고
HIERONYMUS	히에로니무스
HIGGINS	히긴스
HILARY	힐러리
HILBERT	힐베르트
HILDA	힐다
HILDEBRAND	힐데브란드
HILFERDING	힐퍼딩
HILL	힐
HILTON	힐턴
HILTY	힐티
HIMMLER	힘러
HINDEMITH	힌데미트
HINDENBURG	힌덴부르크
HINDS	하인즈
HINDUSTAN	힌두스탄
HINSHELWOOD	힌셜우드
HINTON	힌턴
HIRSCH	허쉬
HITCH	히치
HITCHCOCK	히치콕
HITCHINGS	히칭스
HOARE	호어
HOBART	호바트
HOBBEMA	호베마
HOBBES	홉스
HOBHOUSE	홉하우스
HOBSBAWM	홉스봄
HOBSON	홉슨
HOCHE	오슈
HODEL	호들
HODGE	호지
HODGKIN	호지킨
HODGSON	호지슨
HOEL	호엘
HOFER	호퍼
HOFFA	호파
HOFFMAN	호프만
HOFFMANN	호프만
HOFMANN	호프만
HOFMEISTER	호프마이스터
HOFSTADTER	호프스태터
HOGARTH	호가스
HOGG	호그
HOHENSTAUFEN	호엔슈타우펜
HOLBEIN	홀바인
HOLBERG	홀베르
HOLBROOKE	홀브룩
HOLGER	홀게르
HOLLAND	홀란드
HOLLEY	홀리
HOLLIDAY	홀리데이
HOLLINGWORTH	홀링워스
HOLLOWAY	홀러웨이
HOLLYWOOD	할리우드
HOLMES	홈스
HOLST	홀스트
HOLSTEIN	홀스타인
HOLT	홀트
HOLZ	홀츠
HOLZER	홀처
HOMER	호머
HONDURAS	혼두라스
HONECKER	호네커
HONEGGER	오네게르
HONEYWELL	하니웰
HONGHAI	훙하이
HONIARA	호니아라
HONOLULU	호놀룰루
HONORIUS	호노리우스
HOOCH	호흐
HOOD	후드
HOOKE	훅
HOOVER	후버
HOPE	호프
HOPKINS	홉킨스
HOPP	호프
HOPPER	호퍼
HORACE	호라티우스
HORACIO	호라시오
HORATIO	허레이쇼
HORKHEIMER	호르크하이머
HORN	호른
HORNBY	혼비
HOROWITZ	호로비츠
HORST	호르스트
HORT	홀트
HORTA	오르타
HOSKINS	호스킨스
HOSS	호스
HOTCHKISS	호치키스
HOUDON	우동
HOUSE	하우스
HOUSMAN	하우스먼
HOUSSAY	우사이
HOUSTON	휴스턴
HOWARD	하워드
HOWE	하우
HOWELLS	하우얼스
HOXHA	호자
HOYT	호이트
HRISTOV	흐리스토프
HUBBARD	허버드
HUBBLE	허블
HUBEL	허블
HUBER	후버
HUBERMAN	휴버먼
HUBERT	위베르
HUBERTUS	후베르투스
HUCH	후흐
HUDSON	허드슨
HUE	위에
HUGGINS	허긴스
HUGH	휴
HUGO	위고
HUGUENOT	위그노
HUGUETTE	위게트
HUIZINGA	호이징가
HULBERT	헐버트
HULL	헐
HULME	흄
HULSE	헐스
HUMASON	휴메이슨
HUMBOLDT	훔볼트
HUME	흄
HUMMEL	훔멜
HUMPERDINCK	훔퍼딩크
HUMPHREY	험프리
HUMPHREYS	험프리스
HUNGARY	헝가리
HUNKER	한카
HUNT	헌트
HUNTER	헌터
HUNTINGTON	헌팅턴
HUNTSMAN	헌츠먼
HUNTSVILLE	헌츠빌
HURLEY	헐리
HURT	허트
HUS	후스
HUSAK	후삭
HUSS	후스
HUSSEINI	후세이니
HUSSERL	후설
HUSTON	휴스턴
HUTCHESON	허치슨
HUTCHINS	허친스
HUTCHINSON	허친슨
HUTCHISON	허치슨
HUTSON	허트슨
HUTTEN	후텐
HUTTON	허턴
HUXLEY	헉슬리
HUYGENS	호이겐스
HUYSMANS	위스망스
HYATT	하이엇
HYDE	하이드
HYDERABAD	하이데라바드
HYNDMAN	하인드먼
HYNNINEN	하인니넨
IACOCCA	아이어코카
IAIN	이언
IAN	이언
IBADAN	이바단
IBARBOUROU	이바르부루
IBERIA	이베리아
IBRAHIM	이브라힘
IBSEN	입센
ICELAND	아이슬란드
IDA	이다
IDAHO	아이다호
IDE	이드
IDRIS	이드리스
IGLESIAS	이글레시아스
IGNATIEV	이그나티예프
IGOR	이고르
ILIEV	일리예프
ILLINOIS	일리노이
ILONA	일로나
ILYA	일리야
ILYUSHIN	일류신
IMBERT	임베르트
IMHOFF	임호프
IMMERMANN	이머만
IMRE	임레
INCA	잉카
INCE	인스
INDIA	인디아
INDIANA	인데에나
INDIANAPOLIS	인디애나폴리스
INDIRA	인디라
INDONESIA	인도네시아
INDRA	인드라
INDUS	인더스
INES	이네스
INEZ	아이네즈
INGARDEN	잉가르덴
INGE	잉
INGENHOUSZ	잉겐호우스
INGLIS	잉글리스
INGRAHAM	잉그러햄
INGRES	앵그르
INGRID	잉그리드
INGVAR	잉바르
INNSBRUCK	인스브루크
INVERNESS	인버네스
IOAN	이오안
IOFFE	요페
ION	이온
IONESCO	이오네스코
IOWA	아이오와
IRA	아이라
IRAN	이란
IRAQ	이라크
IRELAND	아일랜드
IRINA	이리나
IRIS	이리스
IRKUTSK	이르쿠츠크
IRONS	아이언스
IRVING	어빙
IRWIN	어윈
ISAAC	이삭
ISAACS	이삭스
ISABEL	이사벨
ISADORA	이사도라
ISAIAH	이사야
ISHERWOOD	이셔우드
ISKANDAR	이스칸달
ISLAMABAD	이슬라마바드
ISLER	아이슬러
ISMAIL	이스마일
ISMAILIA	이스마일리아
ISRAEL	이스라엘
ISTANBUL	이스탄불
ITALO	이탈로
ITALY	이탈리아
ITHACA	이타카
ITZHAK	이작
ITZIK	이치크
IVAN	이반
IVANOV	이바노프
IVERSON	아이버슨
IVES	아이브즈
IVO	이보
IVORY	아이보리
IVY	아이비
JACEK	야체크
JACK	잭
JACKIE	재키
JACKSON	잭슨
JACKSONVILLE	잭슨빌
JACOB	야곱
JACOBI	야코비
JACOBO	하코보
JACOBS	제이콥스
JACOBSEN	야콥센
JACOBUS	야코뷔스
JACOBY	자코비
JACQUARD	자카드
JACQUELINE	재클린
JACQUES	자크
JAFFNA	자프나
JAGAN	제이건
JAGGER	재거
JAHN	얀
JAIME	하이메
JAIPUR	자이푸르
JAKARTA	자카르타
JAKOB	야코프
JAKOBSON	야콥슨
JAM	잼
JAMAICA	자메이카
JAMAL	자말
JAMES	제임스
JAMESTOWN	제임스타운
JAMIESON	제미슨
JAMIL	하밀
JAMISON	제이미슨
JAMMES	잠
JAMSA	잠사
JAN	얀
JANE	제인
JANET	자네
JANEZ	야네즈
JANICE	제니스
JANNINGS	야닝스
JANSEN	얀센
JANSKY	잰스키
JANSSON	얀손
JANTZEN	잔첸
JANUSZ	야누시
JAQUES	자크
JAROSLAV	야로슬라프
JARRE	자르
JARRY	자리
JARUZELSKI	야루젤스키
JASCHA	야샤
JASPER	자스퍼
JASPERS	야스퍼스
JAVA	자바
JAWARA	자와라
JAY	제이
JEAN	잔
JEANETTE	지넷
JEANNE	잔
JEANS	진스
JEFF	제프
JEFFERSON	제퍼슨
JELLINEK	옐리네크
JENA	예나
JENNER	제너
JENNEY	제니
JENNIFER	제니퍼
JENNINGS	제닝스
JENNY	제니
JENS	옌스
JENSEN	옌센
JEPSEN	제프슨
JEREMIAH	예레미야
JEREMIAS	예레미아스
JEREMY	제러미
JEROME	제롬
JERROLD	제럴드
JERUSALEM	예루살렘
JERZY	예지
JESPERSEN	예스페르센
JESS	제스
JESSE	제시
JESSIE	제시
JEVONS	제번스
JI	지
JIDDA	지다
JILL	질
JIM	짐
JIMMY	지미
JOACHIM	요아킴
JOAN	요앙
JOANNE	조앤
JOAQUIN	호아킨
JOBS	잡스
JOCELYN	조셀린
JODELLE	조델
JODIE	조디
JOE	조
JOEL	요엘
JOFFRE	조프르
JOHAN	요한
JOHANN	요한
JOHANNA	요하나
JOHANNES	요하네스
JOHANNESBURG	요하네스버그
JOHANSON	조핸슨
JOHANSSON	요한손
JOHN	존
JOHNNY	조니
JOHNSON	욘손
JOHNSTON	존스톤
JOHNSTONE	존스톤
JOHNSTOWN	존스타운
JOINVILLE	주앵빌
JOLIVET	졸리베
JON	욘
JONAH	요나
JONAS	요나스
JONATHAN	조너선
JONES	존스
JONGKIND	용킨트
JONSON	존슨
JOOST	요스트
JORDAENS	요르단스
JORDAN	요르단
JORGE	조르제
JOSE	조제
JOSEF	요세프
JOSEPH	요셉
JOSEPHSON	조지프슨
JOSEPHUS	요세푸스
JOSH	조시
JOSHUA	여호수아
JOSIE	조쉬
JOSPIN	조스팽
JOST	요스트
JOUHAUX	주오
JOULE	줄
JOURDAN	조단
JOUVE	주브
JOUVET	주베
JOXE	족스
JOYCE	조이스
JOYNER	조이너
JOZEF	요제프
JUAN	후안
JUDAH	유다
JUDAS	유다
JUDD	저드
JUDE	유다
JUDEA	유대
JUDITH	유디트
JUDY	주디
JUE	줴
JUGLAR	쥐글라
JUGNAUTH	주그노트
JUKES	쥬크스
JULES	줄스
JULIA	줄리아
JULIAN	율리아누스
JULIANUS	율리아누스
JULIE	줄리
JULIEN	쥘리앵
JULIET	줄리엣
JULIETTE	쥘리에트
JULIO	훌리오
JULIUS	율리우스
JUMA	주마
JUNEAU	주노
JUNG	융
JUNGE	융게
JUNKER	융커
JUNKERS	융커스
JUNQUEIRO	준케이루
JURGEN	주겐
JUSSIEU	쥐시외
JUSTIN	저스틴
KABUL	카불
KACHALOV	카찰로프
KADUN	카둔
KAFKA	카프카
KAGANOVICH	카가노비치
KAHN	칸
KAI	카이
KAISER	카이저
KAJ	카이
KALAMAZOO	칼라마주
KALB	칼프
KALIMANTAN	칼리만탄
KALININ	칼리닌
KALININGRAD	칼리닌그라드
KALLAS	칼라스
KALMAN	칼만
KAMAL	카말
KAMENEV	카메네프
KAMIL	카밀
KAMINSKI	카민스키
KAMPALA	캄팔라
KAMU	카무
KANDAHAR	칸다하르
KANDEL	캔들
KANE	케인
KANIA	카니아
KANIN	카닌
KANPUR	칸푸르
KANSAS	캔자스
KANT	칸트
KANTOR	캔터
KAPITSA	카피차
KAPP	카프
KAPTEYN	캅테인
KARACHI	카라치
KARAJAN	카라얀
KARAKHAN	카라한
KARAMZIN	카람진
KAREL	카렐
KARELIA	카렐리아
KAREN	카렌
KARIM	카림
KARIMI	카리미
KARIN	카린
KARL	카를
KARLFELDT	칼펠트
KARLGREN	칼그렌
KARLIN	칼린
KARLSRUHE	카를스루에
KAROL	카롤
KARP	카프
KARRER	카러
KARSAVINA	카르사비나
KASAVUBU	카사부부
KASCHNITZ	카슈니츠
KASHMIR	카슈미르
KASPAR	카스파어
KASPER	카스퍼
KASSEM	카셈
KATE	케이트
KATHARINA	카타리나
KATHERINE	캐서린
KATHLEEN	캐서린
KATHMANDU	카트만두
KATZ	카츠
KAUFFMANN	카우프만
KAUFMAN	코프먼
KAUNDA	카운다
KAUTSKY	카우츠키
KAVERIN	카베린
KAY	케이
KAYSER	카이저
KAZAKHSTAN	카자흐스탄
KAZAN	카잔
KEAN	킨
KEARSLEY	키어슬리
KEATON	키튼
KEATS	키츠
KEISER	카이저
KEITA	케이타
KEITH	키스
KEKKONEN	케코넨
KELLER	켈러
KELLERMANN	켈러만
KELLOGG	켈로그
KELLY	켈리
KELSEN	켈젠
KELVIN	켈빈
KEMAL	케말
KEMBLE	켐블
KEMP	켐프
KEMPFF	켐프
KEMPIS	켐피스
KEN	켄
KENDALL	켄들
KENDREW	켄드루
KENNAN	케넌
KENNEDY	케네디
KENNELLY	케널리
KENNETH	케네스
KENNY	케니
KENSINGTON	켄징턴
KENT	켄트
KENTON	켄턴
KENTUCKY	켄터키
KENYA	케냐
KENYATTA	케냐타
KEON	키온
KEPLER	케플러
KEREKOU	케레쿠
KERN	컨
KERR	커
KERRIGAN	케리건
KERSCHENSTEINER	케르셴슈타이너
KESEY	키지
KESSEL	케셀
KESSLER	케슬러
KESWICK	케스윅
KEVIN	케빈
KEY	케이
KEYNES	케인스
KEYSERLING	카이절링
KHABAROVSK	하바로프스크
KHACHATURYAN	하차투리안
KHADEM	카뎀
KHALID	칼리드
KHALIL	칼릴
KHAMENEI	하메네이
KHAN	칸
KHARKOV	카코흐
KHARTOUM	하르툼
KHOMEINI	호메이니
KHORANA	코라나
KHRUSHCHEV	흐루시초프
KIDD	키드
KIEFER	키퍼
KIEL	킬
KIELLAND	셸란
KIER	카야
KIERAN	키런
KIERKEGAARD	키에르케고르
KIESINGER	키징거
KIEV	키예프
KIGALI	키갈리
KILAUEA	키라웨아
KILBY	킬비
KILKENNY	킬케니
KILPINEN	킬피넨
KIMBERLEY	킴벌리
KIMBERLY	킴벌리
KINCK	킹크
KING	킹
KINGSLEY	킹즐리
KINGSTON	킹스턴
KINGSTOWN	킹스타운
KINNEAR	커니어
KINNOCK	키녹
KINSEY	킨제이
KINSHASA	킨샤사
KIOWA	카이오와
KIPLING	키플링
KIRCHER	키르허
KIRCHNER	키르히너
KIRIBATI	키리바시
KIRKLAND	커클런드
KIROV	키로프
KIRPICHNIKOV	키르피치니코프
KIRSCH	키르쉬
KIRSTEN	커스틴
KISANGANI	키상가니
KISS	키시
KISSINGER	키신저
KITCHENER	키치너
KITTY	키티
KIVI	키비
KLAGENFURT	클라겐푸르트
KLAPROTH	클라프로트
KLAUS	클라우스
KLEIN	클라인
KLEMPERER	클렘페러
KLIMT	클림트
KLINE	클라인
KLINGER	클링거
KLITZING	클리칭
KLONDIKE	클론다이크
KLOPSTOCK	클롭슈토크
KLUGE	클루게
KNIES	크니스
KNIGHT	나이트
KNIGHTLEY	나이틀리
KNOWLES	놀스
KNOX	녹스
KNUT	크누트
KNUTH	크누스
KOBLENZ	코블렌츠
KOCH	코흐
KOCHANOWSKI	코하노프스키
KOCHER	코허
KOENIGSBERGER	퀴니스버거
KOEPP	코프
KOERNER	쾨르너
KOESTLER	케스틀러
KOGAN	코간
KOHL	콜
KOHLER	콜러
KOHLRAUSCH	콜라우슈
KOHN	콘
KOIRALA	코이랄라
KOK	코크
KOKOSCHKA	코코슈카
KOLAR	콜라르
KOLAROV	콜라로프
KOLBE	콜베
KOLBENHEYER	콜벤하이어
KOLLER	콜러
KOLLWITZ	콜비츠
KOLMOGOROV	콜모고로프
KOLTSOV	콜초프
KONE	코네
KONESKI	코네스키
KONRAD	콘라트
KONSTANTINOS	콘스탄티노스
KONSTANZ	콘스탄츠
KOOPMANS	쿠프먼스
KOPP	코프
KORNEICHUK	코르네이추크
KORNFELD	콘필드
KORNGOLD	콘골드
KOROLENKO	코롤렌코
KOROR	코로르
KOSSEL	코셀
KOSTOV	코스토프
KOSYGIN	코시긴
KOTZEBUE	코체부
KOVALENKO	코발렌코
KOZLOV	코즐로프
KRAEPELIN	크레펠린
KRAFT	크라프트
KRAKOW	크라코프
KRAM	크램
KRAMER	크레이머
KRASHENINNIKOV	크라셰닌니코프
KRASNODAR	크라스노다르
KRASNOYARSK	크라스노야르스크
KRAUS	크라우스
KRAUSE	크라우제
KRAUSS	크라우스
KREISLER	크라이슬러
KREMER	크레머
KRETSCHMER	크레치머
KREUTZER	크로이처
KRIM	크림
KRISHNA	크리슈나
KRISTIN	크리스틴
KROEBER	크로버
KROEMER	크로머
KROGH	크로그
KRONECKER	크로네커
KRUCZKOWSKI	크루치코프스키
KRUEGER	크루거
KRUGER	크뤼거
KRUPP	크루프
KRUPSKAYA	크루프스카야
KRZYSZTOF	크시슈토프
KUBRICK	큐브릭
KUHLAU	쿨라우
KUHN	쿤
KUHNAU	쿠나우
KUIBYSHEV	쿠이비셰프
KULIK	쿨리크
KULIKOV	쿨리코프
KUMAR	쿠마르
KUMMER	쿠머
KUNDT	쿤트
KUNO	쿠노
KUPRIN	쿠프린
KUROPATKIN	쿠로팟킨
KURSK	쿠르스크
KURT	쿠르트
KUSCH	쿠시
KUTTER	쿠터
KUTUZOV	쿠투조프
KUWAIT	쿠웨이트
KUZNETS	쿠즈네츠
KUZNETSOV	쿠즈네초프
KYD	키드
KYRGYZSTAN	키르긴스스탄
LABAN	라반
LABRADOR	래브라도
LABUAN	라부안
LACAILLE	라카유
LACAN	라캉
LACEY	레이시
LACHMANN	라흐만
LACOMBE	라콤
LACY	레이시
LADISLAV	라디슬라프
LAFONTAINE	라퐁텐
LAFORGUE	라포르그
LAGERKVIST	라게르크비스트
LAGOS	라고스
LAGRANGE	라그랑주
LAHNSTEIN	란스테인
LAHORE	라호르
LAHTI	라티
LAIRD	레어드
LAKE	레이크
LAMA	라마
LAMAR	라마
LAMARR	라마
LAMARTINE	라마르틴
LAMB	램
LAMBERT	람베르트
LAMBETH	램버스
LAMENNAIS	라므네
LAMOUR	라무르
LAMPRECHT	람프레히트
LAMY	라미
LANCASHIRE	랭커셔
LANCASTER	랭커스터
LANCE	랜스
LANDAU	란다우
LANDERS	랜더스
LANDGREBE	랜드그레베
LANDRY	랑드리
LANDSTEINER	란트슈타이너
LANG	랑
LANGBEIN	랭바인
LANGDON	랭던
LANGE	랑에
LANGER	랑거
LANGEVIN	랑주뱅
LANGLAND	랭글런드
LANGLEY	랭글리
LANGMUIR	랭뮤어
LANGUEDOC	랑그도크
LANIER	러니어
LANNING	래닝
LANSING	랜싱
LANSON	랑송
LANVIN	랑방
LANZHAN	란잔
LAO	라오
LAOS	라오스
LAPLACE	라플라스
LAPP	라프
LAPTEV	랍테프
LARDNER	라드너
LAREDO	라레도
LARKIN	라킨
LARS	라르스
LARSEN	라르센
LASKER	래스커
LASKI	래스키
LASKY	래스키
LASSO	라소
LASSUS	라수스
LASSWELL	라스웰
LATHAM	레이담
LATIMER	레이티머
LATVIA	라트비아
LAUD	로드
LAUFER	라우퍼
LAUGHLIN	로플린
LAUGHTON	로튼
LAURA	라우라
LAUREL	라우렐
LAUREN	로렌
LAURENCE	로렌스
LAURENCIN	로랑생
LAURENS	로랑스
LAURENT	로랑
LAUSSEDAT	로세다
LAVAL	라발
LAVOISIER	라부아지에
LAW	로
LAWSON	로슨
LAWTON	로턴
LEAN	린
LEBANON	레바논
LEBEDEV	레베데프
LEBOEUF	르뵈프
LECH	레흐
LEDERBERG	레더버그
LEEDS	리즈
LEEUWENHOEK	레벤후크
LEFEBVRE	르페브르
LEHMBRUCK	렘브루크
LEICESTER	레스터
LEIPOLD	라이폴트
LEIPZIG	라이프치히
LELEWEL	렐레벨
LEMAIRE	르메르
LEMAITRE	르메트르
LEMARCHAND	르막셩
LENARD	레나르트
LENAU	레나우
LENIN	레닌
LENNART	렌나르트
LENNON	레논
LENOIR	르누아르
LENORMAND	르노르망
LENT	렌트
LENZ	렌츠
LEO	레오
LEON	레옹
LEONARD	레너드
LEONARDO	레오나르도
LEONCAVALLO	레온카발로
LEONE	레오네
LEONHARD	레온하르트
LEONID	레오니트
LEONOV	레오노프
LEOPARDI	레오파르디
LEOPOLD	레오폴드
LEPIDUS	레피두스
LEPSIUS	렙시우스
LEROY	리로이
LES	레스
LESKOV	레스코프
LESLIE	레슬리
LESOTHO	레소토
LESSEPS	레셉스
LESSING	레싱
LESZEK	레셰크
LEV	예프
LEVANT	레반트
LEVERRIER	르베리에
LEVI	리바이
LEVINE	러바인
LEVY	레비
LEWES	루이스
LEWIN	레빈
LEWIS	루이스
LEXINGTON	렉싱턴
LEYTE	레이테
LIAM	리엄
LIBBY	리비
LIBERIA	라이베리아
LIBREVILLE	리브르빌
LIBYA	리비아
LICHT	리히트
LICHTENBERG	리히텐베르크
LIDDELL	리들
LIE	리
LIEBERMAN	리버먼
LIEBERMANN	리베르만
LIEBKNECHT	리프크네히트
LIEBMANN	리프만
LIECHTENSTEIN	리히텐슈타인
LILIAN	릴리앙
LILIENTHAL	릴리엔솔
LILLE	릴
LILLEY	릴리
LILLI	릴리
LILLIAN	릴리언
LILONGWE	릴롱궤
LIM	림
LIMA	리마
LIMBURG	림부르흐
LIMERICK	리머릭
LIMOGES	리모주
LINARES	리나레스
LINCOLN	링컨
LINDA	린다
LINDBERGH	린드버그
LINDE	린데
LINDGREN	린드그렌
LINDSAY	린지
LINDSEY	린지
LING	링
LINI	리니
LINSCHOTEN	린스호텐
LINTON	린턴
LINZ	린츠
LION	리온
LIONEL	리오넬
LIPATTI	리파티
LIPCHITZ	립시츠
LIPMANN	리프먼
LIPPI	리피
LIPPMANN	리프만
LIPPS	립스
LIPTON	립턴
LISA	리사
LISBON	리스본
LISE	리제
LISSAJOUS	리사주
LIST	리스트
LISTER	리스터
LISZT	리스트
LITHUANIA	리투아니아
LITT	릿
LITTLE	리틀
LITTLETON	리틀턴
LITVINOV	리트비노프
LIVERMORE	리버몰
LIVINGSTON	리빙스턴
LIVINGSTONE	리빙스턴
LIVIUS	리비우스
LJUBLJANA	류블랴나
LLOYD	로이드
LOBE	로베
LOCKE	록
LOCKETT	로켓
LOCKHART	록하트
LODGE	로지
LOEB	러브
LOEWE	뢰베
LOEWI	뢰비
LOEWY	로위
LOFTING	로프팅
LOFTUS	로프터스
LOGAN	로건
LOIS	루이스
LOLITA	로리타
LOMBARD	롬바르드
LOMBARDI	롬바르디
LOMBARDY	롬바르디아
LOMBROSO	롬브로소
LOME	로메
LOMONOSOV	로모노소프
LONDON	런던
LONDONDERRY	런던데리
LONG	롱
LONGCHAMP	롱샹
LONGFELLOW	롱펠로
LONGMAN	롱맨
LONGO	롱고
LOPEZ	로페스
LORD	로드
LORENTZ	로렌츠
LORENZ	로렌츠
LORENZEN	로렌젠
LORENZO	로렌초
LORIN	로린
LORNA	로나
LORRAIN	로랭
LORRAINE	로렌
LOSCHMIDT	로슈미트
LOT	롯
LOTHAR	로타어
LOTHIAN	로디언
LOTT	롯
LOTTO	로토
LOUIS	루이
LOUISE	루이즈
LOUISIANA	루이지애나
LOURDES	루르드
LOVELACE	러브레이스
LOWE	로웨
LOWELL	로웰
LOWER	로베르
LOWIE	로위
LUANDA	루안다
LUBA	루바
LUBBERS	뤼베르스
LUBBOCK	러벅
LUC	뤼크
LUCA	루카
LUCAS	루카스
LUCE	루스
LUCENA	루세나
LUCHINO	루키노
LUCIA	루치아
LUCIANO	루치아노
LUCIEN	뤼시앵
LUCIUS	루치우스
LUCK	럭
LUCY	루씨
LUDOVIC	루도비
LUDWIG	루트비히
LUDWIK	루드윅
LUIGI	루이지
LUIS	루이스
LUISE	루이제
LUJO	루조
LUKE	룩크
LULLY	륄리
LUNA	루나
LUNDBERG	룬드베리
LURIA	루리아
LUSAKA	루사카
LUTHER	루터
LUTOSLAWSKI	루토슬라프스키
LUXEMBURG	룩셈부르크
LUXENBERG	록셈부루크
LVOV	리보프
LYDIA	리디아
LYELL	라이엘
LYLY	릴리
LYMAN	라이먼
LYND	린드
LYNDON	린든
LYNEN	리넨
LYNN	린
LYON	리옹
LYONNET	리오네
LYONS	리용
LYSENKO	리센코
LYTTELTON	리틀턴
LYTTON	리턴
MAAS	마스
MAASTRICHT	마스트리히트
MABEL	마벨
MACAULAY	매콜리
MACAULEY	맥콜리
MACBETH	맥베스
MACEDONIA	마케도니아
MACH	마하
MACHADO	마차도
MACHEL	마셸
MACHIAVELLI	마키아벨리
MACKAY	맥케이
MACKENZIE	매켄지
MACKINDER	매킨더
MACKINTOSH	매킨토시
MACLAREN	매클래런
MACLEAN	맥클랜
MACLEOD	매클라우드
MACMILLAN	맥밀란
MACON	마콩
MACRAE	맥레이
MACY	메이시
MADAGASCAR	마다가스카르
MADDOX	매독스
MADEIRA	마데이라
MADELEINE	마드렌
MADELINE	매들린
MADER	마더
MADGE	메쥐
MADISON	매디슨
MADRAS	마드라스
MADRID	마드리드
MAETERLINCK	메이터링크
MAFEKING	마페킹
MAGDA	마그다
MAGDALENA	막달레나
MAGDEBURG	마그데부르크
MAGEE	매기
MAGELLAN	마젤란
MAGENDIE	마장디
MAGGIE	매기
MAGNANI	마냐니
MAGNITOGORSK	마그니토고르스크
MAGNUS	마그누스
MAGUIRE	맥과이어
MAGYAR	마자르
MAHAFFY	마하피
MAHAN	머핸
MAHENDRA	마헨드라
MAHER	마헤르
MAHLER	말러
MAHMOOD	마흐무드
MAHMOUD	마무드
MAHONEY	마호니
MAIER	마이에르
MAILLOL	마욜
MAIMON	마이몬
MAINE	메인
MAINZ	마인츠
MAIOR	마이오르
MAISTRE	메스트르
MAJURO	마주로
MAKARENKO	마카렌코
MAKAROV	마카로프
MAKSIM	막심
MAL	말
MALABO	말라보
MALAMUD	맬러머드
MALAWI	말라위
MALAYSIA	말레이시아
MALCOLM	맬컴
MALDEN	몰덴
MALDIVES	몰디브
MALE	말리
MALEBRANCHE	말브랑슈
MALHERBE	말레르브
MALI	말리
MALIK	말리크
MALINOWSKI	말리노프스키
MALIPIERO	말리피에로
MALKIN	말킨
MALONE	말론
MALONEY	멀로니
MALPIGHI	말피기
MALTA	몰타
MALTHUS	맬서스
MALUS	말뤼스
MAMALONI	마말로니
MAN	맨
MANAGUA	마나과
MANAMA	마나마
MANCHESTER	맨체스터
MANCINI	맨시니
MANDALAY	만달레이
MANDELA	만델라
MANDER	만데르
MANDEVILLE	맨더빌
MANET	마네
MANFRED	만프레트
MANG	망
MANHATTAN	맨해튼
MANILA	마닐라
MANN	만
MANNHEIM	만하임
MANNING	매닝
MANRIQUE	만리케
MANSART	망사르
MANSFIELD	맨스필드
MANSON	맨슨
MANTOVANI	만토바니
MANUEL	마누엘
MANZONI	만초니
MAOR	마오
MAPUTO	마푸토
MARA	마라
MARC	마르크
MARCEL	마르셀
MARCELLO	마르첼로
MARCH	마치
MARCHAIS	마르셰
MARCIA	마르샤
MARCO	마르코
MARCONI	마르코니
MARCUS	마르쿠스
MARCUSE	마르쿠제
MARETT	매럿
MARGARET	마거릿
MARGARETE	마르가레테
MARGERY	마제리
MARGOLIS	마골리스
MARGOT	마르고트
MARGUERITE	마거리트
MARGULIS	마굴리스
MARI	마리
MARIA	마리아
MARIAN	마리안
MARIANA	마리아나
MARIANNE	마리안느
MARIE	마리
MARILYN	메릴린
MARIN	마랭
MARINA	마리나
MARINETTI	마리네티
MARINI	마리니
MARINO	마리노
MARIO	마리오
MARION	매리언
MARIT	마리트
MARITAIN	마리탱
MARIUS	마리우스
MARJATTA	마르야타
MARJORIE	마저리
MARK	마르크
MARKHAM	마캄
MARKOV	마르코프
MARKOWITZ	마코위츠
MARLENE	마를레네
MARLOWE	말로
MARNE	마른
MAROT	마로
MARQUAND	마퀀드
MARQUIS	마르키스
MARR	마르
MARRAKECH	마라케시
MARRINER	마리너
MARRIOTT	마리오트
MARS	마르스
MARSCHNER	마르슈너
MARSH	마시
MARSHALL	마셜
MARSTON	마스턴
MART	마르트
MARTENOT	마르트노
MARTHA	마사
MARTIN	마르탱
MARTINA	마르티나
MARTINDALE	마틴_데일
MARTINE	마르틴
MARTINEZ	마르티네스
MARTINI	구이도
MARTINO	마르티노
MARTINON	마르티농
MARTINS	마틴
MARTINSON	마르틴손
MARTINUS	마르티누스
MARTON	마르톤
MARTY	마르티
MARVELL	마벌
MARVIN	마빈
MARX	마르크스
MARY	메리
MARYLAND	메릴랜드
MASACCIO	마사초
MASEFIELD	메이스필드
MASERU	마세루
MASPERO	마스페로
MASSACHUSETTS	매사추세츠
MASSENET	마스네
MASSEY	매시
MASSIMO	마시모
MASSINE	마신
MASSINGER	매신저
MASSON	마송
MASTERS	마스터스
MASUR	마주어
MATAMOROS	마따모로스
MATE	메이트
MATHESON	마테존
MATHEWSON	매튜슨
MATHIAS	마티아스
MATHIEU	마티외
MATISSE	마티스
MATT	맷
MATTERHORN	마터호른
MATTHEW	마태
MATTHEWS	매슈스
MATTHIAS	마티아스
MATUTE	마투테
MAUBOUSSIN	모브상
MAUD	모드
MAUGHAM	몸
MAUPASSANT	모파상
MAUPERTUIS	모페르튀이
MAUREEN	모린
MAURER	마우러
MAURIAC	모리악
MAURICE	모리스
MAURITANIA	모리타니아
MAURITIUS	모리셔스
MAURITZ	마우리츠
MAURIZIO	마우리치오
MAURO	마우로
MAUROIS	모르와
MAURRAS	모라스
MAURUS	모뤼스
MAUSER	모제르
MAX	막스
MAXIM	맥심
MAXIME	막심
MAXIMILIAN	막시밀리안
MAXWELL	맥스웰
MAYA	마야
MAYER	마이어
MAYFLOWER	메이플라워
MAYHEW	메이휴
MAYO	메이오
MAZOWIECKI	마조비에츠키
MBABANE	음바바네
MBASOGO	음바소고
MCKENZIE	맥켄지
MEAD	미드
MEADE	미드
MEADOWS	미도우스
MEANY	미니
MECCA	메카
MECKLENBURG	메클렌부르크
MED	메드
MEDAWAR	메더워
MEDFORD	매드포드
MEDHURST	메드허스트
MEDICI	메디치
MEDINA	메디나
MEG	맥
MEHDI	메디
MEHTA	메타
MEIER	마이어
MEINDERT	마인데르트
MEINECKE	마이네케
MEIR	메이르
MEISHENG	메이성
MEISSNER	마이스너
MEITNER	마이트너
MEL	멜
MELANCHTHON	멜란히톤
MELANIE	멜라니
MELBA	멜바
MELBOURNE	멜버른
MELCHIOR	멜키오르
MELINDA	멜린다
MELISSA	멜리사
MELLON	멜런
MELO	멜로
MELVIL	멜빌
MELVILLE	멜빌
MELVIN	멜빈
MEMLING	멤링
MEMPHIS	멤피스
MENCKEN	멩켄
MENDEL	멘델
MENDELSOHN	멘델존
MENDELSSOHN	멘델스존
MENDERES	멘데레스
MENDES	멘디스
MENELAOS	메넬라오스
MENEM	메넴
MENGELBERG	멩겔베르크
MENGER	멩거
MENON	메논
MENUHIN	메뉴인
MENZEL	멘젤
MERCATOR	메르카토르
MERCOURI	메르쿠리
MEREDITH	메레디스
MERGENTHALER	머건탈러
MERI	메리
MERKEL	메르켈
MERLIN	멀린
MERRIAM	메리엄
MERRIMAN	메리먼
MERTON	머튼
MERYL	메릴
MERZ	메르츠
MESOPOTAMIA	메소포타미아
MESSER	메서
MESSERER	메세레르
MESSIAEN	메시앙
MESSIER	메시에
MESSNER	메스네르
METASTASIO	메타스타시오
METTERNICH	메테르니히
METZ	메스
METZLER	메츠러
MEUNIER	뫼니에
MEXICO	멕시코
MEYER	마이어
MEYERBEER	마이어베어
MEYERHOF	마이어호프
MEYERS	메이어스
MIAMI	마이에미
MICHAEL	마이클
MICHAUX	미쇼
MICHEL	미셸
MICHELET	미슐레
MICHELL	미첼
MICHELLE	미셸
MICHELS	미헬스
MICHELSON	마이컬슨
MICHIE	미치에
MICHIGAN	미시간
MICHNIK	미흐니크
MICK	믹
MICRONESIA	미크로네시아
MIDAS	미다스
MIDDLESEX	미들섹스
MIDDLETON	미들턴
MIDWAY	미드웨이
MIGNON	미뇽
MIGUEL	미겔
MIKE	마이크
MIKHAIL	미하일
MIKHAILOV	미하일로프
MIKOYAN	미코얀
MILAN	밀라노
MILANO	밀라노
MILDRED	밀드레드
MILES	마일스
MILESTONE	마일스톤
MILFORD	밀퍼드
MILHAUD	미요
MILL	밀
MILLAIS	밀레이
MILLAN	밀런
MILLARD	밀러드
MILLAY	밀레이
MILLER	밀러
MILLET	밀레
MILLIKAN	밀리컨
MILLS	밀스
MILNE	밀른
MILO	밀로
MILOS	밀로스
MILOSEVIC	밀로셰비치
MILOVAN	밀로반
MILSTEIN	밀스테인
MILT	밀트
MILTON	밀턴
MINAUX	미노
MINGDAO	밍다오
MINNEAPOLIS	미니애폴리스
MINNESOTA	미네소타
MINNIE	미니
MINOT	마이넛
MINSK	민스크
MIRA	미라
MIRABEAU	미라보
MIRCEA	미르체아
MIRIAM	미리엄
MIRONOV	미로노프
MIRZA	미르자
MISCHA	미샤
MISSISSIPPI	미시시피
MISSOURI	미주리
MISTRAL	미스트랄
MITCHELL	미첼
MITROPOULOS	미트로폴로스
MITSCHERLICH	미처리히
MITTERRAND	미테랑
MOBERG	모베리
MOBILE	모바일
MODENA	모데나
MODIGLIANI	모딜리아니
MOERS	모어스
MOGADISHU	모가디슈
MOGENS	모겐스
MOHAWK	모호크
MOI	모이
MOIRA	모이라
MOISSAN	무아상
MOJAVE	모하비
MOLANDER	몰란더
MOLDOVA	몰도바
MOLINA	몰리나
MOLLY	몰리
MOLNAR	몰나
MOLOTOV	몰로토프
MOLTKE	몰트케
MOMMSEN	몸젠
MONA	모나
MONACO	모나코
MONDRIAAN	몬드리안
MONET	모네
MONETA	모네타
MONGE	몽주
MONGOLIA	몽고
MONICA	모니카
MONIKA	모니카
MONIQUE	모니크
MONIUSZKO	모니우슈코
MONIZ	모니즈
MONK	멍크
MONMOUTH	몬머스
MONNIER	모니에
MONOD	모노
MONROE	먼로
MONROVIA	몬로비아
MONROY	몬로이
MONTAIGNE	몽테뉴
MONTALVO	몬탈보
MONTANA	몬태나
MONTE	몬테
MONTEIRO	몬테이루
MONTELIUS	몬텔리우스
MONTEMAYOR	몬테마요르
MONTENEGRO	몬테네그로
MONTESQUIEU	몽테스키외
MONTESSORI	몬테소리
MONTEUX	몽퇴
MONTEVERDI	몬테베르디
MONTEVIDEO	몬테비데오
MONTFORT	몽포르
MONTGOLFIER	몽골피에
MONTGOMERY	몽고메리
MONTHERLANT	몽테를랑
MONTICELLI	몽티셀리
MONTPELIER	몬트필리어
MONTPELLIER	몽펠리에
MONTREAL	몬트리올
MONTREUIL	몽트르유
MOOD	무드
MOORE	무어
MORALES	모랄레스
MORAN	모런
MORAND	모랑
MORAVIA	모라비아
MORDECAI	모르드개
MORDECHAI	모르데하이
MORE	모어
MOREAU	모로
MOREL	모렐
MORELLI	모렐리
MORENO	모레노
MORGAGNI	모르가니
MORGAN	모르건
MORGENSTERN	모르겐슈테른
MORGENTHAU	모겐쏘
MORICE	모리스
MORIN	모랭
MORISOT	모리조
MORITZ	모리츠
MORLEY	몰리
MORO	모로
MOROCCO	모로코
MORONI	모로니
MORRIS	모리스
MORRISON	모리슨
MORSE	모스
MORTON	모턴
MOSCA	모스카
MOSCOW	모스크바
MOSELEY	모즐리
MOSER	모저
MOSES	모세스
MOSHE	모셰
MOSLEY	모즐리
MOSS	모스
MOST	모스트
MOTT	모트
MOTTELSON	모텔손
MOU	머우
MOUDUD	무두드
MOUNIER	무니에
MOUNT	마운트
MOUSA	무사
MOUSSA	무사
MOUSTAPHA	무스타파
MOYSE	모이즈
MOZAMBIQUE	모잠비크
MOZART	모차르트
MUBARAK	무바라크
MUCHA	무하
MUELLER	뮬러
MUGABE	무가베
MUIR	뮤어
MUIRHEAD	뮤어헤드
MULLER	멀러
MULLIKEN	멀리컨
MULRONEY	멀로니
MUMFORD	멈퍼드
MUN	먼
MUNCH	뭉크
MUNICH	뮌헨
MUNK	뭉크
MUNSELL	먼셀
MURDOCH	머독
MURIEL	뮤리엘
MURILLO	무리요
MURIS	뮤리스
MURMANSK	무르만스크
MURNAU	무르나우
MURPHY	머피
MURRAY	마레
MURRY	머리
MUSA	무사
MUSCAT	무스카트
MUSIL	무질
MUSKOGEE	무스코기
MUSSET	뮈세
MUSSOLINI	뭇솔리니
MUTTER	무터
MUZIO	무치오
MYANMAR	먄마
MYBURGH	마이버그
MYERS	마이어스
MYRON	미론
N'DIAYE	느쟈예
NACHTIGAL	나흐티갈
NADAR	나다르
NADIA	나디아
NADINE	네이딘
NAESS	네스
NAFIS	나피스
NAGY	너지
NAHA	나하
NAHUM	나훔
NAIMAN	나이만
NAIPAUL	나이폴
NAIR	나이르
NAIROBI	나이로비
NAISBITT	네스비트
NAMIBIA	나미비아
NAMUR	나무르
NANA	나나
NANCY	낭시
NANNY	내니
NANSEN	난센
NAOMI	나오
NAPIER	네이피어
NAPLES	나폴리
NASH	내시
NASIR	나시르
NASMYTH	네이즈미스
NASSAU	나사우
NASSER	나세르
NAT	냇
NATALIA	나탈리아
NATALIE	나탈리
NATAN	나탄
NATHALIE	나탈리
NATHAN	나단
NATHANIEL	너대니얼
NATORP	나토르프
NATTA	나타
NATTIER	나티에
NAUMANN	나우만
NAURU	나우루
NAVARRA	나바라
NAVARRE	나바르
NAVARRO	나바로
NAZARETH	나사렛
NEAL	닐
NEANDER	네안더
NEBOJSA	네보이사
NEBRASKA	네브래스카
NECKER	네케르
NED	네드
NEEDHAM	니덤
NEEF	니프
NEFF	네프
NEGEV	네게브
NEGRI	네그리
NEGRO	니그로
NEGROPONTE	네그로폰테
NEHER	네어
NEHRU	네루
NEIL	닐
NEILL	닐
NEILSON	닐슨
NEISSER	나이서
NEKRASOV	네크라소프
NELLY	넬리
NELSON	넬슨
NEMANJA	네마냐
NEPAL	네팔
NERNST	네른스트
NERO	네로
NERUDA	네루다
NERVA	네르바
NERVAL	네르발
NERVO	네르보
NESMEYANOV	네스메야노프
NESTOR	네스토르
NETHERLANDS	네덜란드
NEUMANN	노이만
NEUTRA	노이트라
NEVADA	네바다
NEVELSON	니벨슨
NEVEROV	네베로프
NEWBOLT	뉴볼트
NEWCASTLE	뉴캐슬
NEWCOMB	뉴컴
NEWCOMEN	뉴커먼
NEWLANDS	뉴랜즈
NEWMAN	뉴먼
NEWPORT	뉴포트
NEWTON	뉴턴
NEY	네
NEZVAL	네즈발
NIAMEY	니아메
NICARAGUA	니카라과
NICHOLAS	니콜러스
NICHOLS	니콜스
NICHOLSON	니컬슨
NICK	닉
NICKY	니키
NICOL	니콜
NICOLA	니콜라
NICOLAE	니콜라에
NICOLAI	니콜라이
NICOLAS	니컬러스
NICOLAUS	니콜라우스
NICOLE	니콜
NICOLLE	니콜
NICOLSON	니컬슨
NICOSIA	니코시아
NIE	녜
NIEBUHR	니부어
NIELSEN	닐센
NIEUWLAND	뉴랜드
NIGEL	나이절
NIGER	니제르
NIGERIA	나이지리아
NIGHTINGALE	나이팅게일
NIJMEGEN	네이메겐
NIKE	나이키
NIKOLAEV	니콜라예프
NIKOLAEVA	니콜라에바
NIKOLAI	니콜라이
NILSON	닐손
NILSSON	닐손
NIMITZ	니미츠
NIMU	니무
NINA	니나
NINO	니노
NIPKOW	닙코
NIRENBERG	니런버그
NIXON	닉슨
NIZAN	니장
NKRUMAH	은크루마
NOAH	노아
NOBEL	노벨
NOBILE	노빌레
NOBLE	노블
NODIER	노디에
NOEL	노엘
NOETHER	뇌터
NOLAN	놀런
NOLDE	놀데
NOLTE	놀테
NONO	노노
NORA	노라
NORBERT	노르베르트
NORFOLK	노퍽
NORMAN	노르만
NORMANDY	노르망디
NORONHA	노로냐
NORRIS	노리스
NORRISH	노리시
NORTH	노스
NORTHAMPTON	노샘프턴
NORTHCLIFFE	노스클리프
NORTHROP	노스럽
NORTHUMBERLAND	노섬벌랜드
NORTON	노턴
NORWAY	노르웨이
NORWICH	노리치
NOSKE	노스케
NOSSACK	노사크
NOTTINGHAM	노팅엄
NOUAKCHOTT	누악쇼트
NOURI	누리
NOVERRE	노베르
NOVGOROD	노브고로트
NOVIKOV	노비코프
NOVOA	노보아
NOVOSIBIRSK	노보시비르스크
NOYCE	노이스
NUBIA	누비아
NUJOMA	누조마
NUKU'ALOFA	누쿠알로파
NUNES	누니스
NUNN	넌
NUREYEV	누레예프
NURMI	누르미
NYERS	네르시
OAKESHOTT	오크셔트
OAXACA	오악사카
OB	오브
OBANDO	오반도
OBERON	오베론
OBERTH	오베르트
OBRECHT	오브레히트
OCEANIA	오세아니아
OCHAB	오하프
OCHIRBAT	오치르바트
OCHOA	오초아
OCKEGHEM	오케겜
OCKHAM	오컴
OCTAVIA	옥타비아
OCTAVIO	옥타비오
ODESSA	오데사
ODETS	오데츠
ODILON	오딜롱
OFFENBACH	오펜바흐
OGBURN	오그번
OGDEN	오그던
OGILVY	오글비
OHANA	오하나
OHIO	오하이오
OHM	옴
OISTRAKH	오이스트라흐
OKEN	오켄
OKLAHOMA	오클러호마
OLANDER	올랜더
OLBRICH	올브리히
OLDENBURG	올덴부르크
OLDHAM	올드햄
OLENA	올네나
OLGA	올가
OLIVE	올리브
OLIVEIRA	올리베이라
OLIVER	올리버
OLIVIA	올리비아
OLIVIER	올리비에
OLOF	올로프
OLSON	올슨
OLYMPIA	올림피아
OLYPHANT	올리펀트
OMAHA	오마하
OMAN	오만
OMAR	오마
OMSK	옴스크
ONASSIS	오나시스
ONEGIN	오네긴
ONSAGER	온사거
ONTARIO	온타리오
OORT	오르트
OPARIN	오파린
OPITZ	오피츠
OPPENHEIMER	오펜하이머
OPPERT	오페르트
ORAN	오랑
ORANGE	오랑예
ORBAN	오르번
OREGON	오리건
OREL	오렐
ORENBURG	오렌부르크
ORESME	오렘
ORESTES	오레스테스
ORLANDO	올랜도
ORMANDY	오르먼디
ORR	오어
ORSON	오선
ORTEGA	오르테가
ORTELIUS	오르텔리우스
ORTIZ	오르티스
ORVILLE	오빌
ORWELL	오웰
OSBERT	오스버트
OSBORN	오즈번
OSBORNE	오즈번
OSCAR	오스카
OSGOOD	오스굿
OSKAR	오스카르
OSLER	오슬러
OSLO	오슬로
OSMAN	오스만
OSTADE	오스타데
OSWALD	오스발트
OTIS	오티스
OTTAWA	오타와
OTTO	오토
OUAGADOUGOU	와가두구
OUEDRAOGO	우에드라오고
OUGHTRED	오트레드
OURSLER	아워슬러
OVECHKIN	오베치킨
OVERBECK	오버베크
OVERTON	오버튼
OWEN	오웬
OWENS	오언스
OXFORD	옥스퍼드
OZENFANT	오장팡
PAAVO	파보
PABLO	파블로
PACE	페이스
PACHECO	파체코
PACHELBEL	파헬벨
PACHER	파허
PACINO	파치노
PADDY	패디
PADEREWSKI	파데레프스키
PADGETT	패젯
PADUA	파두아
PAGANINI	파가니니
PAGE	페이지
PAGNOL	파뇰
PAIGE	페이지
PAINE	페인
PAINTER	페인터
PAISIELLO	파이시엘로
PAJOU	파주
PAKISTAN	파키스탄
PALADE	펄레이드
PALAU	팔라우
PALEMBANG	팔렘방
PALERMO	팔레르모
PALESTRINA	팔레스트리나
PALGRAVE	폴그레이브
PALIKIR	팔라키르
PALISSY	팔리시
PALLADIO	팔라디오
PALLAS	팔라스
PALMA	팔마
PALME	팔메
PALMER	파머
PALMERSTON	팔머스톤
PALMIRO	팔미로
PAMELA	파멜라
PAMPAS	팜파스
PANAMA	파나마
PANDOLFI	판돌피
PANDORA	판도라
PANE	페인
PANKHURST	팽크허스트
PANOFSKY	파노프스키
PAOLO	파올로
PAPIN	파팽
PAPINI	파피니
PARAGUAY	파라과이
PARAMARIBO	파라마리보
PARDO	파르도
PARETO	파레토
PARINI	파리니
PARIS	파리
PARISH	패리쉬
PARK	파크
PARKER	파커
PARKES	팍스
PARLY	파를리
PARMA	파르마
PARRINGTON	패링턴
PARSONS	파슨스
PASCAL	파스칼
PASCOLI	파스콜리
PASOLINI	파솔리니
PASSOW	파쇼프
PASSY	파시
PASTERNACK	파스터넥
PASTERNAK	파스테르나크
PASTO	파스토
PASTOR	파스터
PATAGONIA	파타고니아
PATEL	파텔
PATER	페이터
PATERSON	패터슨
PATINIR	파티니르
PATRICE	파트리스
PATRICIA	퍼트리샤
PATRICIO	파트리시오
PATRICK	파트리크
PATTANI	파타니
PATTERSON	패터슨
PATTI	패티
PATTISON	파티슨
PATTON	패튼
PAUKER	파우케르
PAUL	바울
PAULA	폴라
PAULI	파울리
PAULINE	폴린
PAULING	폴링
PAULSEN	폴슨
PAULUS	파울루스
PAVESE	파베세
PAVLOV	파블로프
PAVLOVA	파블로바
PAX	팍스
PAXTON	팩스턴
PAYNE	펜
PAZ	파스
PEA	페냐
PEACOCK	피콕
PEANO	페아노
PEARL	펄
PEARSON	피어슨
PEARY	피어리
PECCEI	페체이
PECHSTEIN	페히슈타인
PECK	펙
PEDERSEN	피더슨
PEDRO	페드로
PEEL	필
PEETERS	페터스
PEIRCE	퍼스
PEKKA	페카
PEKKANEN	페카넨
PELEGRIN	펠레그린
PELLIOT	펠리오
PELTIER	펠티에
PEMBROKE	펨브룩
PENCK	펭크
PENDERECKI	펜데레츠키
PENELOPE	페넬로페
PENG	펑
PENN	펜
PENNSYLVANIA	펜실베이니아
PENROSE	펜로스
PENZIAS	펜지어스
PEPE	페페
PEPER	페페르
PEPYS	피프스
PERCIVAL	퍼시벌
PERCY	퍼시
PERDUE	퍼듀
PEREC	페렉
PEREIRA	페레이라
PERES	페레스
PERGOLESI	페르골레시
PERKIN	퍼킨
PERL	펄
PERLMAN	펄만
PERM	페름
PERON	페론
PEROT	페로
PERRAULT	페로
PERREAU	페로
PERRET	페레
PERRIER	페리에
PERRIN	페랭
PERRY	페리
PERSHING	퍼싱
PERSSON	페르손
PERTH	퍼스
PERTINI	페르티니
PERU	페루
PERUGINO	페루지노
PERUTZ	퍼루츠
PERUZZI	페루치
PESHAWAR	페샤와르
PESTALOZZI	페스탈로치
PETE	피트
PETER	베드로
PETERBOROUGH	피터버러
PETERSBURG	페테스부르크
PETERSON	피터슨
PETIPA	페티파
PETIT	프티
PETRA	페트라
PETRARCA	페트라르카
PETRIC	페트릭
PETRIE	피트리
PETROGRAD	페트로그라드
PETRONI	페트로니
PETROPAVLOVSK	페트로파브로스크
PETRUS	베드로
PETTENKOFER	페텐코퍼
PETTERSSON	페터슨
PETTIT	페티트
PETTY	페티
PETZOLD	펫졸트
PEVSNER	페프스너
PFEFFER	페퍼
PFEIFFER	파이퍼
PFITZNER	피츠너
PFLEIDERER	플라이테러
PHELPS	펠프스
PHIL	필
PHILADELPIA	필라델피아
PHILIP	빌립
PHILIPE	필리프
PHILIPP	필리프
PHILIPPA	필리파
PHILIPPE	필리프
PHILIPPI	빌립보
PHILIPPINES	필리핀
PHILLIPPE	필리프
PHILLIPS	필립스
PHILLPOTTS	필포츠
PHOEBE	포이베
PHOENIX	피닉스
PHYLLIS	필리스
PIAF	피아프
PIAGET	피아제
PIATIGORSKY	피아티고르스키
PIAZZETTA	피아체타
PIAZZI	피아치
PICABIA	피카비아
PICARD	피카르
PICASSO	피카소
PICCARD	피카르
PICCINNI	피친니
PICHON	피숑
PICK	피크
PICKERING	피커링
PICKFORD	픽퍼드
PIDGEON	피전
PIERCE	피어스
PIERLUIGI	피에를루이지
PIERO	피에로
PIERRE	피어
PIETER	피터
PIETRO	피에트로
PIGALLE	피갈
PIGOU	피구
PILCHER	피처
PILON	필롱
PIMENTEL	피멘텔
PINA	피나
PINEL	피넬
PINERO	피네로
PINHEIRO	피네이로
PINO	피노
PIOTROWSKI	피오트로프스키
PIPPIN	피핀
PIRAEUS	피레우스
PIRANDELLO	피란델로
PIRANESI	피라네시
PIRE	피르
PIRENNE	피렌
PIRES	피레스
PIRIE	파이리
PIRQUET	피르케
PISA	피사
PISANELLO	피사넬로
PISANO	피사노
PISAREV	피사레프
PISCATOR	피스카토르
PISSARRO	피사로
PISTON	피스턴
PITCAIRN	핏케언
PITMAN	피트먼
PITT	피트
PITTSBURGH	피치버그
PIZARRO	피사로
PLANCK	플랑크
PLATEN	플라텐
PLATO	플라톤
PLATONOV	플라토노프
PLEKHANOV	플레하노프
PODOLSKY	포돌스키
POE	포
POINT	포인트
POISEUILLE	포아즈이유
POISSON	푸아송
POITIERS	푸아티에
POLAND	폴란드
POLANYI	폴라니
POLE	폴
POLEVOI	폴레보이
POLIZIANO	폴리치아노
POLK	포크
POLLACK	폴락
POLLARD	폴라드
POLLOCK	폴록
POLLY	폴리
POLO	폴로
POLYNESIA	폴리네시아
POMPADOUR	퐁파두르
POMPEL	폼페이
POMPIDOU	퐁피두
POMPONAZZI	폼포나치
PONCE	폰스
PONCELET	퐁슬레
PONCHIELLI	폰키엘리
PONS	퐁스
PONTOPPIDAN	폰토피단
PONTORMO	폰토르모
PONTRYAGIN	폰트랴긴
POPE	포프
POPLE	포플
POPOV	포포프
PORSCHE	포르셰
PORT	포트
PORT-AU-PRINCE	포르토프랭스
PORT-OF-SPAIN	포트오브스페인
PORTA	포르타
PORTER	포터
PORTINARI	포르티나리
PORTLAND	포틀랜드
PORTMAN	포트만
PORTO-NOVO	포르토노보
PORTSMOUTH	포츠머스
PORTUGAL	포르투갈
POSADA	포사다
POSNER	포즈너
POTANIN	포타닌
POTAPENKO	포타펜코
POTSDAM	포스담
POTT	포트
POTTER	포터
POTTINGER	포틴저
POTYOMKIN	포툠킨
POUL	포울
POULENC	풀랑크
POUND	파운드
POURCEL	푸르셀
POUSSIN	푸생
POWELL	파월
POWYS	포우이스
POYNTING	포인팅
PRADO	프라도
PRAETORIUS	프레토리우스
PRAGER	프라거
PRAGUE	프라그
PRAIA	프라이아
PRANDTL	프란틀
PRASAD	프라사드
PRATA	프라타
PRATT	프랫
PREBISCH	프레비시
PREGL	프레글
PREMINGER	프레민저
PRENDERGAST	프렌더가스트
PRENTICE	프랜티스
PRESCOTT	프레스컷
PRESLEY	프레슬리
PRESTON	프레스턴
PRETORIA	프리토리아
PRETORIUS	프레토리우스
PREVIN	프레빈
PRIDE	프라이드
PRIESTLEY	프리스틀리
PRIGOGINE	프리고진
PRIMAKOV	프리마코프
PRINCE	프린스
PRINCIPE	프린시페
PRIOR	프라이어
PRISCILLA	프리실라
PRISHVIN	프리슈빈
PRITCHARD	프리처드
PROBST	프로브스트
PROCTER	프록터
PROCTOR	프록터
PROKHOROV	프로호로프
PROKOFIEV	프로코피예프
PROSPER	프로스페르
PROUDHON	프루동
PROUST	프루스트
PROUT	프라우트
PROVENCE	프로방스
PROVIDENCE	프로비던스
PRUS	프루스
PUCCINI	푸치니
PUCK	퍽
PUDOVKIN	푸도프킨
PUFENDORF	푸펜도르프
PUIG	프이그
PULCI	풀치
PULITZER	퓰리처
PULLMAN	풀먼
PUNSALMAAGIYN	푼살마긴
PUPIN	푸핀
PURCELL	퍼셀
PURDY	퍼디
PUSHKIN	푸시킨
PUTNAM	퍼트넘
PYM	핌
PYONGYANG	평양
QATAR	카타르
QI	치
QINGXIAN	칭셴
QUACKENBUSH	퀙켄부시
QUAID	퀘이드
QUANT	퀀트
QUANTZ	크반츠
QUASIMODO	콰시모도
QUAYLE	퀘일
QUEBEC	퀘벡
QUEEN	퀸
QUEENS	퀸즈
QUENEAU	크노
QUENTAL	퀜탈
QUENTIN	퀀틴
QUESADA	퀘스다
QUESNAY	케네
QUIGLEY	퀴글리
QUINN	퀸
QUINTANA	진타나
QUINTON	퀸턴
QUIRK	쿽크
QUIROGA	키로가
QUISLING	크비슬링
QUITO	키토
RAABE	라베
RABAT	라바트
RABELAIS	라블레
RABI	라비
RABIN	라빈
RABINOWITZ	라비노비츠
RACE	레이스
RACHEL	라헬
RACINE	라신
RADBRUCH	라드브루흐
RADCLIFFE	래드클리프
RADEMACHER	라데마허
RAFAEL	라파엘
RAFFLES	래플스
RAFIK	라피크
RAGUSA	라구사
RAHAL	라호르
RAHMAN	라만
RAINWATER	레인워터
RAIS	라이스
RAJ	라지
RAJIV	라지브
RAKHMANINOV	라흐마니노프
RALPH	랠프
RALSTON	랠스턴
RAMA	라마
RAMAN	라만
RAMBERT	램버트
RAMEAU	라모
RAMIREZ	라미레즈
RAMON	라몬
RAMSAY	램지
RAMSTEDT	람스테트
RAMUS	라무스
RAMUZ	라뮈
RANASINGHE	라나싱헤
RAND	랜드
RANDALL	랜달
RANDOLPH	랜돌프
RANGOON	랭군
RANIERI	라네리
RANKINE	랭킨
RANKOVIC	랑코비치
RANSOM	랜섬
RAPHAEL	라파엘
RASHID	라시드
RASMUSSEN	라스무센
RASPUTIN	라스푸틴
RATHENAU	라테나우
RATNER	레트너
RATZENHOFER	라첸호퍼
RATZINGER	라칭거
RAU	라우
RAUF	라우프
RAUL	라울
RAUSCHENBUSCH	라우션부시
RAUTIO	로티오
RAVEL	라벨
RAVEN	레이븐
RAWLINGS	롤링스
RAWLINSON	롤린슨
RAY	레이
RAYMOND	레몽
RAZIN	라진
RE	레
READ	리드
READE	리드
READING	레딩
REAGAN	레이건
REBECCA	레베카
RECORDE	레코드
RED	레드
REDFORD	레드퍼드
REDON	르동
REED	리드
REEL	릴
REEVES	리브스
REG	레지
REGAN	리건
REGER	레거
REGGIE	레지
REGINA	리자이나
REGINALD	레저널드
REGIOMONTANUS	레기오몬타누스
REHNQUIST	렌퀴스트
REICH	라이히
REICHENBACH	라이헨바흐
REICHSTEIN	라이히슈타인
REID	리드
REILLY	라일리
REINACH	라이나흐
REINECKE	라이네케
REINER	라이너
REINERS	라이너즈
REINES	라이너스
REINHARD	라인하르트
REINHARDT	라인하르트
REINHOLD	라인홀트
REIS	라이스
REISCHAUER	라이샤워
REMBRANDT	렘브란트
REMINGTON	레밍턴
RENAN	르낭
RENARD	르나르
RENATA	레나타
RENATO	레나토
RENAULT	르노
RENE	르네
RENEE	르네
RENN	렌
RENNER	레너
RENOIR	르누아르
REPIN	레핀
REPPE	레페
RESNICK	루스닉
RESPIGHI	레스피기
REUBEN	르우벤
REUCHLIN	로이힐린
REUTER	로이터
REVERE	리비어
REVUELTAS	레부엘타
REX	렉스
REYES	레이어스
REYKJAVIK	레이캬비크
REYNAUD	레노
REYNOLDS	레이놀즈
RHINE	라인
RHODES	로도스
RIBBENTROP	리벤트로프
RIBEIRO	리베이루
RIBERA	리베라
RIBOT	리보
RICARDO	리카도
RICCI	리치
RICE	라이스
RICH	리치
RICHARD	리처드
RICHARDS	리처즈
RICHARDSON	리처드슨
RICHELIEU	리슐리외
RICHET	리셰
RICHMOND	리치먼드
RICHTER	리히터
RICKEN	리켄
RICKETTS	리케츠
RICOU	리코우
RIDDICK	리딕
RIDEL	리델
RIDLEY	리들리
RIEFENSTAHL	리펜슈탈
RIEMENSCHNEIDER	리멘슈나이더
RIESMAN	리스먼
RIFKIN	리프킨
RIGA	리가
RILEY	라일리
RING	링
RINGER	링거
RIO	리우
RIPLEY	리플리
RISA	리사
RITA	리타
RITCHIE	리치
RITZ	리츠
RIVAS	리바스
RIVERA	리베라
RIVERSIDE	리버사이드
RIVLIN	리블린
RIYADH	리야드
ROALD	로알
ROBBINS	로빈스
ROBERT	로버트
ROBERTA	로버타
ROBERTO	로베르토
ROBERTS	로버츠
ROBERTSON	로버트슨
ROBESPIERRE	로베스피에르
ROBIN	로빈
ROBINSON	로빈슨
ROBLES	로블레스
ROCCO	로코
ROCHESTER	로체스터
ROCKEFELLER	록펠러
ROCKINGHAM	락킹햄
ROD	로드
RODBERTUS	로트베르투스
RODENBACH	로덴바흐
RODGERS	로저스
RODIN	로댕
RODNEY	로드니
RODRIGO	로드리고
RODRIGUES	로드리게스
RODRIGUEZ	로드리게스
ROEBUCK	로벅
ROGER	로저
ROGERS	로저스
ROGGE	로게
ROHRER	로러
ROJAS	로하스
ROLAND	롤랑
ROLF	롤프
ROLLAND	롤랑
ROLLINS	롤린스
ROLLO	롤로
ROLLS	롤스
ROMA	로마
ROMAIN	로맹
ROMAN	로만
ROMANIA	루마니아
ROMANO	로마노
ROMANOV	로마노프
ROMBACH	롬바흐
ROMBERG	롬버그
ROME	로마
ROMEO	로메오
ROMER	로머
ROMMEL	로멜
RON	론
RONALD	로널드
RONGE	롱이
ROOSEVELT	루스벨트
ROOT	루트
ROSA	로자
ROSALIE	로잘리
ROSALYN	로절린
ROSARIO	로사리오
ROSAS	로사스
ROSE	로즈
ROSEAU	로조
ROSEBERY	로즈버리
ROSEMARY	로즈마리
ROSEN	로슨
ROSENBERG	로젠베르크
ROSENBUSCH	로젠부슈
ROSETTA	로제타
ROSETTI	로세티
ROSS	로스
ROSSE	로스
ROSSELLINI	로셀리니
ROSSELLINO	로셀리노
ROSSET	로세트
ROSSETTI	로세티
ROSSI	로시
ROSSINI	로시니
ROSSO	로소
ROSTAND	로스탕
ROSTOV	로스토프
ROSTOW	로스토우
ROTH	로트
ROTHSCHILD	로스차일드
ROTTERDAM	로테르담
ROUAULT	루오
ROUS	라우스
ROUSE	로즈
ROUSSEAU	루소
ROUSSEL	루셀
ROUX	루
ROWAN	로언
ROWE	로웨
ROWELL	로웰
ROWLING	롤링
ROY	로이
ROYCE	로이스
ROZIER	로지에
RUBEN	루벤
RUBENS	루벤스
RUBIN	루빈
RUBINSTEIN	루빈슈타인
RUBY	루비
RUCKER	러커
RUDE	뤼드
RUDENKO	루덴코
RUDI	루디
RUDIGER	루디거
RUDIN	루딘
RUDOLF	루돌프
RUDOLPH	루돌프
RUGBY	럭비
RUGGIERO	루지에로
RULE	라울
RUMFORD	럼퍼드
RUMSEY	럼지
RUMSFELD	럼즈펠드
RUNEBERG	루네베리
RUNGE	룽게
RUO	뤄
RUPERT	루퍼트
RUSH	러시
RUSHDIE	루슈디
RUSK	러스크
RUSKA	루스카
RUSKIN	러스킨
RUSSEL	러셀
RUSSELL	러셀
RUSSIA	러시아
RUSSO	루소
RUTH	루스
RUTHERFORD	러더퍼드
RUYSDAEL	로이스달
RWANDA	르완다
RYAN	라이언
RYDBERG	뤼드베리
RYLE	라일
RYZHKOV	리슈코프
SAAR	자르
SAARINEN	사리넨
SABIN	세이빈
SABINE	사빈
SACCHETTI	사케티
SACHS	색스
SACRAMENTO	새크라멘토
SADAT	사다트
SADE	사드
SADI	사디
SADIK	사디크
SAGAN	세이건
SAHARA	사하라
SAID	사이드
SAILLANT	사양
SAINT	샌트
SAKHAROV	사하로프
SAL	살
SALAM	살람
SALAZAR	살라자르
SALE	사르
SALEH	살레
SALEM	살렘
SALERNO	살레르노
SALGADO	살가도
SALIH	쌀리흐
SALIM	살림
SALINGER	샐린저
SALISBURY	솔즈베리
SALLY	샐리
SALMON	살몽
SALOMON	살로몬
SALT	솔트
SALTEN	잘텐
SALVADOR	살바도르
SALVATORE	살바토레
SALVINI	살비니
SALWEEN	살윈
SALZBURG	잘츠부르크
SAM	샘
SAMAR	사마르
SAMARKAND	사마르칸트
SAMMARTINI	삼마르티니
SAMMY	새미
SAMOA	사모아
SAMPSON	샘슨
SAMSON	삼손
SAMUEL	사무엘
SAMUELSON	사무엘슨
SAMUELSSON	사무엘손
SANAA	사나
SAND	상드
SANDBURG	샌드버그
SANDERSON	샌더슨
SANDLER	산들레르
SANDRA	샌드라
SANDRO	산드로
SANDS	샌즈
SANGALLO	상갈로
SANGER	생어
SANGUINETTI	상기네티
SANKEY	생키
SANSOVINO	산소비노
SANTANA	산타나
SANTANDER	산탄데르
SANTAYANA	산타야나
SANTER	상테르
SANTIAGO	산티아고
SANTINI	상티니
SANTORIO	산토리오
SANTOS	산투스
SANZ	산스
SAPIR	사피어
SARA	사라
SARAH	사라
SARAJEVO	사라예보
SARAN	사란
SARDINIA	사르디니아
SARDOU	사르두
SARGENT	사전트
SARMIENTO	사르미엔토
SARNEY	사르네이
SAROYAN	사로이언
SARTON	사턴
SASSOON	서순
SATISH	사티쉬
SAUER	자우어
SAUL	사울
SAUSSURE	소쉬르
SAUVY	소비
SAVAGE	세비지
SAVANNAH	서배너
SAVINKOV	사빈코프
SAVIO	사비오
SAVOIE	사부아
SAVONAROLA	사보나롤라
SAXON	색슨
SAY	세
SAYCE	세이스
SAZONOV	사조노프
SCALAPINO	스칼라피노
SCALIA	스캘리아
SCHAAP	스캅
SCHACHT	샤흐트
SCHAEFFER	쉐퍼
SCHALLY	샬리
SCHARNHORST	샤른호르스트
SCHAUDINN	샤우딘
SCHAWLOW	숄로
SCHEELE	셸레
SCHEFFEL	셰펠
SCHEIDEMANN	샤이데만
SCHEIDT	샤이트
SCHELER	셸러
SCHELL	쉘
SCHELLING	셸링
SCHERMAN	셰르만
SCHIAPARELLI	스키아파렐리
SCHICKELE	시켈레
SCHIELE	실레
SCHILLER	실러
SCHILLING	실링
SCHINKEL	싱켈
SCHLAF	슐라프
SCHLEGEL	슐레겔
SCHLEICHER	슐라이허
SCHLEIDEN	슐라이덴
SCHLEIERMACHER	슐라이어마허
SCHLICK	슐리크
SCHLIEMANN	슐리만
SCHMALENBACH	슈말렌바흐
SCHMIDT	슈미트
SCHMIEDEBERG	슈미데베르크
SCHMITT	슈미트
SCHNABEL	슈나벨
SCHNEIDER	슈나이더
SCHNITZLER	슈니츨러
SCHOLES	숄스
SCHOLZ	숄츠
SCHONBERG	쇤베르크
SCHONGAUER	숀가우어
SCHOPENHAUER	쇼펜하워
SCHREKER	슈레커
SCHREYER	슈라이어
SCHRIEFFER	슈리퍼
SCHROEDER	슈로더
SCHUBERT	슈베르트
SCHULTZ	슐츠
SCHULTZE	슐체
SCHULZ	슐츠
SCHULZE	슐체
SCHUMACHER	슈마허
SCHUMAN	쉬망
SCHUMANN	슈만
SCHUMPETER	슘페터
SCHUSTER	스후스테르
SCHUTZ	슈츠
SCHWAB	슈바프
SCHWABE	슈바베
SCHWAN	슈반
SCHWANN	슈반
SCHWARTZ	슈워츠
SCHWARZ	슈왈츠
SCHWARZKOPF	슈워츠코프
SCHWEITZER	슈바이처
SCHWERIN	슈베린
SCHWINGER	슈윙거
SCHWITTERS	슈비터스
SCIPIO	스키피오
SCOFIELD	스코필드
SCOTLAND	스코틀랜드
SCOTT	스코트
SCRANTON	스크랜턴
SEABORG	시보그
SEAGA	시가
SEAMUS	셰이머스
SEAN	숀
SEARS	씨어스
SEATTLE	시애틀
SEBASTIAN	서배스천
SECCHI	세키
SECKEL	세컬
SEGAL	시갈
SEGANTINI	세간티니
SEGNI	세니
SEGOVIA	세고비아
SEGURA	세구라
SEIFERT	사이페르트
SEIPEL	자이펠
SELES	셀레스
SELIGMAN	셀리그먼
SELZNICK	셀즈닉
SEM	셈
SEMENOV	세묘노프
SEMPER	젬퍼
SEMYONOV	세묘노프
SEN	센
SENECA	세네카
SENEFELDER	제네펠더
SENEGAL	세네갈
SENGHOR	상고르
SENIOR	시니어
SENNETT	세넷
SERAFIMOVICH	세라피모비치
SERAFIN	세라핀
SERAO	세라오
SERENA	세리나
SERGE	세르게
SERGI	세르히
SERGIO	세르조
SERLIO	세를리오
SERRA	세라
SERVAIS	세르베
SERVETUS	세르베투스
SETH	셋
SETON	시턴
SEURAT	쇠라
SEUSE	조이제
SEVERINI	세베리니
SEVERO	세베로
SEVERUS	세베루스
SEWARD	슈어드
SEWELL	슈얼
SEXTON	섹스턴
SEYCHELLES	세이셸
SEYFERT	시퍼트
SEYMOUR	세이무어
SEYNI	세이니
SFORZA	스포르자
SHACKLETON	섀클턴
SHADWELL	섀드웰
SHAFTESBURY	섀프츠베리
SHAGINYAN	샤기냔
SHAH	샤아
SHAHEEN	섀힌
SHAKESPEARE	셰익스피어
SHALOM	샬롬
SHAMIR	샤미르
SHANE	쉐인
SHANNON	섀넌
SHAPLEY	섀플리
SHARAF	셰라프
SHARIF	샤리프
SHARON	샤론
SHARP	샤프
SHARPE	샤프
SHAW	쇼
SHAWN	숀
SHCHEPKIN	시쳅킨
SHEA	셰이
SHEARER	시어러
SHEFFIELD	셰필드
SHELLEY	셸리
SHELTON	셸턴
SHEPPARD	셰퍼드
SHERATON	셰러턴
SHERIDAN	셰리던
SHERMAN	셔먼
SHERRIFF	셰리프
SHERRINGTON	셰링턴
SHERRY	셰리
SHERWOOD	셔우드
SHESTOV	셰스토프
SHEVCHENKO	셰프첸코
SHIELDS	쉴드
SHIPLEY	시플리
SHIRLEY	셜리
SHLOMO	슐로모
SHOCKLEY	쇼클리
SHOEMAKER	슈메이커
SHOLES	숄스
SHOLOKHOV	숄로호프
SHORT	쇼트
SHOSTAKOVICH	쇼스타코비치
SHOUP	슈프
SHROPSHIRE	슈롭셔
SHU	수
SHUFELDT	슈펠트
SHUTE	슈트
SIBELIUS	시벨리우스
SICKEL	지켈
SICKINGEN	지킹겐
SIDGWICK	시지윅
SIDNEY	시드니
SIEGEN	지겐
SIEGFRIED	지크프리트
SIEMENS	지멘스
SIENKIEWICZ	솅키에비치
SIEWERT	시워트
SIGMUND	시그먼드
SIGOURNEY	시거니
SIGRID	시그리드
SIKORSKI	시코르스키
SIKORSKY	시코르스키
SILONE	실로네
SILVA	실바
SILVIA	실비아
SIM	심
SIMEON	시므온
SIMIC	시미치
SIMMONDS	시먼즈
SIMMONS	시먼스
SIMMS	심스
SIMON	시몬
SIMONE	시모네
SIMONOV	시모노프
SIMONS	사이먼즈
SIMPSON	신프슨
SIMROCK	짐로크
SINAI	시나이
SINCLAIR	싱클레어
SINGER	싱어
SINGH	싱
SINOWATZ	지노바츠
SISLEY	시슬레
SITWELL	시트웰
SKELTON	스켈턴
SKINNER	스키너
SKOPJE	스코페
SKRYABIN	스크랴빈
SLIM	슬림
SLOBODAN	슬로보단
SLOVAKIA	슬로바키아
SLOVENIA	슬로베니아
SLUTER	슬뤼테르
SMALL	스몰
SMALLEY	스몰리
SMEATON	스미턴
SMEDLEY	스메들리
SMELLIE	스멜리
SMETANA	스메타나
SMILES	스마일스
SMIRNOV	스미르노프
SMITH	스미스
SMITHSON	스미스슨
SMOLENSK	스몰렌스크
SMOLLETT	스몰렛
SNEH	스네
SNEIDER	스나이더
SNELL	스넬
SNIDER	스나이더
SNOW	스노
SNOWDEN	스노든
SNOWDON	스노든
SOARES	소아레스
SOBRERO	소브레로
SODDY	소디
SODOMA	소도마
SOFIA	소피아
SOKOLOFF	소콜로프
SOL	솔
SOLANA	솔라나
SOLO	솔로
SOLOGUB	솔로구프
SOLOMON	솔로몬
SOLOVYOV	솔로비요프
SOLOW	솔로
SOLTI	솔티
SOLVAY	솔베이
SOMALIA	소말리아
SOMARE	소마레
SOMBART	좀바르트
SOMERSET	서머싯
SOMMARUGA	소마루가
SOMMER	조머
SOMMERFELD	조머펠트
SOMMERFIELD	섬머필드
SONIA	소냐
SONJA	소냐
SONORA	소노라
SONYA	소냐
SOPHIE	소피
SOR	소르
SOREL	소렐
SORGE	소르주
SOROKIN	소로킨
SOROS	소로스
SOSA	소사
SOTO	소토
SOUFFLOT	수플로
SOUPAULT	수포
SOUSA	수자
SOUTER	수터
SOUTH	사우스
SOUTHAMPTON	사우샘프턴
SOUTHERN	서던
SOUTHEY	사우디
SOUTINE	수틴
SOYINKA	소잉카
SPAAK	스파크
SPADOLINI	스파돌리니
SPAIN	스페인
SPALLANZANI	스팔란차니
SPEAKES	스피크스
SPEIGHT	스페이트
SPEKE	스피크
SPEMANN	슈페만
SPENCE	스펜스
SPENCER	스펜서
SPENER	슈페너
SPENGLER	슈펭글러
SPENSER	스펜서
SPERLING	스펄링
SPERRY	스페리
SPETH	스페스
SPEYER	슈파이어
SPIEGEL	스피겔
SPIELBERG	스필버그
SPINOZA	스피노자
SPITSBERGEN	스키츠베르겐
SPITTELER	슈피텔러
SPOHR	슈포어
SPONTINI	스폰티니
SPRANGER	슈프랑거
SPRENGEL	슈프렝겔
SPRINGER	스프링거
SPRINGFIELD	스프링필드
SPRINGSTEEN	스프링스틴
SPYRI	슈피리
STACEY	스테이시
STAFFORD	스태포드
STAFFORDSHIRE	스태퍼드셔
STAHL	슈탈
STAKHANOV	스따하노프
STALIN	스탈린
STAMMLER	슈탐러
STAN	스탠
STANFORD	스탠퍼드
STANISLAV	스타니슬라프
STANLEY	스탠리
STANTON	스탠턴
STARK	슈타르크
STARLING	스탈링
STARR	스타
STAUB	스타웁
STAUDINGER	슈타우딩거
STAUDT	슈타우트
STEAD	스테드
STEEL	스틸
STEELE	스틸
STEEN	스텐
STEERS	스티어스
STEFAN	슈테판
STEFFEN	스테픈
STEFFENS	슈테펜스
STEFFI	슈테피
STEGER	슈테거
STEICHEN	스타이컨
STEIN	슈타인
STEINBECK	스타인벡
STEINBERG	스타인버그
STEINBERGER	스타인버거
STEINEM	스타이넘
STEINER	슈타이너
STEINHEIL	슈타인하일
STEINMETZ	스타인메츠
STELLA	스텔라
STENO	스테노
STEPHAN	슈테판
STEPHANIE	스테파니
STEPHANOPOULOS	스테파노풀로스
STEPHEN	스티븐
STEPHENSON	스티븐슨
STERN	슈테른
STERNBERG	스턴버그
STERNE	스턴
STEVE	스티브
STEVEN	스티븐
STEVENS	스티븐스
STEVENSON	스티븐슨
STEVIN	스테빈
STEWART	스튜어트
STIEGLITZ	스티글리츠
STIFTER	슈티프터
STIG	스티게
STIGLER	스티글러
STIGLITZ	스티글리츠
STILLER	스틸레르
STILWELL	스틸웰
STIMSON	스팀슨
STIPE	스티페
STIRLING	스터링
STIRNER	슈티르너
STOCKHAUSEN	슈토크하우젠
STOCKHOLM	스톡홀름
STOCKMAN	스토크먼
STOCKTON	스톡턴
STOCKWELL	스톡웰
STODDARD	스토다드
STODOLA	스토도라
STOKES	스토크스
STOKOWSKI	스토코프스키
STOLTENBERG	슈톨텐베르크
STOLYPIN	스톨리핀
STOLZ	스톨츠
STONE	스톤
STONEHENGE	스톤헨지
STONEY	스토니
STORM	슈토름
STOSS	슈토스
STOWE	스토
STOYANOV	스토야노프
STRACHEY	스트레이치
STRAFFORD	스트래퍼드
STRAND	스트랜드
STRANG	스트랭
STRASBURGER	슈트라스부르거
STRASSER	스트라저
STRASSMANN	슈트라스만
STRAUB	스트라우브
STRAUSS	슈트라우스
STRAVINSKY	스트라빈스키
STRESEMANN	슈트레제만
STRICK	스트릭
STRICKLAND	스트릭랜드
STROESSNER	스트로에스네르
STUART	스튜어트
STUMPF	슈툼프
SUCRE	수크레
SUDAN	수단
SUDBURY	서드베리
SUDERMANN	주더만
SUE	쉬
SUESS	쥐스
SUFFOLK	서퍽
SUK	수크
SULA	수라
SULLA	술라
SULLIVAN	설리번
SULLY	쉴리
SULTAN	술탄
SUMAROKOV	수마로코프
SUMATRA	수마트라
SUMMER	사마
SUMMERS	서머스
SUMNER	섬너
SUNDAY	선데이
SUPERVIELLE	쉬페르비엘
SUQI	쑤치
SURIKOV	수리코프
SURINAME	수리남
SURREY	서리
SUSAN	수잔
SUSANNA	수산나
SUSANNE	주자네
SUSIE	수지
SUSLOV	수슬로프
SUTHERLAND	서덜랜드
SUTTER	수터
SUTTNER	주트너
SUTTON	서턴
SUVA	수바
SUZANNE	수잔
SVEN	스벤
SVEND	스벤
SVENSSON	스벤손
SVERDLOVSK	스베르들로프스크
SVERDRUP	스베르드루프
SVEVO	스베보
SWAMI	스와미
SWAMMERDAM	스왐메르담
SWAN	스완
SWAZILAND	스와질란드
SWEDEN	스웨덴
SWEDENBORG	스베덴보리
SWEELINCK	스벨링크
SWEET	스위트
SWIFT	스위프트
SWINBURNE	스윈번
SWITZERLAND	스위스
SYDENHAM	시드넘
SYDNEY	시드니
SYDOW	시도
SYLVAIN	실뱅
SYLVESTER	실베스터
SYLVIA	실비아
SYMINGTON	사이밍턴
SYMONDS	시먼즈
SYMONS	시먼스
SYNGE	싱
SYRIA	시리아
SYSE	쉬세
SZELL	셀
SZIGETI	시게티
SZILARD	질라드
SZYMANOWSKI	시마노프스키
TAFT	태프트
TAGLIONI	탈리오니
TAGORE	타고르
TAHITI	타히티
TAINE	텐
TAIT	타이트
TAJIKISTAN	타지키스탄
TAJO	타호
TALBOT	톨벗
TALCOTT	탤컷
TALLAHASSEE	탤러해시
TALLINN	탈린
TALLIS	탤리스
TAMAYO	타마요
TAMIR	타미르
TAMM	탐
TANG	당
TANGIER	탠지어
TANGUY	탕기
TANSLEY	탠슬리
TANZANIA	탄자니아
TARAWA	타라와
TARKINGTON	타킹턴
TARRANT	타란트
TARTINI	타르티니
TASHA	타샤
TASHKENT	타슈켄트
TASMAN	타스먼
TASSO	타소
TATE	테이트
TATIANA	타티아나
TATUM	테이텀
TAUBE	타우버
TAULER	타울러
TAUNTON	톤턴
TAUSSIG	타우시그
TAVARES	타바레스
TAVERNER	타베너
TAYA	타야
TAYLOR	테일러
TEAGARDEN	티가든
TEAGUE	티그
TEASDALE	티즈데일
TED	테드
TEGUCIGALPA	테구시갈파
TEHRAN	데헤란
TEITELBAUM	타이텔바움
TEIXEIRA	테이셰이라
TELLER	텔러
TEMIN	테민
TEMPEST	템페스트
TEMPLE	템플
TEMPLETON	템플턴
TENDRYAKOV	텐드랴코프
TENNANT	테넌트
TENNESSEE	테네시
TENNYSON	테니슨
TERBORCH	테르보르히
TERESA	테레사
TERRA	테라
TERRY	테리
TESSA	테사
TEXAS	텍사스
THACKERAY	새커리
THADDEUS	다대오
THAILAND	타이
THATCHER	대처
THAYER	세이어
THEBES	테베
THEILER	타일러
THEO	테오
THEOBALD	시어벌드
THEODOR	테어도어
THEODORE	시어도어
THERESA	테레사
THIERS	티에르
THIMPHU	팀부
THOMA	토마
THOMAS	도마
THOMASIUS	토마지우스
THOMPSON	톰슨
THOMSEN	톰센
THOMSON	톰슨
THOR	토르
THOREAU	소로
THOREZ	토레즈
THORNDIKE	손다이크
THORNE	쏜
THORNTON	손튼
THORPE	소프
THORVALDSEN	토르발센
THURNWALD	투른발트
THYSSEN	티센
TIBERIUS	티베리우스
TIELE	틸레
TIEPOLO	티에폴로
TIFFANY	티파니
TIGER	타이거
TIJUANA	티후아나
TIKHONOV	티호노프
TILAK	틸라크
TILGHMAN	틸먼
TILMAN	틸만
TIM	팀
TIMOSHENKO	티모쉔코
TIMOTHY	티머시
TINA	티나
TINBERGEN	틴버겐
TINDEMANS	틴데만스
TING	팅
TIPPETT	티펫
TIRANA	티라나
TISCHBEIN	티슈바인
TISELIUS	티셀리우스
TISO	티소
TITCHENER	티치너
TITO	티토
TITULESCU	티툴레스쿠
TITUS	디도서
TOBEY	토비
TOBIAS	토비아스
TOBIN	토빈
TODD	토드
TODOR	토도르
TOFFLER	토플러
TOGLIATTI	톨리아티
TOGO	토고
TOIVO	토이보
TOLAND	톨런드
TOLEDO	털리도
TOLKIEN	톨킨
TOLLER	톨러
TOM	톰
TOMA	토마
TOMMY	토미
TOMSK	톰스크
TONER	토너
TONGA	통가
TONI	타니
TONY	토니
TOPEKA	토피카
TOPELIUS	토펠리우스
TORA	토라
TORINO	토리노
TORMOD	토모드
TORONTO	토론토
TORQUATO	토르콰토
TORRENCE	토런스
TORRENS	토런스
TORRES	토레스
TORRICELLI	토리첼리
TORSTEN	톨스턴
TOSCANELLI	토스카넬리
TOSTI	토스티
TOURAINE	투렌
TOURNEUR	터너
TOWNES	타운스
TOWNSEND	타운센드
TOYNBEE	토인비
TRACY	트레이시
TRAUTMANN	트로트만
TREITSCHKE	트라이치케
TRENDELENBURG	트렌델렌부르크
TRENTON	트렌턴
TREVELYAN	트리벨리언
TREVITHICK	트레비식
TRICIA	트리시아
TRIER	트리어
TRIESTE	트리에스테
TRIMBLE	트림블
TRINIDAD	트리니다드
TRIPOLI	트리폴리
TRIPOLITANIA	트리폴리타니아
TRISTAN	트리스탕
TRISTRAM	트리스트럼
TROLLOPE	트롤럽
TROY	트로이
TRUDEAU	트뤼도
TRUJILLO	트루히요
TRUMAN	트루먼
TRYGVE	트뤼그베
TUCCI	투치
TUDOR	투도르
TULA	툴라
TULASNE	툴라슨
TUNIS	튀니스
TUNISIA	튀니지
TUPOLEV	투폴레프
TURCO	투르코
TURGENEV	투르게네프
TURGOT	튀르고
TURIN	투린
TURING	튜링
TURK	터키
TURKEY	터키
TURKMENISTAN	투르크메니스탄
TURNER	터너
TUSSAUD	터소
TUTU	투투
TUVALU	투발루
TWARDOWSKI	트와르도프스키
TWEED	데도
TWINING	트와이닝
TYLOR	타일러
TYNDALE	틴들
TYNDALL	틴들
TYUTCHEV	튜체프
UCCELLO	우첼로
UEBERWEG	유버벡
UGANDA	우간다
UGARTE	우가르테
UGO	우고
UKRAINE	우크라이나
ULAANBAATAR	울란바토르
ULANOVA	울라노바
ULISES	율리시스
ULLMAN	울만
ULRICH	울리히
UMBERTO	움베르토
UNAMUNO	우나무노
UNDERWOOD	언더우드
UNDSET	운세트
UNGARETTI	웅가레티
UNGARO	웅가로
UNGER	웅거
UNSWORTH	언스워스
UPDIKE	업다이크
URBAIN	위르뱅
URBAN	우르반
UREY	유리
URIBE	우리베
URSULA	우즐라
URUGUAY	우루과이
USTINOV	유스티노프
UTAH	유타
UTE	우트
UTRECHT	위트레흐트
UTRILLO	유트릴로
UWE	우베
UZBEKISTAN	우즈베키스탄
UZI	우지
VADUZ	파두츠
VAILLAND	바양
VAILLANT	바양
VAKHTANGOV	바흐탕고프
VALADON	발라동
VALDES	발데스
VALDIVIA	발디비아
VALENCIA	발렌시아
VALENTIN	발렌틴
VALENTINE	발렌타인
VALENTINO	발렌티노
VALERA	발레라
VALERI	발레리
VALERIE	발레리
VALERO	발레로
VALERY	발레리
VALLA	발라
VALLEJO	바예호
VALLETTA	발레타
VALOIS	발루아
VAN	반
VANCE	번스
VANCOUVER	밴쿠버
VANE	베인
VANUATU	바누아투
VARDI	바르디
VARENIUS	바레니우스
VARGA	바르가
VARGAS	바르가스
VARRO	바로
VASARI	바사리
VASILEVSKAYA	바실레프스카야
VATICAN	바티칸
VAUBAN	보방
VAUCANSON	보캉송
VAUGHAN	본
VAUVENARGUES	보브나르그
VAVILOV	바빌로프
VAZOV	바조프
VEBLEN	베블런
VECELLIO	베첼리오
VEEN	빈
VEGA	베가
VELAYATI	벨라야티
VELLA	벨라
VENEZIA	베네치아
VENEZIANO	베네치아노
VENEZUELA	베네수엘라
VENN	벤
VENTER	벤터
VENTURA	벤츄라
VENTURI	벤투리
VERDI	베르디
VERDIER	베르디에
VERDUN	베르됭
VERESAEV	베레사예프
VERGA	베르가
VERHAEREN	베르하렌
VERHOEVEN	버호벤
VERISSIMO	베리시모
VERLAINE	베를렌
VERMEER	베르메르
VERMONT	버몬트
VERNE	베른
VERNER	베르너
VERNET	베르네
VERONA	베로나
VERONESE	베로네세
VERONICA	베로니카
VERROCCHIO	베로키오
VERSAILLES	베르사유
VERTOV	베르토프
VERWEY	페르웨이
VESAAS	베소스
VESPUCCI	베스푸치
VESUVIUS	베수비오
VIC	빅
VICENTE	비센테
VICO	비코
VICTOR	빅터
VICTORIA	빅토리아
VICTORIEN	빅토리앵
VIDELA	비델라
VIDOR	비더
VIENNA	비엔나
VIENTIANE	비엔티안
VIEUXTEMPS	비외탕
VIGANO	비가노
VIGELAND	비겔란
VIGNOLA	비뇰라
VIGO	비고
VIKING	바이킹
VIKTOR	빅토르
VILA	빌라
VILLA	빌라
VILLANI	빌라니
VILLANUEVA	빌라누에바
VILLON	비용
VINAY	비나이
VINCENT	뱅상
VINCENZO	빈첸초
VINCI	빈치
VINOGRADOFF	비노그라도프
VINOGRADOV	비노그라도프
VIOLA	비올라
VIOLET	바이올렛
VIOTTI	비오티
VIRCHOW	피르호
VIRGIL	버질
VIRGINIA	버지니아
VIRTANEN	비르타넨
VISCHER	피셔
VISCONTI	비스콘티
VITO	비토
VITTORINI	비토리니
VITTORIO	비토리오
VIVALDI	비발디
VIVES	비베스
VIVIAN	비비언
VIVIEN	비비언
VLADIMIR	블라디미르
VLADISLAV	블라디슬라프
VLADIVOSTOK	블라디보스토크
VOGEL	포겔
VOGT	포크트
VOIGHT	보이트
VOIGT	포크트
VOISIN	브와쟁
VOLCKER	볼커
VOLGA	볼가
VOLGOGRAD	볼고그라드
VOLKOV	볼코프
VOLPI	볼피
VOLTA	볼타
VOLTAIRE	볼테르
VONDEL	폰델
VORONIN	보로닌
VORONTSOV	보론초프
VOROSHILOV	보로실로프
VOSS	포스
VOUET	부에
VOYNICH	보니치
WAAGE	보게
WACKENRODER	바켄로더
WADE	와데
WAGNER	바그너
WAIGEL	바이겔
WAIKIKI	와이키키
WAKEFIELD	웨이크필드
WAKSMAN	왁스먼
WALCOTT	월컷
WALD	월드
WALDEN	웰던
WALDHEIM	발트하임
WALES	웨일스
WALESA	바웬사
WALEY	웨일리
WALKER	워커
WALLACE	월리스
WALLACH	발라흐
WALLENSTEIN	발렌슈타인
WALLIS	윌리스
WALLON	왈롱
WALPOLE	월폴
WALSH	왈시
WALSINGHAM	월싱엄
WALT	월트
WALTARI	발타리
WALTER	발터
WALTHAM	월섬
WALTHER	발터
WALTON	월턴
WAND	반트
WANDA	완다
WANGCHUCK	왕추크
WARBURG	바르부르크
WARD	워드
WARDEN	와든
WARE	웨어
WARHOL	워홀
WARNER	워너
WARREN	워런
WARSAW	바르샤바
WARTBURG	바르트부르크
WARWICK	워릭
WARWICKSHIRE	워릭셔
WASHINGTON	워싱턴
WASSERMANN	바세르만
WASSILY	바실리
WATERBURY	워터베리
WATERFORD	워터퍼드
WATERLOO	워털루
WATERS	워터스
WATSON	왓슨
WATT	와트
WATTS	와트
WAUGH	워
WAYLAND	웨일랜드
WAYNE	웨인
WEAVER	위버
WEBB	웨브
WEBER	웨버
WEBERN	베베른
WEBSTER	웹스터
WEDDELL	웨들
WEDEKIND	베데킨트
WEDGWOOD	웨지우드
WEGENER	베게너
WEIDENREICH	바이덴라이히
WEIDMAN	와이드먼
WEIERSTRASS	바이어슈트라스
WEIL	바일
WEINBERG	와인버그
WEINBERGER	와인버거
WEINGARTNER	바인가르트너
WEINHEBER	바인헤버
WEISMANN	바이스만
WEISS	바이스
WEIYI	웨이이
WEIZMAN	바이츠만
WEIZMANN	바이츠만
WELCH	웰치
WELHAVEN	벨하벤
WELLER	웰러
WELLES	웰스
WELLESLEY	웰즐리
WELLINGTON	웰링턴
WELLS	웰스
WELTY	웰티
WEND	웬드
WENDERS	벤더스
WENDY	웬디
WERFEL	베르펠
WERGELAND	베르겔란
WERNER	베르너
WERNICKE	베르니케
WERTH	웰스
WERTHEIMER	베르트하이머
WESLEY	웨슬리
WESLEYAN	웨슬리
WEST	웨스트
WESTERBERG	베스테르베리
WESTERGAARD	웨스터가드
WESTERMARCK	웨스터마크
WESTINGHOUSE	웨스팅하우스
WESTON	웨스턴
WESTWOOD	웨스트우드
WETZEL	웨젤
WEYDEN	바이덴
WEYGAND	베강
WEYL	바일
WHALE	웨일
WHARTON	와튼
WHEATLEY	위틀리
WHEATSTONE	휘트스톤
WHEELOCK	휠락
WHIPPLE	휘플
WHISTLER	휘슬러
WHITAKER	휘태커
WHITE	화이트
WHITEHEAD	화이트헤드
WHITELAW	화이틀로
WHITFIELD	휫필드
WHITMAN	휘트먼
WHITNEY	휘트니
WHITTALL	휫톨
WHITTIER	휘티어
WHITWORTH	휘트워스
WHORF	워프
WHYMPER	휨퍼
WICKHAM	위컴
WICKSELL	빅셀
WIECHERT	비헤르트
WIELAND	빌란트
WIEMAN	위먼
WIEN	빈
WIENER	위너
WIENIAWSKI	비에니아프스키
WIESBADEN	비스바덴
WIESEL	비셀
WIESER	비저
WIGHT	와이트
WIGNER	위그너
WILBERFORCE	윌버포스
WILBUR	윌버
WILDE	와일드
WILDER	와일더
WILFRED	윌프레드
WILHELM	빌헬름
WILKE	윌크
WILKES	윌크스
WILKINS	윌킨스
WILKINSON	윌킨슨
WILL	윌
WILLCOCKS	윌콕스
WILLEM	빌렘
WILLEMSTAD	빌렘스타트
WILLI	빌리
WILLIAM	빌리암
WILLIAMS	윌리엄스
WILLIAMSON	윌리엄슨
WILLIS	윌리스
WILLOUGHBY	윌루비
WILLY	빌리
WILM	빌름
WILSON	윌슨
WILTON	윌턴
WILTSHIRE	윌트셔
WIM	빔
WIMBLEDON	윔블던
WINCHESTER	윈체스터
WINCKELMANN	빙켈만
WINDAUS	빈다우스
WINDELBAND	빈델반트
WINDHOEK	빈트후크
WINDSOR	윈저
WINFRIED	윈프레드
WINGROVE	윈그로브
WINKLER	빙클러
WINNIE	위니
WINSTON	윈스턴
WINTERS	윈터스
WINTHROP	윈스럽
WISCONSIN	위스콘신
WISE	와이즈
WISLICENUS	비슬리체누스
WISSLER	위슬러
WIT	비트
WITHERS	위더스
WITTENBERG	비텐베르크
WITTFOGEL	비트포겔
WITTGENSTEIN	비트겐슈타인
WITTIG	비티히
WITZ	비츠
WLODZIMIERZ	블로치미에르츠
WODEHOUSE	우드하우스
WOHLFAHRT	볼파르트
WOLCOTT	월코트
WOLE	월레
WOLF	볼프
WOLFE	울프
WOLFERS	월퍼스
WOLFF	볼프
WOLFGANG	볼프강
WOLFOWITZ	울포위츠
WOLFRAM	월프람
WOLFRUM	월프럼
WOLKER	볼케르
WOLLASTON	울러스턴
WOLLSTONECRAFT	울스턴크래프트
WOLSEY	울지
WOLVERHAMPTON	울버햄턴
WOOD	우드
WOODROW	우드로
WOODS	우즈
WOODWARD	우드워드
WOODWORTH	우드워스
WOOLF	울프
WOOLLEY	울리
WORCESTER	우스터
WORDSWORTH	워즈워스
WORKMAN	워크맨
WORMS	보름스
WORTHY	워디
WRANGEL	브랑겔
WREN	렌
WRIGHT	라이트
WRIGHTSON	라이트슨
WUNDT	분트
WYATT	와이엇
WYCHERLEY	위철리
WYCLIFFE	위클리프
WYLER	와일러
WYOMING	와이오밍
XAVIER	자비에르
XENAKIS	크세나키스
XENOPHON	크세노폰
XIE	셰
XIZHEN	시전
YAHYA	야히아
YALA	얄라
YALE	예일
YAMOUSSOUKRO	야무수크로
YANGON	양곤
YAO	야오
YAOUNDE	야운데
YASIN	야신
YASSIN	야신
YATES	예이츠
YEHUDI	예후디
YEMEN	예멘
YITZHAK	이츠하크
YORK	요크
YORKE	요크
YORKSHIRE	요크셔
YORKTOWN	요크타운
YOUNG	영
YOUNGSTOWN	영스타운
YUL	율
YUNIS	유니스
YVETTE	이베뜨
YVON	이봉
YVONNE	이본느
ZACHARIAS	자카리아스
ZADORNOV	자도르노프
ZAGREB	자그레브
ZAHN	잰
ZAIRE	자이르
ZAJAC	자자크
ZAKARIA	자카리아
ZAMBEZI	잠베지
ZAMBIA	잠비아
ZAMBONI	잠보니
ZAMORA	사모라
ZANETTI	사네티
ZANNINI	재니니
ZANZIBAR	잔지바르
ZAPATA	사파타
ZARAGOZA	사라고사
ZASULICH	자술리치
ZBIGNIEW	즈비그니에프
ZDENEK	즈데넥
ZEELAND	젤란드
ZEEMAN	제만
ZEISS	차이스
ZEMAN	제만
ZEMSKOV	젬스코프
ZENO	제논
ZEPPELIN	체펠린
ZETKIN	체트킨
ZEYER	쩌예얼
ZHAOZHEN	자오전
ZHDANOV	주다노프
ZHUKOV	주코프
ZIEGLER	치글러
ZIMBABWE	짐바브웨
ZIMMER	치머
ZIMMERMAN	짐머만
ZIMMERMANN	치머만
ZIMMERN	짐메른
ZINZENDORF	친첸도르프
ZION	시온
ZOLA	졸라
ZORAN	조란
ZORN	소른
ZORRILLA	소리야
ZUCKMAYER	추크마이어
ZUNZUNEGUI	순수네기
ZURICH	취리히
ZWEIG	츠바이크
ZWINGLI	츠빙글리
