万兹	wands
丘吉尔	churchill
丹塔斯	dantas
丹尼森	denison
丽贝卡	rebecca
久拉什	duras
乌里布鲁	uriburu
乔基姆	joachim
乔布	job
乔斯塔德	jorstad
乔登	jorden
云格	jung
亚历山德里	alecsandri
亚尼	jany
亨宁	henning
亨尼	henney
亨德肖特	hendershot
亨登	hendon
亨谢尔	hunscher
伊克林	ikerrin
伊卡伯德	ichabod
伊姆利	imlay
伊姆勒	imler
伊尔德	eerde
伊尔雷斯	ilraith
伊帕季耶夫	ipatieff
伊格尔	eagle
伊格纳季耶夫	ignatiev
伊登	eadon
伊萨多	isador
伍兹利	woozley
伍尔福德	woolfrod
伍拉科特	woolacott
休恩梅克	schoonmaker
伦丁	lundeen
伦奇	wrench
伯伊森	boisen
伯克尔曼	bockelman
伯克林	burklin
伯兹曼	bozeman
伯加德	bogard
伯加德斯	bogardus
伯尼奥尔	bonior
伯尼拉	bonilla
伯恩特	berndt
伯格万	burgevine
伯格姆	gergherm
伯格莫泽	bergmoser
伯维尔	bovill
伯蒙特	beaumont
伯达尼尔	berdanier
伯雷斯	burress
佛得角共和国	republic of cape verde
佩勒齐	pellerzi
佩奇曼	pechman
佩尔谢	pelshe
佩尔顿	pelton
佩扎里	pezzari
佩斯金	peskin
佩蒂弗	pettifor
佩雷拉	pereira
保尔斯	pauls
克兰伯格	kreymbourg
克兰曼	kleinman
克利文格	cleavenger
克劳利	crawley
克劳迪	claudy
克卢菲尔德	klufeld
克尔图亚拉	keltuyala
克拉夫顿	crafton
克拉恩	krahn
克拉格特	clagett
克拉纳汉	clanahan
克拉迪	clardy
克朗米勒	cronmiller
克林布尔	crymble
克林曼	clingman
克洛基	clokey
克洛诺沃	klonower
克罗伊瑟	kreuser
克罗恩	crohn
克莫德	kermode
克莱夫	clive
克莱德温	cledwyn
克莱恩	clain
克莱查克	klechak
克莱纳根	clenaghan
克莱蒙	clemon
克莱蒙斯	clemons
克莱里季斯	clerides
克里斯皮	crispi
克雷佐夫	kerezov
克雷文斯	cravens
克鲁利茨	krulitz
克鲁德尔	crudele
克鲁索	crusoe
克鲁青格	crutsinger
兰伯恩	lamborn
兰佩尔	lampell
兰塞姆	ransom
兰金	rankin
兰齐	lantzy
内丁	nadine
内切尔	netscher
内斯瓦德巴	nesvadba
内林	nehring
凯内尔姆	kenelm
凯姆	kaim
凯尔特纳	keltner
凯弗	keffer
凯彻姆	ketchum
凯洛格	kellogg
凯琳	kerin
凯蒂	katie
切里托	cerrito
列舍特尼科夫	reshetnikov
利伯维尔	libreville
利克莱特	leichliter
利布鲁克	lybrook
利平	lipin
利斯利	leathley
利普	lippe
利普许茨	lipschutz
利曾伯格	litzenberg
利欣	liesching
利波维茨	lipowitz
利登斯	lydens
利维	leavey
利萨戈	lisagor
别洛乌索夫	belousov
加兰托	galanto
加利科	gallico
加尔迪	galdi
加尼茨	garnitz
加布里埃尔森	gabrielson
加拉乔拉	garagiola
加拉尔	gallalle
加拉拉蒂	callarati
加拉蒂	galaty
加斯帕德	gaspard
加斯廷	garstin
加特利	gartley
加瑟	gasser
加西特	gassett
加迪斯	gaddis
加雷斯	gareth
劳利希特	laulicht
劳夫	rauf
劳巴克	laubach
劳帕赫	raupach
劳普	laupp
劳韦里斯	lauwerys
勒克莱尔	leclaire
勒布斯多夫	leubsdorf
勒平	leupin
南基韦尔	nankivell
南塞尔	nensel
南美洲大陆	south american continent
博伦	bolen
博内特	bonet
博恩斯坦	bornstein
博舍尔	boshier
卡丁	cardim
卡亨	kahan
卡兰德	callander
卡兹默	kazmer
卡内韦	canevet
卡利森	callison
卡塞雷斯	caceres
卡尔片科	karpenko
卡尔瓦豪斯	culvahouse
卡尔维特	calvit
卡尼夫	caniff
卡布里尔森	cabrielson
卡布雷拉	cabrera
卡扎利斯	cazalis
卡拉克里斯蒂	caracristi
卡拉梅辛斯	karamessines
卡斯塔涅	castanier
卡斯莱克	karshlake
卡斯顿圭	castonguay
卡普图尔	kaptur
卡普尔斯	caples
卡曾斯	cousins
卡林斯	cullins
卡梅伦	cameron
卡滕斯	catterns
卡珀特	cappeart
卡瓦略	carvalho
卡瓦诺	cavanaugh
卡罗维拉诺	carovillano
卡茨基	kartzke
卡莱斯	carles
卡萨扎	casazza
卡西利	cassilly
卡费尔	cuffell
卡钦斯	catchings
卢伯克	lubbock
卢拉姆	looram
卢特约翰	lutterjohann
卢肯	lucan
卢西恩	lucian
厄尔利	early
厄尔布	erb
厄恩利	ernle
厄舍克	isik
古奇	gooch
叶罗申科	eroshenko
吉万	givan
吉内蒂	gennetti
吉尔	gear
吉尔古德	gielgud
吉尔德罗伊	gilderoy
吉尔菲兰	gilfillan
吉尼	genee
吉托默	gitomer
吉洛特	gillot
吉米	jimmy
吉米尼亚尼	gemignani
吉耶梅特	guillemette
吉达	jidda
吕宁	luening
哈伊	khai
哈克姆	harcum
哈加德	huggard
哈夫彭尼	halfpenny
哈夫曼	haveman
哈尔彭	halpern
哈尔斯	hales
哈拉尔	harral
哈特威克	hartwick
哈登伯格	hardenbergh
哈维特	harvitt
哈考特	harcourt
哈莫尼	hamoney
哈默斯利	hammersley
唐伊	donghi
唐奈	donell
唐科	donkor
图尔斯特鲁普	thulstrup
圣地亚哥	santiago
坎内拉	cannella
坎德利斯	candless
坎德洛尔	candelore
坎特	canter
坎班	kamban
坎皮奥利	campioli
坎迪	candee
坦克维尔	tankerville
坦克雷德	tancred
坦纳鲍姆	tannebaum
坦西	tansey
坦西尔	tansil
埃丝特	esther
埃伦伯格	ehrenberg
埃克布洛姆	ekblom
埃兹尔	edsall
埃勒	ehle
埃勒森	ellertson
埃基克森	echikson
埃夫兰	eveland
埃尔博根	elbogen
埃尔德顿	elderton
埃尔瑟	elser
埃尔达夫	elduff
埃巴特	ebbutt
埃布尔	eble
埃希巴赫	aeschbacher
埃弗顿	everton
埃斯特科特	estcourt
埃斯蒙德	esmond
埃斯韦格	eschwege
埃杰维特	ecevit
埃格洛夫	eglof
埃瓦里斯特	evarist
埃米琳	emmeline
埃维斯	aves
埃维莉娜	evelina
埃贝斯泰因	eberstein
埃迪塔	edita
基基布勒	kibler
基尔迪	kildee
基希海默尔	kirchheimer
基洛	killough
基洛普	killop
塔巴科夫	tabakov
塔普斯科特	tapscott
塔顿	tatton
塞佩尔	seipel
塞奇威克	sedgwick
塞尔	serre
塞尔伯恩	selborne
塞尔屈	sercu
塞恩	sain
塞拉蓬	cerabone
塞滕布里尼	settembrini
塞特林顿	settrington
塞登	seddon
塞西莉亚	cecilia
塞贝里	seberg
夏帕	schiappa
夏莱恩	charlayne
多丽丝	doris
多克赛	docksai
多尔曼	dallman
多德	dod
多恩伯格	dornberg
多特	dott
多特韦克	dotterweich
大洋洲	oceania
太格特	tigert
太默	theimer
奇瓦特罗	chivatero
奇默林	chimerine
奈特利	knightley
奈顿	knighton
奎格尔	quiggle
奎贝尔	quibell
奥克利里	oclery
奥克斯纳德	oxnard
奥克特曼	ochtman
奥利克	aulick
奥卡拉汉	ocallaghan
奥古斯塔	augusta
奥多克	auddock
奥多姆	odom
奥尔加	orga
奥尔德曼	alderman
奥尔福德	alford
奥德丽	audrey
奥德利	audley
奥戈尔曼	ogorman
奥曼	auman
奥格莫尔	ogmore
奥特布里奇	outerbridge
奥特斯哈根	oettershagen
奥特考特	outcault
奥珀	opper
奥肖内西	o'shaughnessy
奥莫尔	omore
奥蒙德	ormond
奥费拉尔	oferrall
奥里甘	oregan
姆利纳奇克	mlinarchik
姆罗兹	mroz
委内瑞拉	venezuela
威兰	wieland
威加德	wiegard
威尔伯恩	wilbern
威尔克斯	weelkes
威尔金森	wilkinson
威格纳尔	wignal
威纳德	winard
威蒂格	wittig
威贝尔沙姆	wibbelsham
安东	anton
安东尼娅	antonia
安富索	anfuso
安布里斯特	armbrister
安普尔福斯	ampleforth
安杰耶夫斯基	andrzejewski
安泰拉米	antelami
安特里姆	antrim
富加德	fugard
富拉姆	fullam
富萨罗	fusaro
尤利塞斯	ulysses
尤厄尔	euell
尤塞里	usery
尤德利	eudaly
尼乔	nico
尼尔森	neilson
尼德雷克	niederecker
尼文	niven
尼米	niemi
尼藏	nizan
尼豪斯	niehaus
巴克多尔	barkdoll
巴克温	bakwin
巴内费尔特	barneveldt
巴勒特	barratt
巴因斯	barnes
巴塞尔	bahcer
巴塞洛缪斯	bartholomeus
巴布奇克	babchik
巴彻	bacher
巴恩斯特普尔	barnstaple
巴戈特	baggott
巴托尔夫	bottolph
巴斯尼特	basnett
巴林特	balint
巴特利特	bartlett
巴特鲁斯	batrus
巴舍	basher
布伦内克	brennecke
布伦科	blenko
布兰德法斯	brandfas
布兰斯福德	bransford
布兰比拉	brambilla
布兰贝尔	brambell
布利文	bliven
布劳沃	brouwer
布拉德洛	bradlaugh
布拉德福德	bradford
布拉沃	bravo
布拉热	blaze
布拉焦蒂	braggiotti
布朗斯坦	braunstein
布朗普顿	brompton
布林斯	brings
布泽尔	buzzell
布洛特	blott
布洛马特	blommaert
布莱克洛克	blacklock
布莱克门	blackmun
布莱克默	blackmar
布莱希斯米特	blechschmidt
布莱恩	blain
布莱金	blacking
布西内	boussinesq
布赖因	bryan
布赖尔	brier
布赖尼	briney
布赫霍尔茨	buchholz
布雷斯特	brester
布雷滕巴赫	barytenbah
希伦布兰德	hillenbrand
希尔布兰德	hillbrand
希拉里	hilary
希普韦尔	hipwell
希比	shippey
希特	heater
希维尔	shivell
帕克森	parkson
帕内拉伊	panerai
帕布利克	publicker
帕库维乌斯	pacuvius
帕格斯利	pugsley
帕滕	parten
帕辛	passin
帕辛厄姆	passingham
帕里尼奥	paringaux
席卡内德	schikaneder
平克尔	pinkel
库宁	kunin
库纳斯	kunnas
库鲁斯	kurrus
康德特	condit
康拉迪	conradi
康斯坦茨	constantz
康诺普	connop
康迪	condy
弗兰科	franko
弗内斯	furness
弗劳尔	flower
弗吕格尔曼	fluegelman
弗拉德	flad
弗斯科伊尔	verschoyle
弗罗伊德	freud
弗罗勒	frorer
弗莱希曼	fleischmann
彭伯顿	pemberton
彭德	pender
彭达	penda
彻宁	chernin
彻林顿	cherrington
彻马克	chermak
彼得罗奇	petrocci
德佩尼	depeny
德利弗	delievre
德哈维兰	dehavilland
德尔普	delp
德布罗	durbrow
德拉姆	dirlam
德拉蒙德	drummond
德拉马尔宾	drumalbyn
德方丹	desfontaines
德格鲁特	degroot
德沃尼克	dwornik
德甘特	degandt
德米特里	dmitri
德罗布	drob
德莱思	derleth
德里斯纳克	driessnack
德雷斯勒	dressler
德默	demer
怀勒	wyler
恩尼弗	ennever
恩廷	entin
恩格尔贝里	engelberg
恩里科	enrico
惠兰	whelan
惠利斯	wheless
惠特吉夫特	whitgift
惠特威尔	whitwill
惠特布雷德	whitbread
惠特拉姆	whitlam
戈	gau
戈勒	goeller
戈尔兹伯勒	goldsborough
戈尼	gorney
戈德伯尔	godbole
戈德利	godley
戈托	gotto
戈查尔克	gotshalk
戈维特	govett
扎因	zainal
扎尔茨	salz
扎布洛多斯基	zablodowsky
拉基曼	rackemann
拉多克	ruddock
拉尼厄斯	lanius
拉帕迪斯	lapadis
拉德利	radley
拉德林	rudlin
拉本施拉格	rabenschlag
拉脱维亚共和国	republic of latvia
拉蒙	lamon
拉赫曼尼诺夫	rakhmaninov
拉齐	ratsey
撒克	thacker
斤巴利斯特	zimbalist
斤恩	zinn
斯克林杰	scrimgeour
斯克莱特	sclater
斯克鲁太特	scrutator
斯利克特	slichter
斯卡利	scali
斯卡布	scaboo
斯卡曼	scarman
斯图尔特	steuart
斯坦伯格	staenberg
斯坦迈耶	steinmeyer
斯基瓦扎帕	schivazappa
斯塔勒	stahler
斯塔斯特尼	stastny
斯太恩	steyn
斯太曼	staiman
斯太格尔	steiger
斯太西	stacey
斯帕尼奥尔	spaniol
斯帕尼斯	spaneth
斯库巴尔	skubal
斯庞	spohn
斯庞塞勒	sponseller
斯托伯	stobaugh
斯托西	stosy
斯托顿	staughton
斯波克	spock
斯洛姆	sloame
斯温德尔	swindell
斯滕韦克	steenwijk
斯潘根贝格	spangenberg
斯特兰兰	strandland
斯特罗伊克	struik
斯特赖茨	streitz
斯特雷德	strader
斯瓦戈	swago
斯科拉	skora
斯科森	scothern
斯科特兰	scotland
斯穆特	smoot
斯维里根	sverigan
斯莫哈拉	smohalla
斯莫尔斯里德	smallsreed
斯莱皮恩	slepian
斯蒂夫勒	stifler
斯蒂安森	stiansen
斯蒂居姆	stigum
斯蒂林弗利特	stillingfleet
斯里夫斯	shrieves
斯韦策	sweitzer
方齐	vanzi
施内	schnee
施彭	spahn
施林普顿	shrimpton
施特罗迈尔	strohmeyer
施韦柴尔德	schweichild
施韦策	schweitzer
昂斯托特	onstot
昂斯沃思	unsworth
昂马克	unmack
昆塔斯	quintus
明尼	minney
易卜拉欣	ibrahim
晓尔斯	shchors
普利	pooley
普利布兰克	pulleyblank
普夫利姆林	pflimlin
普洛采克	plocek
普罗尔	prahl
普罗尼	prony
普莱文	pleven
普里西拉	priscilla
曼弗雷迪	manfredi
曼德斯	manders
曼蒂	mantey
本克特	benkert
本斯基	bennsky
本纳斯	benners
本纳维茨	bennewitz
朱伊特	jewett
朱伯特	joubert
朱尔金斯	jurgins
朱斯伯里	jewsbury
杜布	doob
杜拉茨基	dulacki
杜普卡	dupka
杜西	ducey
杜里安	dourian
杰拉尔德	gerald
杰西纳	jacyna
杰鲁撒	jerutha
林多	lindow
林登鲍姆	lindenbaum
柯克斯	kirks
柯根文	curgenven
柴可夫斯基	chaikovski
格伦伯格	gruenberg
格利朗奇	glilonge
格利森	gleason
格奥尔格	georg
格岑	gotzen
格拉夫	graf
格拉文	glavin
格拉斯默克	grassmuck
格林斯莱德	greenslade
格赖斯	grice
格里内森	greeneisen
格里戈列夫	grigoriev
格里格斯	griggs
格里特	greet
格里蒙德	grimond
格雷沙姆	gresham
格鲁吉亚	georgia
格鲁特	grutt
格鲁菲	gruffy
桑切斯	sanchez
梅亚	meja
梅奥尔	mayall
梅尔德伦	meldrum
梅尔泽	melzer
梅德福	medford
梅格雷斯	maegraith
梅瑟利	messerly
森德兰	sunderland
森德奎斯特	sundquist
森森布伦纳	sensenbrenner
森特尔	sentelle
欣伯里	himbury
欣利	hingley
武科塔	vukota
比克利	beakley
比克罗夫特	beecroft
比克顿	bickerton
比利拉基斯	bilirakis
比奇伍德	beechwood
比姆	beahm
比特恩	bittern
毛里西奥	maurizio
汉伯里	hanbury
汉弗莱斯	humphreys
沃克曼	werkman
沃尔弗利	wolfle
沃尔茨	voltz
沃尔西	wolsey
沃拉斯	wallas
沃斯伯格	vosburg
沃滕伯格	wirtenberger
沃特洛	waterlow
沃里克	warwick
沙勒迈恩	charlemagne
沙因曼	scheinman
沙夫豪森	schaaffhausen
沙尔特	shalt
沙普尔斯	sharples
法兰	farland
法利	falley
法尔布希	fahlbusch
法拉尔	farrall
法拉斯	fallas
法策尔	fatzer
波佩奥	popeo
波多布尼卡	podobnikar
波森	pawson
波莱蒂	poletti
泽弗雷蒂	zeferetti
泽肯多夫	zeckendorf
洛夫莱斯	lovelace
洛施密特	loschmidt
洛沃恩	lovvorn
洛里亚	loria
洛齐尔	lozier
派克	peik
海克斯	heikes
海内克	heinecke
海姆斯	himes
海尔纳	heilner
涅尔什	nyers
温内曼	wenneman
温加滕	weingarten
温宁顿	winnington
温斯特德	winstead
潘克拉齐	pancrazi
特利亚	telia
特尔菲尔	telphere
特弗沙姆	teversham
特斯特	test
特立尼达	trinidad
特罗皮宁	tropinin
特萨	tesar
玛伊	maj
珀斯基	perskie
班克罗夫特	bancroft
班菲尔德	bamfield
瓦恩加德纳	winegardner
瓦拉	valla
甘佐尼	ganzoni
甘佩尔	gampell
甘尼	ganey
甲宁	janeen
甲弗	jaffer
甲斯	jasch
皮尔斯布里	pilsbry
皮查姆	peacham
皮特罗斯	peatross
皮珀	pierper
皮科利	piccoli
盖恩斯伯勒	gainsborough
盖格纳	genger
盖耶	gaje
福伊西	foisie
福内尔	fornell
福尔德	foard
福帕	foppa
福日斯特	forst
福纳	foner
福罗	forrow
科丁	codding
科伯利	coberly
科利施	kolisch
科利森	collissoon
科图尼奥	cotugno
科尔布伦纳	kohlbrenner
科尔斯托克	colstock
科恩戈尔德	korngold
科林斯	collings
科格比尔	cogbill
科潘	kopan
科特利	coatley
科茨布	kotzebue
米哈埃拉	mihaela
米尔顿伯格	miltonberger
索尔斯坦森	thorsteinson
索尔森	thorsen
索德斯	sawders
索拉日	sorarz
索林斯	sollins
索科尔	sokol
索萨诺	sorzano
纳兰霍	naranjo
纳奇曼	nacheman
纳尔拉	najera
纽因顿	newington
纽波特	newport
纽豪斯	newhouse
维尔登韦	wildenvey
维布朗斯基	verblunsky
维特林	wittlin
维诺克	vinocur
维诺德	vinod
罗斯芒特	rosemount
罗曼诺夫	romanov
罗根	rogan
罗森塔尔	rozental
罗波洛	roppolo
罗蒂	rorty
考密克	cormick
考珀斯韦特	cowperthwaite
耶赖米亚什	jeremias
聚斯	suess
肖特	schodt
肖特利	shortley
肯塔基	kentucky
肯辛顿	kensington
舍希	schech
舒季科	shutko
艾伯塔齐	albertazzie
艾利斯	ailice
艾尔威克	airwich
艾布拉姆森	abramson
艾斯林	iselin
艾森巴特	eisenbud
艾森斯坦	eisenstein
艾特曼	eiteman
艾瓦	ivah
艾西特	isitt
芬利	finlay
芬斯特斯托克	fensterstock
芬纳勒德	finnerud
苏兹贝格	sulzberger
苏尔	suhr
范斯勒	fansler
范维克滕	vanvechten
范齐尔	vanzyl
莫内	monnet
莫尔尼	morny
莫尔森	molson
莫尔茨比	maultsby
莫里亚蒂	moriarty
莱伯	leber
莱厄利	lierle
莱夫特威奇	leftwich
莱姆利	lemley
莱姆利特	lemlet
莱西特	lessiter
莱里	laeri
菲亚尔	fjare
菲尔森	filson
菲尔波	firpo
菲尔波特	philpot
菲茨威廉	fitzwilliam
萨克森	saxon
萨勒姆	sarum
萨夫利	safley
萨尔普卡斯	salpukas
萨尔韦米尼	salvemini
萨拉米纽斯	salaminius
萨梅斯	sameth
萨瑟恩	southern
萨米	summy
萨索	sasso
蒂亚诺	tiano
蒂德霍尔姆	tidholm
蒂施勒	tischler
蒂特马斯	titmuss
蒙克斯韦尔	monkswell
蒙特利尔	montellier
蒙特莫雷诺	montemoreno
蔡斯勒	zeisler
西丁	seeding
西兹	seeds
西奥多	theodor
西姆	seem
西姆加	seamgar
西尔克纳特	silkenat
西尔弗斯坦	silverstein
西尔弗曼	silverman
西尔比	searby
西尔金	silkin
西尔韦纽斯	sylvanius
西比利亚	scibilia
西皮奥	scipio
詹妮特	jennett
詹特	jent
许伦	hulen
诺勒姆	norem
诺尔德	nold
诺尔斯基	norsky
诺韦	norway
谢诺	chennault
豪斯多弗	hausdorfer
贝克特尔	bachtel
贝内里托	benerito
贝古尼克	begunik
贝尔内特	bernette
贝尔斯	bales
贝拉曼	bellamann
贝林格	beringer
贝格	baerg
贝特纳	betner
费伦塞德	fearenside
费尔蒙特	fairmont
费德尔	fedel
费恩巴赫	fernbach
费斯塔	festa
费莫尔	fermor
赖伯格	ryberg
赖克曼斯	ryckmans
赖内克尔	reinecker
赖尔森斯	ryersons
赖恩	rhyne
赖蒂纳	rytina
赛姆	sime
赛弗	seyfer
赛登伯格	saidenberg
赫利希	herlihy
赫夫曼	huffman
赫姆基	helmke
赫尔皮尤	hulpieu
赫尔芬	helfen
赫罗德	herod
辛克莱	sinclair
达尔齐尔	dalziel
达文波特	davenport
达维特	davit
达隆	dallon
迈布里奇	muybridge
迈登斯	mydans
迪克特	dickert
迪夫斯	deeves
迪尔林	deerlin
迪布丁	dibdin
迪斯科姆	discombe
迪普伊	dupuis
迪格	dygrad
迪瓦恩	devine
道尔尼	darnyi
道滕代	dauthendey
邓布尔	dumble
邦德	bond
邦普兰	bonpland
里切尔	ritschel
里士曼	richmond
里夫金	rifkin
里奇马尔	richmal
里奥斯	rios
里尔斯比	reresby
里德尔伯格	riddleberger
里普洛格尔	replogle
里比科夫	ribicoff
里赫特	richter
里韦罗	rivero
金斯洛	kinslow
锡西	cissie
门泽尔	menzel
阿什克拉夫特	ashcraft
阿伦霍尔茨	ahrenholtz
阿内罗德	anerood
阿利斯特	alister
阿坎德	arcand
阿宾登	abingdon
阿尔	ahl
阿尔加斯	algase
阿尔巴雷斯	albares
阿尔方	alphand
阿尔曼扎	almanza
阿尔让斯	argens
阿布德哈尔登	abderhalden
阿德莱	adlai
阿拉本	allaben
阿普林	aplin
阿本	abern
阿比斯	abbiss
阿波尔蒂	aporti
阿洛伊修斯	aloysius
阿索斯	athos
阿萨焦利	assagioli
阿谢德	adshead
阿贝格	abegg
陶里亚蒂	togliatti
隆巴多	lombardo
雅尔纳赫	jarnach
雷基特	rekitt
雷德尔	redl
雷德韦	reddaway
雷蒙德	ramond
雷金纳德	reginald
霍伊	hoey
霍伊辛顿	hoisington
霍勒	hohler
霍夫斯特龙	hoffstrom
霍夫索默	hoffsommer
霍姆	holme
霍尔斯克	holske
霍弗伯斯	hofferberth
霍斯利	horsley
霍特尔	hottel
霍维	hovey
韦伦	waylen
韦德莱克	wedlake
韦斯特拉普	westrup
韦罗克	weyrauch
马图格	martuge
马弗里克	maverick
马文	marven
马瑟雷尔	masereel
马茨纳	matsner
马迪尔	madill
鲍里谢诺克	borisenok
麦克奈里	mceniry
麦克希尔	machill
麦克希里	mcsherry
麦克拉弗蒂	mcclafferty
麦克邓菲	mcdunphy
麦克里	mccree
麦克里迪	macready
麦克韦西	mcwethy
麦克默罗	macmurrough
麦凯尔丁	mckeldin
麦基格	mckeag
麦库克	mccook
黑克威尔	hakewill
黑贝勒	heberle
默塞德	merced
默尼克	murneek
默瑟	mercer
默雷尔	murrell
齐勒	zierer
龙根	rongen
